time,open,high,low,close,Plot,Plot,Plot,Plot,Plot,Plot,Plot,Plot,Plot,Plot,MA,MA,MA,MA,EMA,EMA,Basis,Upper,Lower,MA,MA,MA,MA,VWAP,Volume,Volume MA,RSI,EMA Divergence,Min,Max,-Min,-Max,ATR,Plot,Plot,Histogram,MACD,Signal,HV,ROC,Plot,Plot,Plot,OnBalanceVolume
1226500200,3.327466,3.327466,3.017471,3.074136,NaN,3.583298,NaN,NaN,NaN,NaN,NaN,NaN,NaN,NaN,NaN,NaN,NaN,NaN,NaN,NaN,NaN,NaN,NaN,NaN,NaN,NaN,NaN,3.1396910000000005,13312404,NaN,NaN,NaN,1.5,2.75,NaN,NaN,NaN,NaN,-28.84089564328303,NaN,NaN,NaN,NaN,NaN,4.136394678765702,77.91313038442966,17.950474936804646,-27930092
1226586600,3.051636,3.533297,2.564141,3.518298,NaN,3.562465,NaN,NaN,NaN,NaN,NaN,NaN,NaN,NaN,NaN,NaN,NaN,NaN,NaN,NaN,NaN,NaN,NaN,NaN,NaN,NaN,NaN,3.2052453333333335,32068244,NaN,NaN,NaN,1.5,2.75,NaN,NaN,NaN,NaN,-23.049964481463697,NaN,NaN,NaN,NaN,NaN,44.44779436557902,23.34374344679184,32.208462187629145,4138152
1226673000,3.270801,3.583298,3.041636,3.067469,NaN,3.541632,NaN,NaN,NaN,NaN,NaN,NaN,NaN,NaN,NaN,NaN,NaN,NaN,NaN,NaN,NaN,NaN,NaN,NaN,NaN,NaN,NaN,3.2308009999999996,34303060,NaN,NaN,NaN,1.5,2.75,NaN,NaN,NaN,NaN,-29.18296019022107,NaN,NaN,NaN,NaN,NaN,16.27315207028257,54.06739181267033,29.659456117047103,-30164908
1226932200,2.956637,3.170802,2.833305,2.850806,NaN,3.170802,NaN,NaN,NaN,NaN,NaN,NaN,NaN,NaN,NaN,NaN,NaN,NaN,NaN,NaN,NaN,NaN,NaN,NaN,NaN,NaN,NaN,2.9516376666666666,44527416,NaN,NaN,NaN,1.5,2.75,NaN,NaN,NaN,NaN,-34.085457794363336,NaN,NaN,NaN,NaN,NaN,8.765701051210272,67.00022272013946,24.234076228650274,-74692324
1227018600,2.836637,2.99497,2.595807,2.876638,NaN,3.206635,NaN,NaN,NaN,NaN,NaN,NaN,NaN,NaN,NaN,NaN,NaN,NaN,NaN,NaN,NaN,NaN,NaN,NaN,NaN,NaN,NaN,2.8224716666666665,61130864,NaN,NaN,NaN,1.5,2.75,NaN,NaN,NaN,NaN,-37.31969919851323,NaN,NaN,NaN,NaN,-32.31373110040147,35.29403005627067,31.41060421420451,33.295365729524804,-13561460
1227105000,2.874971,2.970803,2.366642,2.41331,NaN,3.2138016,NaN,NaN,NaN,NaN,NaN,NaN,NaN,NaN,NaN,NaN,NaN,NaN,NaN,NaN,NaN,NaN,NaN,NaN,NaN,NaN,NaN,2.5835850000000002,75194200,NaN,NaN,NaN,1.5,2.75,NaN,NaN,NaN,NaN,-46.90935708925878,NaN,NaN,NaN,184.8918139670988,-32.96294074051851,22.368384411701225,45.67004853842614,31.96156704987265,-88755660
1227191400,2.324143,2.497475,1.846648,1.996648,NaN,3.2209681999999997,NaN,NaN,NaN,NaN,NaN,NaN,NaN,NaN,NaN,NaN,NaN,NaN,NaN,NaN,NaN,NaN,NaN,NaN,NaN,NaN,NaN,2.1135903333333332,137046144,NaN,NaN,NaN,1.5,2.75,NaN,NaN,NaN,NaN,-56.779345268920736,NaN,NaN,NaN,190.38715908801132,-48.1945591843343,4.978304876102091,75.61942886530026,19.402266258597653,-225801804
1227277800,2.266644,2.269978,1.805815,2.222478,NaN,3.2281348,NaN,NaN,NaN,NaN,NaN,NaN,NaN,NaN,NaN,NaN,NaN,NaN,NaN,NaN,3.1451355384615387,4.428875833112019,1.8613952438110584,NaN,NaN,NaN,NaN,2.0994236666666666,124578164,NaN,NaN,NaN,1.5,2.75,NaN,NaN,NaN,NaN,-52.56437700725986,NaN,NaN,NaN,200.89624334908137,-40,25.472358938243556,41.87020174601656,32.65743931573988,-101223640
1227537000,2.371644,2.797473,2.316644,2.597474,NaN,3.2353013999999995,NaN,NaN,NaN,NaN,NaN,NaN,NaN,NaN,NaN,NaN,NaN,NaN,NaN,NaN,3.018021384615385,4.1582252937934525,1.8778174754373174,NaN,NaN,NaN,NaN,2.5705303333333336,98186576,NaN,NaN,NaN,1.5,2.75,NaN,NaN,0.5486017857142859,NaN,-42.128860728704204,NaN,NaN,NaN,234.7806358222249,-24.902430005328437,47.55734726523831,20.935529898934394,31.507122835827296,-3037064
1227623400,2.834137,2.845797,2.524975,2.742473,NaN,3.2424679999999997,NaN,NaN,NaN,NaN,NaN,NaN,NaN,NaN,NaN,NaN,NaN,NaN,NaN,NaN,2.9520605384615384,4.048336749427936,1.8557843274951413,NaN,NaN,NaN,NaN,2.7044150000000005,80055524,NaN,33.05225847344917,NaN,1.5,2.75,NaN,NaN,0.5323318010204083,NaN,-37.16139903527609,NaN,NaN,NaN,238.99138334461333,-10.788820013167935,49.64039726084949,19.3848914432296,30.97471129592089,77018460
1227709800,2.587474,3.044969,2.575808,3.028303,NaN,3.2496346,NaN,NaN,NaN,NaN,NaN,NaN,NaN,NaN,NaN,NaN,NaN,NaN,NaN,NaN,2.8885355384615385,3.8565702882391455,1.9205007886839316,NaN,NaN,NaN,NaN,2.8830266666666673,61238160,NaN,37.38590447132131,NaN,1.5,2.75,NaN,NaN,0.527819600947522,NaN,-30.48272767318687,NaN,NaN,NaN,239.9760021521378,-13.92704654352758,71.85293132868928,6.525501889330349,21.621566781980373,138256620
1227882600,2.991636,3.124969,2.979137,3.118302,NaN,3.2568011999999995,NaN,NaN,NaN,NaN,NaN,NaN,NaN,NaN,NaN,NaN,NaN,NaN,NaN,NaN,2.843471846153846,3.704016464036783,1.9829272282709094,NaN,NaN,NaN,NaN,3.0741359999999998,21645264,NaN,38.73075672772647,NaN,1.5,2.75,NaN,NaN,0.5005347723084134,NaN,-26.445619102187685,NaN,NaN,NaN,225.23450393228782,1.657164261480716,100,0,0,159901884
1228141800,2.872471,2.881638,2.281644,2.30831,NaN,3.2639677999999996,NaN,NaN,NaN,NaN,NaN,NaN,NaN,NaN,NaN,NaN,NaN,NaN,NaN,NaN,2.754972692307692,3.580097162219357,1.9298482223960272,NaN,NaN,NaN,NaN,2.490530666666667,101855240,NaN,32.057220048743346,NaN,1.5,2.75,NaN,NaN,0.5245435742863839,NaN,-34.8895518352215,NaN,NaN,NaN,272.8876049904317,-19.02956567370771,70.84156602752878,6.969016729544747,22.189417242926478,58046644
1228228200,2.423309,2.573308,2.309977,2.552474,NaN,3.2711343999999993,NaN,NaN,NaN,NaN,NaN,NaN,NaN,NaN,NaN,NaN,NaN,NaN,NaN,NaN,2.714844846153846,3.524575304854896,1.9051143874527958,NaN,NaN,NaN,NaN,2.4785863333333333,109263204,NaN,35.6563014978081,NaN,1.5,2.75,NaN,NaN,0.5060046046944994,NaN,-29.154888494068544,NaN,NaN,NaN,280.54265774787814,-11.26884926083851,71.65841617249168,6.60888301683999,21.73270081066832,167309848
1228314600,2.388309,2.786639,2.366642,2.744138,NaN,3.2783009999999995,NaN,NaN,NaN,NaN,NaN,NaN,NaN,NaN,NaN,NaN,NaN,2.9989118,NaN,2.9989118,2.655294076923077,3.320963293948822,1.9896248598973316,NaN,NaN,NaN,2.9989118,2.6324729999999996,136167376,57968759.4,38.41416517673987,NaN,1.5,2.75,NaN,NaN,0.49986120435917797,2.348978612090153,-25.2454980897557,NaN,NaN,NaN,284.52197893159666,13.708475081941396,76.03578685607276,4.828698700285884,19.135514443641362,303477224
1228401000,2.645807,2.825555,2.403309,2.524975,NaN,3.2854675999999996,NaN,NaN,NaN,NaN,NaN,NaN,NaN,NaN,NaN,NaN,NaN,2.91266265,NaN,2.953774961904762,2.6135637692307685,3.2373442654277778,1.9897832730337595,NaN,NaN,NaN,2.91266265,2.584612999999999,109459800,63430311.6,36.48827516296385,NaN,1.5,2.75,NaN,NaN,0.4943172611906652,1.7256702235717851,-30.308561923504527,NaN,NaN,NaN,268.7567335520442,26.460698130065992,46.21414563216401,21.96681444532228,31.819039922513713,194017424
1228487400,2.414976,2.816639,2.28331,2.781639,NaN,3.2926341999999993,NaN,NaN,NaN,NaN,NaN,NaN,NaN,NaN,NaN,NaN,NaN,2.8717464,NaN,2.937381060770975,2.6082432307692303,3.224978868092638,1.9915075934458224,NaN,NaN,NaN,2.8717464,2.627196,167188908,71573159.2,40.26529454454854,NaN,1.5,2.75,NaN,NaN,0.4971038139627605,2.3359162829855915,-25.699794111958717,NaN,NaN,NaN,242.07756940308516,25.15934915891181,60.94234171303576,12.024137750209661,27.03352053675457,361206332
1228746600,3.033302,3.206635,2.974137,3.091637,NaN,3.2998007999999994,NaN,NaN,NaN,NaN,NaN,NaN,NaN,NaN,NaN,NaN,NaN,2.8336218499999997,NaN,2.952072102602311,2.624781615384615,3.279764245441339,1.9697989853278908,NaN,NaN,NaN,2.8336218499999997,3.0908029999999997,142794440,78363958.6,44.55416429062694,NaN,1.5,2.75,NaN,NaN,0.4919532558225633,1.8221953376408426,-19.801026906393258,NaN,NaN,NaN,241.912494306234,19.024752509553508,83.0850681316873,2.5031747212959257,14.411757147016784,504000772
1228833000,3.012469,3.204135,2.879138,2.91747,NaN,3.306967399999999,NaN,NaN,NaN,NaN,NaN,NaN,NaN,NaN,NaN,NaN,NaN,2.79428885,NaN,2.9487766642592335,2.663563153846153,3.3235518354254876,2.0035744722668185,NaN,NaN,NaN,2.79428885,3.0002476666666666,126280452,84388724.4,42.69923283824937,NaN,1.5,2.75,NaN,NaN,0.48002780897809444,1.4964138028847844,-24.186473617635208,NaN,NaN,NaN,233.1518062729769,6.380992629644844,57.60201442622114,14.009571712669636,28.388413861109218,377720320
1228919400,3.018303,3.119135,2.895804,3.009137,NaN,3.3141339999999992,NaN,NaN,NaN,NaN,NaN,NaN,NaN,NaN,NaN,NaN,NaN,2.77180575,NaN,2.954525267663116,2.7414469230769223,3.299311104364784,2.1835827417890608,NaN,NaN,NaN,2.77180575,3.0080253333333338,125737628,90101653.4,44.020231839479095,NaN,1.5,2.75,NaN,NaN,0.4616923226225163,1.3955085534534708,-19.415105108831,NaN,NaN,NaN,231.97077075657182,-0.6328957175025167,57.72099572650186,13.936001404377434,28.34300286912071,503457948
1229005800,2.954137,3.097469,2.721639,2.786639,NaN,3.3213005999999994,NaN,NaN,NaN,NaN,NaN,NaN,NaN,NaN,NaN,NaN,NaN,2.7574309,NaN,2.938536099314248,2.7848439230769224,3.255415141021478,2.3142727051323666,NaN,NaN,NaN,2.7574309,2.868582333333334,113850944,95128580.4,41.518278711444445,NaN,1.5,2.75,NaN,NaN,0.45555929957805086,1.196811132062263,-25.609122678917203,NaN,-0.11189245567993478,NaN,228.99438289576037,-10.63601280440444,55.704576946328096,15.208475623627864,29.086947430044038,389607004
1229092200,2.543308,2.884971,2.516642,2.860638,NaN,3.328467199999999,NaN,NaN,NaN,NaN,NaN,NaN,NaN,NaN,NaN,NaN,NaN,2.7245479,NaN,2.931117232712891,2.805087307692307,3.2641770610142036,2.3459975543704106,NaN,NaN,NaN,2.7245479,2.7540836666666664,142076596,100628998,42.68503275594762,NaN,1.5,2.75,NaN,NaN,0.44932856389390435,1.4118852301401232,-22.39122915835481,NaN,-0.10300258632045312,NaN,228.81663928119127,23.927808656549583,54.14533028437554,16.230138760150584,29.62453095547387,531683600
1229351400,2.903304,2.916638,2.630808,2.738306,NaN,3.335633799999999,NaN,NaN,NaN,NaN,NaN,NaN,NaN,NaN,NaN,NaN,NaN,2.70808975,NaN,2.9127542581688064,2.804766769230769,3.2640367287442116,2.3454968097173268,NaN,NaN,NaN,2.70808975,2.7619173333333333,91218168,103474753.4,41.22091598593032,NaN,1.5,2.75,NaN,NaN,0.4376500950443397,0.8815499916910167,-27.60698237650586,NaN,-0.10462244837418755,NaN,138.712465904258,7.280465932268065,27.34179737663213,39.71252615390165,32.9456764694662,440465432
1229437800,2.819138,3.157468,2.810805,3.155802,NaN,3.342800399999999,NaN,NaN,NaN,NaN,NaN,NaN,NaN,NaN,NaN,NaN,NaN,2.72333955,NaN,2.9359016621527294,2.8145743846153843,3.2973629947299266,2.331785774500842,NaN,NaN,NaN,2.72333955,3.041358333333333,122079044,107352334.8,47.80137361227917,NaN,1.5,2.75,NaN,NaN,0.43632951682688687,1.1371810797355848,-20.677019155542677,NaN,-0.07139476823538482,NaN,149.4080515118627,15.001577908982712,57.803500669963874,13.878276965701271,28.318222364334854,562544476
1229524200,3.050803,3.229134,2.984137,3.074968,NaN,3.349966999999999,NaN,NaN,NaN,NaN,NaN,NaN,NaN,NaN,NaN,NaN,NaN,2.73325605,NaN,2.949146075281041,2.811241,3.2861290543000874,2.3363529456999124,NaN,NaN,NaN,2.73325605,3.096079666666667,119923436,110291963.4,46.710991291438646,NaN,1.5,2.75,NaN,NaN,0.42266290848210925,1.0873270572314429,-17.953663382481313,NaN,-0.050996366209423716,NaN,147.7341889427984,21.78211665462035,27.599948928081623,39.42094942892411,32.97910164299427,442621040
1229610600,3.119135,3.140802,2.796647,2.904971,NaN,3.357133599999999,NaN,NaN,NaN,NaN,NaN,NaN,NaN,NaN,NaN,NaN,NaN,2.7578391,NaN,2.944938925254275,2.857138,3.2339245874642075,2.4803514125357924,NaN,NaN,NaN,2.7578391,2.9474733333333334,94500668,111257286.8,44.41635825073428,NaN,1.5,2.75,NaN,NaN,0.41705520073338714,0.8493885723627048,-20.791894443469047,NaN,-0.04799457127501627,NaN,142.2416121602068,4.433788856138413,29.06017065202471,37.801811456849535,33.13801789112577,348120372
1229697000,2.942471,3.075803,2.858305,2.899137,NaN,3.364300199999999,NaN,NaN,NaN,NaN,NaN,NaN,NaN,NaN,NaN,NaN,NaN,2.8029635500000003,NaN,2.94057683713482,2.883804384615385,3.2171307180472044,2.5504780511835654,NaN,NaN,NaN,2.8029635500000003,2.944415,97215456,109265752.4,44.33586505014471,NaN,1.5,2.75,NaN,NaN,0.40280111496671667,0.8897157056505108,-17.511945584701728,NaN,-0.045561181269141215,NaN,132.16752678311295,-6.226474841645377,7.358247133873172,69.95745560152115,22.684297264605682,250904916
1229956200,2.909971,2.916638,2.603308,2.766639,NaN,3.371466799999999,NaN,NaN,NaN,NaN,NaN,NaN,NaN,NaN,NaN,NaN,NaN,2.8301716,NaN,2.924011328836266,2.885535230769231,3.21616541106987,2.5549050504685917,NaN,NaN,NaN,2.8301716,2.762195,76354468,106854567.6,42.454108004669585,NaN,1.5,2.75,NaN,NaN,0.3964103210405226,0.7145643814293999,-21.748268113904217,NaN,-0.05370510441246834,NaN,117.4917667221397,-5.169924626474299,8.576945356173386,67.46111969929309,23.961934944533525,174550448
1230042600,2.798305,2.835797,2.648307,2.679139,NaN,3.3786333999999987,NaN,NaN,NaN,NaN,NaN,NaN,NaN,NaN,NaN,NaN,NaN,2.8342548499999998,NaN,2.9006901546613832,2.8973940000000002,3.1835061652950922,2.6112818347049083,NaN,NaN,NaN,2.8342548499999998,2.7210810000000003,68977816,105394129.6,41.21017709734547,NaN,1.5,2.75,NaN,NaN,0.3814874409661996,0.654474933867664,-24.614662402242132,0.0063933166631996025,-0.06645370397590167,-0.07284702063910127,114.62677125921844,-10.966532929540922,0,100,0,105572632
1230129000,2.713306,2.736639,2.65664,2.710806,NaN,3.385799999999999,NaN,NaN,NaN,NaN,NaN,NaN,NaN,NaN,NaN,NaN,NaN,2.8326715,NaN,2.882605949455537,2.891945307692308,3.1891504793362904,2.5947401360483253,NaN,NaN,NaN,2.8326715,2.7013616666666667,17955512,102289129,41.873967200953835,NaN,1.5,2.75,NaN,NaN,0.3599525523257568,0.17553685494770416,-22.243955089106038,-0.00024916220001690303,-0.0731584733891224,-0.0729093111891055,112.72785488839176,-2.721306922066341,0.2734760783023143,94.65816340334895,5.068360518348747,123528144
1230301800,2.772472,2.778306,2.704974,2.767473,NaN,3.392966599999999,NaN,NaN,NaN,NaN,NaN,NaN,NaN,NaN,NaN,NaN,NaN,2.81963,NaN,2.871640906650248,2.8670096153846156,3.146904540896138,2.5871146898730935,NaN,NaN,NaN,2.81963,2.750251,19193852,100186913.6,43.11179110245237,NaN,1.5,2.75,NaN,NaN,0.3394796557310599,0.19158043012116505,-17.468646572520807,-0.00011842194253065819,-0.07305733861726882,-0.07293891667473816,105.38559086119062,-3.2567909676093216,2.1096779461834116,84.58334806568438,13.306973988132214,142721996
1230561000,2.787472,2.787472,2.619974,2.749973,NaN,3.4001331999999986,NaN,NaN,NaN,NaN,NaN,NaN,NaN,NaN,NaN,NaN,NaN,2.80121355,NaN,2.8600534869692718,2.8541252307692306,3.13892044651789,2.5693300150205713,NaN,NaN,NaN,2.80121355,2.719139666666667,46645340,101436917.4,42.808603282147544,NaN,1.5,2.75,NaN,NaN,0.32719525175027,0.4598457957477323,-21.577174289355636,-0.00048210754438599013,-0.07354155110522065,-0.07305944356083466,103.9952939517621,0.4260663344417917,3.413203309941132,80.14125316682522,16.44554352323364,96076656
1230647400,2.795805,2.935804,2.754139,2.932471,NaN,3.4072997999999988,NaN,NaN,NaN,NaN,NaN,NaN,NaN,NaN,NaN,NaN,NaN,2.8324216,NaN,2.8669503929721984,2.848227846153846,3.1229356940637483,2.573519998243944,NaN,NaN,NaN,2.8324216,2.874138,57150148,99201662.8,46.99497218181773,NaN,1.5,2.75,NaN,NaN,0.31709780519667924,0.576100706247436,-15.575438429345356,0.011627879252774198,-0.05852459449486691,-0.07015247374764111,107.2859846981596,-7.076838153977973,30.465008653887136,36.41554082769276,33.119450518420095,153226804
1230733800,2.944137,3.128301,2.926637,3.03247,NaN,3.4144663999999985,NaN,NaN,NaN,NaN,NaN,NaN,NaN,NaN,NaN,NaN,NaN,2.8564214,NaN,2.8827141650700843,2.867137923076923,3.155775362782289,2.578500483371557,NaN,NaN,NaN,2.8564214,3.0291359999999994,65382280,97007616.6,49.18970055346134,NaN,1.5,2.75,NaN,NaN,0.30885253339691643,0.6739912008105146,-8.47576199971806,0.025629900999545013,-0.03811509749820985,-0.06374499849775486,68.44085427946169,-1.3820631629337328,75.57670409244587,5.032052715684093,19.391243191870025,218609084
1230906600,3.089969,3.384966,3.02497,3.329133,NaN,3.4216329999999986,NaN,NaN,NaN,NaN,NaN,NaN,NaN,NaN,NaN,NaN,NaN,2.88567115,NaN,2.925230244587219,2.9031759999999998,3.2823557426234684,2.523996257376531,NaN,NaN,NaN,2.88567115,3.2463563333333334,87174964,94557996,55.12594091076962,NaN,1.5,2.75,NaN,NaN,0.3125056381542795,0.9219205956945196,-1.0848892501708187,0.052576025788977465,0.001975033738466969,-0.050600992050510496,86.28917232762969,14.601247310214108,83.46257789225211,2.416372926231293,14.121049181516595,305784048
1231165800,3.291634,3.428299,3.223718,3.329133,NaN,3.4287995999999987,NaN,NaN,NaN,NaN,NaN,NaN,NaN,NaN,NaN,NaN,NaN,2.92587905,NaN,2.9636971736741504,2.9486242307692305,3.3763845367855456,2.5208639247529154,NaN,NaN,NaN,2.92587905,3.32705,111760068,94673009.4,55.125940910769614,NaN,1.5,2.75,NaN,NaN,0.30479673542897384,1.180485005264869,3.4675826058651964,0.06717053220983091,0.033362173211778146,-0.03380835899805276,76.27275436849854,14.831862033425809,81.26611707380131,3.0342431308519715,15.69963979534672,305784048
1231252200,3.419132,3.508299,3.322467,3.409966,NaN,3.508299,NaN,NaN,NaN,NaN,NaN,NaN,NaN,NaN,NaN,NaN,NaN,2.9572954,NaN,3.0061989666575646,2.9681753076923068,3.451632657054098,2.4847179583305157,NaN,NaN,NaN,2.9572954,3.4135773333333344,119625584,92294843.2,56.72367597504198,NaN,1.5,2.75,NaN,NaN,0.2962992543269043,1.2961242454334654,8.80071561492354,0.07826369337427763,0.06402125771979428,-0.014242435654483354,75.78107944689569,23.25301566268674,100,0,0,425409632
1231338600,3.230801,3.280801,3.045803,3.123302,NaN,3.517726,NaN,NaN,NaN,NaN,NaN,NaN,NaN,NaN,NaN,NaN,NaN,2.95887865,NaN,3.017351636499701,2.9718933076923073,3.4593058430706343,2.4844807723139803,NaN,NaN,NaN,2.95887865,3.149968666666666,116434584,90976850.4,49.93364407164358,NaN,1.5,2.75,NaN,NaN,0.3011466647321254,1.2798264996872215,3.398267958724907,0.06294957853720033,0.06444453751701706,0.0014949589798167288,90.46073004830471,16.578572444356176,64.03642190941744,10.294088788658643,25.66948930192393,308975048
1231425000,3.051636,3.154968,3.009137,3.154968,NaN,3.527153,NaN,NaN,NaN,NaN,NaN,NaN,NaN,NaN,NaN,NaN,NaN,2.9707535500000004,NaN,3.0304579568330627,2.9911238461538456,3.486125277267765,2.496122415039926,NaN,NaN,NaN,2.9707535500000004,3.1063576666666664,104341976,89879926.6,50.636582682592255,NaN,1.5,2.75,NaN,NaN,0.29005268867983075,1.1609041078144362,7.049751675426014,0.05205828800165357,0.06656781898188369,0.01450953098023012,86.04912582811869,16.384868559387886,67.92729950684972,8.313679112228508,23.759021380921777,413317024
1231511400,3.175802,3.185801,2.924972,2.947471,NaN,3.5365800000000003,NaN,NaN,NaN,NaN,NaN,NaN,NaN,NaN,NaN,NaN,NaN,2.9676702500000003,NaN,3.022554437134676,2.9948418461538457,3.4877453754623997,2.5019383168452918,NaN,NaN,NaN,2.9676702500000003,3.0194146666666666,114430984,89314594.4,46.07189766065477,NaN,1.5,2.75,NaN,NaN,0.2879652823455571,1.281212603256249,1.8138530757259153,0.029128602200549553,0.05092028373091706,0.021791681530367507,98.80866231450145,6.504056227468175,35.42538081070236,31.288689308732952,33.285929880564716,298886040
1231770600,2.919137,2.928304,2.679139,2.733306,NaN,3.546007,NaN,NaN,NaN,NaN,NaN,NaN,NaN,NaN,NaN,NaN,NaN,2.9650036,NaN,2.9950069669313737,2.9922777692307685,3.4902240534423234,2.4943314850192135,NaN,NaN,NaN,2.9650036,2.7802496666666663,85794388,87911766.6,41.875928962179,NaN,1.5,2.75,NaN,NaN,0.2865629050351602,0.9759147303951461,-3.687055940064112,-0.0006364306701917913,0.02099614319262777,0.02163257386281956,109.24309987197203,-0.6060786778633822,25.535290894812142,41.79800757569883,32.66670152948903,213091652
1231857000,2.703306,2.808305,2.66164,2.744138,NaN,3.555434,NaN,NaN,NaN,NaN,NaN,NaN,NaN,NaN,NaN,NaN,NaN,2.9591786,NaN,2.971114684366481,2.9972776923076916,3.4837189600562786,2.5108364245591046,NaN,NaN,NaN,2.9591786,2.738027666666666,123647460,86990309.8,42.162840446457444,NaN,1.5,2.75,NaN,NaN,0.2765701975326488,1.4213934895079545,-1.9903568274375156,-0.018765160993817337,-0.0018238773794521101,0.016941283614365227,109.22703428434589,-6.422331201229273,22.723634798050757,45.222888682058176,32.053476519891056,336739112
1231943400,2.607473,2.622474,2.429976,2.475809,NaN,3.564861,NaN,NaN,NaN,NaN,NaN,NaN,NaN,NaN,NaN,NaN,NaN,2.94605375,NaN,2.923942714426816,2.9792009999999993,3.521176644002853,2.4372253559971457,NaN,NaN,NaN,2.94605375,2.5094196666666666,158163872,90337595,37.256700401148535,NaN,1.5,2.75,NaN,NaN,0.27925532628031674,1.7508089738275632,-10.37621281506104,-0.04642277756497768,-0.04108718834185687,0.0053355892231208065,115.07652502011585,-18.35668613374576,21.913510566236045,46.2530668006881,31.833422633075838,178575240
1232029800,2.459975,2.576641,2.256644,2.508309,NaN,3.574288,NaN,NaN,NaN,NaN,NaN,NaN,NaN,NaN,NaN,NaN,NaN,2.9136790999999995,NaN,2.884358551148072,2.9592653076923066,3.5479773599839746,2.3705532554006385,NaN,NaN,NaN,2.9136790999999995,2.447198,200343968,94250841.2,38.19477144183131,NaN,1.5,2.75,NaN,NaN,0.2821654458317227,2.125646471153193,-8.0544408624352,-0.05929904657914785,-0.068788219000814,-0.009489172421666154,112.36436239754589,-24.655788759415742,28.697683222149305,38.19713893329706,33.10517784455364,378919208
1232116200,2.63164,2.64164,2.384976,2.558308,NaN,3.583715,NaN,NaN,NaN,NaN,NaN,NaN,NaN,NaN,NaN,NaN,2.9335273799999997,2.8878460999999995,2.9335273799999997,2.853306117705398,2.944521846153845,3.562341535718737,2.3267021565889534,NaN,NaN,2.9335273799999997,2.8878460999999995,2.5283080000000004,209710640,98740201.4,39.68869958401713,NaN,1.5,2.75,NaN,NaN,0.2803439139865997,2.123862793741476,-4.624116783332581,-0.0609837581868735,-0.08571887015525803,-0.02473511196838453,91.49346979377422,-23.153926262483367,59.966644570033715,12.575258783867996,27.458096646098294,588629848
1232461800,2.484142,2.504975,2.144145,2.162471,NaN,3.5931420000000003,NaN,NaN,NaN,NaN,NaN,NaN,NaN,NaN,NaN,NaN,2.8917776400000004,2.850721099999999,2.9032898749019607,2.787512296971551,2.8852910769230755,3.630817098635762,2.139765055210389,NaN,NaN,2.8917776400000004,2.850721099999999,2.2705303333333333,207614556,104395895.8,32.907077852564015,NaN,1.5,2.75,NaN,NaN,0.289902420130414,1.9887233536244056,-11.830264951984919,-0.08387872070756436,-0.12958351285283998,-0.04570479214527562,120.08889307055287,-36.5837958501639,50.75189971880602,18.560027292368815,30.68807298882517,381015292
1232548200,2.263311,2.434976,2.141645,2.424142,NaN,3.602569,NaN,NaN,NaN,NaN,NaN,NaN,NaN,NaN,NaN,NaN,2.8682612,2.826971349999999,2.8844997621607074,2.752905602021879,2.8384966153846136,3.616839996985281,2.060153233783946,NaN,NaN,2.8682612,2.826971349999999,2.3335876666666664,180904484,108580347.2,40.18340580937205,NaN,1.5,2.75,NaN,NaN,0.29014731869252725,1.6660886492357798,-6.3412186204597765,-0.07671586474935324,-0.14159962308196716,-0.06488375833261392,146.692065789178,-22.38528326751624,53.12679367661919,16.90654363109152,29.966662692289297,561919776
1232634600,2.284977,2.421642,2.175812,2.302477,NaN,3.611996,NaN,NaN,NaN,NaN,NaN,NaN,NaN,NaN,NaN,NaN,2.8372281800000003,2.8037632499999994,2.8616753401151893,2.7100076399245574,2.7595230769230756,3.531019958223103,1.988026195623048,NaN,NaN,2.8372281800000003,2.8037632499999994,2.299977,200989816,114812114.6,38.11368734292496,NaN,1.5,2.75,NaN,NaN,0.28716036735734674,1.750597632490605,-11.204426784911885,-0.07537759623408544,-0.15910575362522072,-0.08372815739113529,143.27741952908502,-27.020591017087973,50.3460879520589,18.85051411430531,30.803397933635793,360929960
1232721000,2.144979,2.414976,2.124979,2.344977,NaN,3.621423,NaN,NaN,NaN,NaN,NaN,NaN,NaN,NaN,NaN,NaN,2.8100451200000003,2.7870551499999996,2.841412660110672,2.6752428170745994,2.683818769230768,3.4086131294173305,1.9590244090442055,NaN,NaN,2.8100451200000003,2.7870551499999996,2.294977333333333,213453140,122035880.8,39.290026430359916,NaN,1.5,2.75,NaN,NaN,0.2873629839746791,1.749101482291264,-9.336860219016902,-0.06711179296423439,-0.16761789859642828,-0.10050610563219389,144.1995003847058,-20.44104929276658,50.29979050419256,18.88380354492768,30.816405950879773,574383100
1232980200,2.387475,2.536641,2.315809,2.37081,NaN,3.63085,NaN,NaN,NaN,NaN,NaN,NaN,NaN,NaN,NaN,NaN,2.7882853400000003,2.7700553499999994,2.822957653831822,2.646249215448447,2.603883692307691,3.210242810038777,1.9975245745766048,NaN,NaN,2.7882853400000003,2.7700553499999994,2.4077533333333334,203561008,131316155.6,40.03612839530844,NaN,1.5,2.75,NaN,NaN,0.28261077083363056,1.5501596667211601,-5.5471281749909345,-0.055847939836222674,-0.17031603042747223,-0.11446809059124956,143.63529529841625,-13.262181402301819,51.08349513613645,18.43131819356226,30.4851866703013,777944108
1233066600,2.419975,2.507475,2.374976,2.460809,NaN,3.640277,NaN,NaN,NaN,NaN,NaN,NaN,NaN,NaN,NaN,NaN,2.7760188000000006,2.754722149999999,2.8087557458384174,2.628588242548595,2.552922692307691,3.082609295533749,2.0232360890816325,NaN,NaN,2.7760188000000006,2.754722149999999,2.447753333333333,165792156,138646070.8,42.6791358748493,NaN,1.5,2.75,NaN,NaN,0.27218607291694263,1.195794118386224,-1.441953511667406,-0.03907322396431076,-0.163309620546638,-0.12423639658232724,142.78750357117528,-10.324881620384987,77.43012964831927,4.345598967111637,18.224271384569093,943736264
1233153000,2.625806,2.752472,2.594141,2.679973,NaN,3.6497040000000003,NaN,NaN,NaN,NaN,NaN,NaN,NaN,NaN,NaN,NaN,2.7592523000000004,2.7512221499999994,2.803705442080048,2.6334820289725385,2.516384615384614,2.92707764753808,2.1056915832311476,NaN,NaN,2.7592523000000004,2.7512221499999994,2.6755286666666667,189202100,145773908.8,48.618399128478195,NaN,1.5,2.75,NaN,NaN,0.2735772819943039,1.2979147061192062,4.4786521523311205,-0.011391700084460499,-0.13847602168790285,-0.12708432160344235,153.04088209750404,8.24635502981046,78.18532066155382,4.076916068173376,17.737763270272815,1132938364
1233239400,2.579141,2.604141,2.434143,2.446651,NaN,3.6591310000000004,NaN,NaN,NaN,NaN,NaN,NaN,NaN,NaN,NaN,NaN,2.746835940000001,2.7269311499999995,2.789703307096517,2.6156885976418205,2.477859999999999,2.8050423297278644,2.1506776702721333,NaN,NaN,2.746835940000001,2.7269311499999995,2.4949783333333335,157605736,150796688.2,43.45611504569422,NaN,1.5,2.75,NaN,NaN,0.27159533328042507,1.0451538285175683,-1.2453007094276458,-0.007175746909953207,-0.13605400524088385,-0.12887825833093064,150.33424917450992,-2.458150092353055,81.61655603332976,2.954841533696163,15.428602432974088,975332628
1233325800,2.478309,2.509975,2.244312,2.29331,NaN,3.668558,NaN,NaN,NaN,NaN,NaN,NaN,NaN,NaN,NaN,NaN,2.7356860200000006,2.6899731499999993,2.7702369028966536,2.584985874056885,2.4440141538461524,2.748756620927756,2.1392716867645487,NaN,NaN,2.7356860200000006,2.6899731499999993,2.349199,200636196,157559384,40.418656214898924,NaN,1.5,2.75,NaN,NaN,0.2711715951889661,1.2734004849879332,-5.501015821028881,-0.012768010533332985,-0.14483827149759687,-0.13207026096426389,154.2056198026049,-10.358330584120438,53.06963316122228,17.04744532306181,29.882921515715907,774696432
1233585000,2.187478,2.318311,2.166645,2.275811,NaN,3.677985,NaN,NaN,NaN,NaN,NaN,NaN,NaN,NaN,NaN,NaN,2.7236694800000008,2.6373070499999995,2.750847651802667,2.5555406479562293,2.4079889999999984,2.6700326441910436,2.145945355808953,NaN,NaN,2.7236694800000008,2.6373070499999995,2.2535890000000003,156571840,161029227.8,40.074412287735996,NaN,1.5,2.75,NaN,NaN,0.2626354812468971,0.9723193866051688,-7.331893390954391,-0.015516498761949826,-0.15146588441670117,-0.13594938565475134,153.140387878891,5.241226356330327,24.58388224476406,42.93081594535609,32.48530180987985,618124592
1233671400,2.320811,2.41331,2.241228,2.36081,NaN,3.687412,NaN,NaN,NaN,NaN,NaN,NaN,NaN,NaN,NaN,NaN,2.7226194800000005,2.5888908999999996,2.7355520576143273,2.536994871960398,2.399142923076922,2.6591880954184406,2.139097750735403,NaN,NaN,2.7226194800000005,2.5888908999999996,2.3384493333333336,160343860,163458417.4,42.63035912728517,NaN,1.5,2.75,NaN,NaN,0.25616737544354734,0.9809458732713755,-4.555109943187988,-0.009761935226282159,-0.14815180468760403,-0.13838986946132187,117.6777084738132,-2.6125532250173444,23.64247289532335,44.07760133843898,32.27992576623767,778468452
1233757800,2.408308,2.499975,2.312477,2.327476,NaN,3.696839,NaN,NaN,NaN,NaN,NaN,NaN,NaN,NaN,NaN,NaN,2.729236040000001,2.5347663999999996,2.719549074962785,2.5170406936784553,2.3852326923076905,2.6397184994626546,2.1307468851527265,NaN,NaN,2.729236040000001,2.5347663999999996,2.379976,184543376,166704307,41.8760258411846,NaN,1.5,2.75,NaN,NaN,0.25126242005472255,1.1070102465918892,-6.887360774336718,-0.0065089734932718135,-0.14652608632791164,-0.14001711283463983,96.85096576207536,1.0857437446714895,4.143418357882733,77.89252613193287,17.964055510184398,593925076
1233844200,2.279145,2.500807,2.235811,2.451642,NaN,3.7062660000000003,NaN,NaN,NaN,NaN,NaN,NaN,NaN,NaN,NaN,NaN,2.7338193200000007,2.5011833999999995,2.709042915160323,2.5108122466614597,2.377027615384614,2.615006131493867,2.139049099275361,NaN,NaN,2.7338193200000007,2.5011833999999995,2.3960866666666667,242675256,173016340.6,45.72830382469772,NaN,1.5,2.75,NaN,NaN,0.2522433900508138,1.4026146614731951,-3.6146667287850294,0.005071624383108403,-0.13367758235575433,-0.13874920673886273,96.51377471279194,4.548658686204599,25.347879509596734,42.01834131795361,32.63377917244966,836600332
1233930600,2.480809,2.687473,2.466643,2.651641,NaN,3.7156930000000004,NaN,NaN,NaN,NaN,NaN,NaN,NaN,NaN,NaN,NaN,2.734902660000001,2.4760170499999994,2.7067918596638396,2.5242245088841777,2.414656076923076,2.659624534041647,2.1696876198045048,NaN,NaN,2.734902660000001,2.4760170499999994,2.601919,174417436,176520113.6,51.324380103981525,NaN,1.5,2.75,NaN,NaN,0.25107107647575566,0.9880881699137996,1.781319433786801,0.02609267482675154,-0.10613336320542333,-0.13222603803217486,105.02366483865474,11.845360868226473,53.950927134546156,16.350267203033205,29.69880566242062,1011017768
1234189800,2.649139,2.729972,2.601641,2.66914,NaN,3.72512,NaN,NaN,NaN,NaN,NaN,NaN,NaN,NaN,NaN,NaN,2.733436000000001,2.462100499999999,2.7053153161476104,2.5380259842285415,2.4335020769230757,2.713659106107629,2.1533450477385223,NaN,NaN,2.733436000000001,2.462100499999999,2.666917666666667,123070936,176952111.2,51.79275395753849,NaN,1.5,2.75,NaN,NaN,0.24230392815605883,0.6955041969569901,3.4314380859645954,0.040222665717042666,-0.08194770588587152,-0.12217037160291419,105.07393752932495,8.465955708061873,78.62709026458701,3.945486367070603,17.427423368342378,1134088704
1234276200,2.595807,2.667472,2.247478,2.297645,NaN,3.734547,NaN,NaN,NaN,NaN,NaN,NaN,NaN,NaN,NaN,NaN,2.718822840000001,2.4403174499999993,2.6893282449261355,2.5151325571591565,2.4331303846153833,2.7139936975549843,2.1522670716757824,NaN,NaN,2.718822840000001,2.4403174499999993,2.4041983333333334,261924408,185758612.2,42.453378503769535,NaN,1.5,2.75,NaN,NaN,0.25511521900205464,1.4100256504823308,-2.9915922852025982,0.024376392599663427,-0.09169988085333491,-0.11607627345299834,138.10594486293903,-14.266113875027838,46.58784818483977,21.846107363666363,31.56604445149385,872164296
1234362600,2.33331,2.374976,2.240811,2.337043,NaN,3.743974,NaN,NaN,NaN,NaN,NaN,NaN,NaN,NaN,NaN,NaN,2.7031976600000007,2.4199626999999997,2.6755131372819734,2.4981716469535225,2.4325200769230757,2.714180306434244,2.1508598474119074,NaN,NaN,2.7031976600000007,2.4199626999999997,2.31761,170143796,188083429,43.614616546878906,NaN,1.5,2.75,NaN,NaN,0.24647591764476504,0.9046187476728744,-0.9915922852025982,0.016738938370012085,-0.09515260049048324,-0.11189153886049533,126.5285673460493,-4.479919694308675,71.24328558844122,6.868706134923556,21.888008276635222,1042308092
1234449000,2.225812,2.35831,2.135812,2.351476,NaN,3.753401,NaN,NaN,NaN,NaN,NaN,NaN,NaN,NaN,NaN,NaN,2.7040609800000004,2.4137460499999994,2.6628057985650333,2.4842006329579487,2.431032846153845,2.7141809892644475,2.147884703043242,NaN,NaN,2.7040609800000004,2.4137460499999994,2.281866,226644056,191507438.2,44.059956177835005,NaN,1.5,2.75,NaN,NaN,0.24476320924156753,1.1834739064458961,-2.486903308428126,0.013015621355259938,-0.09562201216642041,-0.10863763352168035,116.71249399094621,2.5363339452581615,70.33455462666143,7.278352120926097,22.387093252412473,1268952148
1234535400,2.334142,2.394143,2.270811,2.279977,NaN,3.7628280000000003,NaN,NaN,NaN,NaN,NaN,NaN,NaN,NaN,NaN,NaN,2.6986110400000007,2.40232945,2.6477929045036595,2.4647507631524297,2.417122692307691,2.710630746951076,2.123614637664306,NaN,NaN,2.6986110400000007,2.40232945,2.3149770000000003,137587516,188369615.6,42.2785107332989,NaN,1.5,2.75,NaN,NaN,0.23608955143859842,0.7304124689204919,-5.387477964135739,0.006427147426733296,-0.10060369923826373,-0.10703084666499703,111.78988056833468,0.18305562280875318,47.3979329067338,21.22134387061242,31.380723222653774,1131364632
1234881000,2.073313,2.093679,1.958314,1.968314,NaN,3.7722550000000004,NaN,NaN,NaN,NaN,NaN,NaN,NaN,NaN,NaN,NaN,2.6830945600000007,2.37282975,2.6211466729544965,2.417471071423627,2.3623796923076914,2.7013184380133786,2.0234409466020042,NaN,NaN,2.6830945600000007,2.37282975,2.006769,262577216,191012944.4,35.53410342174355,NaN,1.5,2.75,NaN,NaN,0.24220194062155567,1.374656659132678,-13.430763638811507,-0.016953126839932636,-0.12822225521491282,-0.11126912837498018,139.97751455982822,-16.62548023771502,21.148167725493884,47.27325622057454,31.578576053931567,868787416
1234967400,2.026647,2.02998,1.906648,1.96248,NaN,3.781682,NaN,NaN,NaN,NaN,NaN,NaN,NaN,NaN,NaN,NaN,2.6718446600000005,2.3628302,2.5953166073484377,2.3741385884309008,2.3251357692307684,2.7205494655362212,1.9297220729253155,NaN,NaN,2.6718446600000005,2.3628302,1.9663693333333334,197616716,190513052.4,35.420198899525715,NaN,1.5,2.75,NaN,NaN,0.23371123057715884,1.037287017926127,-18.023247617107902,-0.030076611723157384,-0.14886489302892691,-0.11878828130576953,136.48734753012926,-15.68205214575789,25.72389312976726,41.60361311168475,32.67249375854801,671170700
1235053800,2.023313,2.04748,1.885814,1.898581,NaN,3.791109,NaN,NaN,NaN,NaN,NaN,NaN,NaN,NaN,NaN,NaN,2.6541835000000003,2.33655215,2.567993642354381,2.3288473895327195,2.2947719999999996,2.751211263053947,1.838332736946052,NaN,NaN,2.6541835000000003,2.33655215,1.9439583333333332,187369404,190836298.4,34.129749368978594,NaN,1.5,2.75,NaN,NaN,0.22856514267879038,0.981833150039762,-21.910727520592935,-0.0397204069323448,-0.16843878997120054,-0.12871838303885574,136.70115682798422,-22.558799367933815,8.267067679258647,68.04522703474481,23.68770528599655,483801296
1235140200,1.790816,1.937481,1.724983,1.835815,NaN,3.800536,NaN,NaN,NaN,NaN,NaN,NaN,NaN,NaN,NaN,NaN,2.6290670600000006,2.31321905,2.539280754418915,2.2818919238629367,2.2609261538461536,2.7790543156539895,1.7427979920383176,NaN,NaN,2.6290670600000006,2.31321905,1.8327596666666668,292914480,195432531.6,32.863220135233064,NaN,1.5,2.75,NaN,NaN,0.22741748963030536,1.498801031752075,-27.144830436407005,-0.04651482013103925,-0.1868619082026548,-0.14034708807161556,128.7390759979834,-30.76683457526868,0,100,0,190886816
1235399400,1.905814,1.923314,1.635817,1.655817,NaN,3.809963,NaN,NaN,NaN,NaN,NaN,NaN,NaN,NaN,NaN,NaN,2.6038340000000004,2.2787610499999995,2.5046351169907224,2.222265740637895,2.2066959230769223,2.811912463207534,1.6014793829463103,NaN,NaN,2.6038340000000004,2.2787610499999995,1.738316,267400496,198129899.4,29.48413997619157,NaN,1.5,2.75,NaN,NaN,0.2317088832281407,1.3496221257355567,-33.35276580482552,-0.05854257720076178,-0.21352530957256777,-0.154982732371806,114.79087890141622,-37.96440051851907,0,100,0,-76513680
1235485800,1.684983,1.857481,1.657483,1.834147,NaN,3.8193900000000003,NaN,NaN,NaN,NaN,NaN,NaN,NaN,NaN,NaN,NaN,2.5803342000000002,2.2519278999999996,2.478341465344027,2.1853020510533336,2.168747538461538,2.8002090376046533,1.537286039318422,NaN,NaN,2.5803342000000002,2.2519278999999996,1.783037,277953112,201849504.6,36.45535891925791,NaN,1.5,2.75,NaN,NaN,0.22956282014041637,1.3770314301777087,-26.446936659062054,-0.05021889170576216,-0.2177563470040087,-0.16753745529824654,141.1928595907565,-20.172742090270695,6.168666788850437,72.66627596831205,21.165057242837502,201439432
1235572200,1.802482,1.894148,1.69915,1.77665,NaN,3.8288170000000004,NaN,NaN,NaN,NaN,NaN,NaN,NaN,NaN,NaN,NaN,2.56013442,2.21771995,2.450824152977595,2.1463828080958733,2.1168250769230763,2.7576372390243424,1.4760129148218102,NaN,NaN,2.56013442,2.21771995,1.7899826666666667,343836268,210751710.2,35.24550991098941,NaN,1.5,2.75,NaN,NaN,0.22709390441610092,1.6314755769891731,-30.239033704233762,-0.044511126824735514,-0.22317636382916595,-0.17866523700443043,121.78337496316415,-23.978720117687175,5.025073071572631,75.50293235832689,19.471994570100488,-142396836
1235658600,1.845814,1.885814,1.688316,1.695817,NaN,3.8382440000000004,NaN,NaN,NaN,NaN,NaN,NaN,NaN,NaN,NaN,NaN,2.5368380000000004,2.16851215,2.421216029331415,2.103471778753409,2.043300153846153,2.6395766981668083,1.4470236095254978,NaN,NaN,2.5368380000000004,2.16851215,1.7566490000000001,297255836,216154397,33.55930278857795,NaN,1.5,2.75,NaN,NaN,0.2249799112435223,1.3752014306699485,-32.40615819798777,-0.04212997991358125,-0.231327711896407,-0.18919773198282575,119.06439119397332,-27.882870163250658,4.430209327047252,77.09488439473351,18.474906278219226,-439652672
1235745000,1.589984,1.699982,1.574151,1.58665,NaN,3.847671,NaN,NaN,NaN,NaN,NaN,NaN,NaN,NaN,NaN,NaN,2.5138048800000004,2.1255121,2.388487949749791,2.0542506569673704,1.9600316923076915,2.4810484953117253,1.4390148893036576,NaN,NaN,2.5138048800000004,2.1255121,1.620261,333976200,224972920.2,31.376102978875494,NaN,1.5,2.75,NaN,NaN,0.2178978461546993,1.4845173352557124,-36.01371869694315,-0.043670903294752594,-0.2437863611012665,-0.2001154578065139,117.8288147472576,-30.409385708715494,4.458942373477337,77.01584079472451,18.525216831798144,-773628872
1236004200,1.492485,1.519986,1.35832,1.371654,NaN,3.857098,NaN,NaN,NaN,NaN,NaN,NaN,NaN,NaN,NaN,NaN,2.4781219200000004,2.0794293,2.3486121085831324,1.9892414515419066,1.8888016153846148,2.4567905934480647,1.3208126373211648,NaN,NaN,2.4781219200000004,2.0794293,1.4166533333333333,332223992,231552310,27.571844145046285,NaN,1.5,2.75,NaN,NaN,0.2186430000007922,1.434768636080547,-44.13604731761729,-0.054243551323964356,-0.26791989696146934,-0.21367634563750498,132.28289143482485,-30.313252865142452,4.575068754842981,76.69422898789612,18.730702257260884,-1105852864
1236090600,1.429986,1.429986,1.30582,1.339987,NaN,3.866525,NaN,NaN,NaN,NaN,NaN,NaN,NaN,NaN,NaN,NaN,2.4434223000000004,2.0326381000000002,2.309058182756343,1.9274076942522012,1.8121049999999992,2.386505993687269,1.2377040063127294,NaN,NaN,2.4434223000000004,2.0326381000000002,1.3585976666666666,329437084,240195572.2,27.051578800198172,NaN,1.5,2.75,NaN,NaN,0.21189464285787846,1.3715368729848718,-48.194935868832566,-0.058099613192983346,-0.2863008621287342,-0.22820124893575083,117.6438065505312,-31.719711793241203,0,100,0,-1435289948
1236177000,1.407486,1.498318,1.362487,1.424987,NaN,3.8759520000000003,NaN,NaN,NaN,NaN,NaN,NaN,NaN,NaN,NaN,NaN,2.4138226200000004,1.9858469500000002,2.274388724609035,1.8795581043234202,1.7408366153846149,2.2567983092290254,1.2248749215402046,NaN,NaN,2.4138226200000004,1.9858469500000002,1.4285973333333333,362263076,250291533,30.82474997442462,NaN,1.5,2.75,NaN,NaN,0.20806866836802998,1.4473644859572616,-42.94039787853072,-0.049965871688250674,-0.2906585885460642,-0.24069271685781352,129.90562737733342,-24.944629699759982,5.395062042270729,74.55103271368151,20.053905244047748,-1073026872
1236263400,1.339987,1.387485,1.224154,1.258321,NaN,3.8853790000000004,NaN,NaN,NaN,NaN,NaN,NaN,NaN,NaN,NaN,NaN,2.3810063,1.9323892000000005,2.234542931487112,1.8203926658164278,1.6622476923076919,2.1352289558477278,1.189266428767656,NaN,NaN,2.3810063,1.9323892000000005,1.2899866666666668,382207468,260174737.6,27.789565213908404,NaN,1.5,2.75,NaN,NaN,0.2075518349131707,1.4690414277946409,-51.85570822762624,-0.050690391733692386,-0.30405570652492897,-0.2533653147912366,140.3061520722728,-31.457091264642678,5.50613449235041,74.2724649806813,20.22140052696828,-1455234340
1236349800,1.292487,1.348319,1.166655,1.259237,NaN,3.8948060000000004,NaN,NaN,NaN,NaN,NaN,NaN,NaN,NaN,NaN,NaN,2.3508582600000003,1.8727689500000004,2.196295640056245,1.7669492690720061,1.607703307692307,2.090364683079543,1.1250419323050713,NaN,NaN,2.3508582600000003,1.8727689500000004,1.2580703333333334,396619900,267871969.8,27.83162486273585,NaN,1.5,2.75,NaN,NaN,0.20570270384794423,1.4806323345295382,-54.84929110797855,-0.04611889257347945,-0.3110139305080859,-0.26489503793460645,142.3437360546717,-23.950714360342968,24.003687916069705,43.63476847816023,32.361543605770066,-1058614440
1236605400,1.209155,1.32582,1.202488,1.216655,NaN,3.9042330000000005,NaN,NaN,NaN,NaN,NaN,NaN,NaN,NaN,NaN,NaN,2.3216085800000004,1.8010196500000006,2.157878360054039,1.7145402910651484,1.5503321538461532,2.0279512320057878,1.0727130756865186,NaN,NaN,2.3216085800000004,1.8010196500000006,1.248321,351151348,276708665.4,27.04306113317925,NaN,1.5,2.75,NaN,NaN,0.19981908214451963,1.2690290977783019,-59.633077828205046,-0.041138423171799776,-0.31631806689935615,-0.2751796437275564,136.11478367556398,-33.66644003997499,25.42875107480717,41.961935919427994,32.60931300576483,-1409765788
1236691800,1.299987,1.440818,1.289987,1.432486,NaN,3.91366,NaN,NaN,NaN,NaN,NaN,NaN,NaN,NaN,NaN,NaN,2.29604218,1.7391869500000006,2.129431600836234,1.6876779776303723,1.5144786923076918,1.950294209168728,1.0786631754466556,NaN,NaN,2.29604218,1.7391869500000006,1.3877636666666666,385704208,289840329,36.815076675893664,NaN,1.5,2.75,NaN,NaN,0.20155793341991107,1.3307472059900953,-50.174666837899196,-0.01957762683374048,-0.29965167726973196,-0.2800740504359915,160.2485547345714,-19.371513804069462,53.40932344511436,16.74060091263741,29.850075642248214,-1024061580
1236778200,1.492485,1.533317,1.419985,1.458319,NaN,3.923087,NaN,NaN,NaN,NaN,NaN,NaN,NaN,NaN,NaN,NaN,2.2698591,1.6972206500000007,2.10311345962697,1.6658342654750988,1.485440538461538,1.880106662933752,1.0907744139893238,NaN,NaN,2.2698591,1.6972206500000007,1.4705403333333333,447996732,299143945.2,37.88744176447379,NaN,1.5,2.75,NaN,NaN,0.19525608103277456,1.4975958537301528,-47.7676664653087,-0.0008354624761646168,-0.28111837853119725,-0.28028291605503264,161.96560339273609,-14.00493095658317,56.21060156570782,14.899489026416335,28.88990940787585,-576064848
1236864600,1.458319,1.649149,1.422487,1.635817,NaN,3.9325140000000003,NaN,NaN,NaN,NaN,NaN,NaN,NaN,NaN,NaN,NaN,2.24757598,1.6621593500000007,2.0847881082690494,1.662975478286994,1.4839020769230764,1.8760474813437886,1.0917566725023642,NaN,NaN,2.24757598,1.6621593500000007,1.569151,341704664,307721988.6,44.81745740187783,NaN,1.5,2.75,NaN,NaN,0.19749936095900494,1.1104330423529571,-39.43003316608895,0.02483835290732317,-0.24923497492087865,-0.2740733278282018,177.85447359140542,3.098793054548904,82.2797345732611,2.7376578760270136,14.98260755071191,-234360184
1236951000,1.673317,1.694983,1.584984,1.673317,NaN,3.9419410000000004,NaN,NaN,NaN,NaN,NaN,NaN,NaN,NaN,NaN,NaN,2.2223929,1.6282514000000006,2.0686519863761457,1.663960385116804,1.4715305384615378,1.8271428388411812,1.1159182380818944,NaN,NaN,2.2223929,1.6282514000000006,1.6510946666666664,373286484,315054110,46.183587403985456,NaN,1.5,2.75,NaN,NaN,0.19124933517621884,1.1848329291752455,-36.50828961713506,0.04451997210938241,-0.21842336269147378,-0.2629433348008562,173.63120834265317,21.992645375583056,83.16488014218488,2.4847532786474202,14.3503665791677,138926300
1237210200,1.731649,1.791649,1.644984,1.652483,NaN,3.9513680000000004,NaN,1.216655,NaN,NaN,NaN,NaN,NaN,NaN,NaN,NaN,2.19479316,1.5968767000000006,2.052331633969238,1.6628673008199657,1.4619792307692303,1.7898888345858486,1.134069626952612,NaN,NaN,2.19479316,1.5968767000000006,1.696372,317373796,324043424,45.50949655942269,NaN,1.5,2.75,NaN,NaN,0.18806473980648894,0.9794174869600193,-34.43698022917653,0.0555898462091064,-0.19345602703947318,-0.24904587324857957,145.9570113251255,23.3208232617182,80.59590675768835,3.2901874607890944,16.113905781522543,-178447496
1237296600,1.659983,1.808357,1.622484,1.802649,NaN,3.960795,NaN,1.216655,NaN,NaN,NaN,NaN,NaN,NaN,NaN,NaN,2.1642634800000002,1.5885934500000005,2.042540158127307,1.6761798435990165,1.470197076923076,1.8253582157808423,1.1150359380653099,NaN,NaN,2.1642634800000002,1.5885934500000005,1.7444966666666666,275566528,324692889.6,51.05479072981711,NaN,1.5,2.75,NaN,NaN,0.1879081869631683,0.8486989916517099,-29.62513586824317,0.07146786423214677,-0.1597110429583961,-0.23117890719054288,148.0575083829524,26.502838271507038,80.15968569569917,3.4306442261810712,16.40967007811976,97119032
1237383000,1.777482,1.995813,1.729982,1.929147,NaN,3.970222,NaN,1.216655,NaN,NaN,NaN,NaN,NaN,NaN,NaN,NaN,2.1362637600000003,1.5869268000000005,2.0380933676125106,1.7002719537324436,1.4965429999999993,1.9254964711314173,1.0675895288685813,NaN,NaN,2.1362637600000003,1.5869268000000005,1.8849806666666666,387890532,334206580.4,55.191551498267295,NaN,1.5,2.75,NaN,NaN,0.19347410218008484,1.160631043038553,-24.34325125337834,0.08785385558886236,-0.12136158770446492,-0.20921544329332728,148.5967719271849,53.311198017040155,80.89159278863781,3.196491431682857,15.911915779679331,485009564
1237469400,2.00248,2.004147,1.845814,1.864148,NaN,3.979649,NaN,1.216655,NaN,NaN,NaN,NaN,NaN,NaN,NaN,NaN,2.1053474000000003,1.5852051500000006,2.0312719806473143,1.7158791962341156,1.5344271538461531,1.9981518621428196,1.0707024455494867,NaN,NaN,2.1053474000000003,1.5852051500000006,1.9047030000000003,294113916,339543806,52.72562757779642,NaN,1.5,2.75,NaN,NaN,0.19096402345293592,0.8662031549472589,-25.51839055616435,0.09127812617057457,-0.09511778558010908,-0.18639591175068365,120.72157827784241,48.03789914051128,55.50671137630498,15.483611772395614,29.009676851299393,190895648
1237555800,1.88998,1.898314,1.729149,1.737483,NaN,3.9890760000000003,NaN,1.216655,NaN,NaN,NaN,NaN,NaN,NaN,NaN,NaN,2.07763102,1.5802885500000003,2.019750844151341,1.717936701354676,1.5650037692307686,2.0258233025528396,1.1041842359086973,NaN,NaN,2.07763102,1.5802885500000003,1.7883153333333333,223127924,336054478.2,48.20561794051464,NaN,1.5,2.75,NaN,NaN,0.1894069503491548,0.6639635489910278,-30.643246743746225,0.08225531398835312,-0.08357676926524227,-0.16583208325359539,135.04096004448178,42.808191311423535,30.91803647621614,36.0469640110828,33.03499951270107,-32232276
1237815000,1.882481,2.120812,1.860815,2.117479,NaN,3.9985030000000004,NaN,1.216655,NaN,NaN,NaN,NaN,NaN,NaN,NaN,NaN,2.0568812400000005,1.6033716500000004,2.0235833208512886,1.7559883488447068,1.618272384615384,2.155756175394683,1.080788593836085,NaN,NaN,2.0568812400000005,1.6033716500000004,2.0330353333333333,296740692,337521488,59.439461998884575,NaN,1.5,2.75,NaN,NaN,0.20325852532421518,0.8791757045109969,-21.82907320492741,0.09805034706224808,-0.0432691494257853,-0.14131949648803338,157.03052431203798,47.81847780711295,58.08626538793976,13.718039379586596,28.195695232473653,264508416
1237901400,2.02498,2.122479,1.976647,1.978314,NaN,4.00793,NaN,1.216655,NaN,NaN,NaN,NaN,NaN,NaN,NaN,NaN,2.0374981,1.6105800000000001,2.0218080533669243,1.7771622203833062,1.673656461538461,2.199621508699825,1.1476914143770973,NaN,NaN,2.0374981,1.6105800000000001,2.0258133333333332,272196320,337233648.4,54.755541695574934,NaN,1.5,2.75,NaN,NaN,0.19915663065819977,0.807144605206009,-25.922675012330735,0.09521760426758488,-0.022297491153552285,-0.11751509542113717,154.96616764749172,35.657150458850225,31.98978926048825,34.721084917142214,33.28912582236955,-7687904
1237987800,2.03748,2.144979,1.864981,2.033312,NaN,4.0173570000000005,NaN,1.216655,NaN,NaN,NaN,NaN,NaN,NaN,NaN,NaN,2.02349822,1.6234131000000005,2.0222591885290058,1.801557437489658,1.7332006923076917,2.2326140145867184,1.233787370028665,NaN,NaN,2.02349822,1.6234131000000005,2.014424,373023056,338692987.8,56.223707683842356,NaN,1.5,2.75,NaN,NaN,0.20493101418261409,1.1013604338932228,-22.303282798159962,0.0930318383758418,-0.001225297451334928,-0.09425713582717672,154.73855302176977,24.299478486896756,32.23211739442078,34.47266254019665,33.295220065382544,365335152
1238074200,2.10998,2.184978,2.049146,2.172978,NaN,4.026784,NaN,1.216655,NaN,NaN,NaN,NaN,NaN,NaN,NaN,NaN,2.01207502,1.6472711500000006,2.0281697301553194,1.8369308243954048,1.8067639999999996,2.2597298710336027,1.3537981289663965,NaN,NaN,2.01207502,1.6472711500000006,2.1357006666666667,333359300,340498161,59.79192675675437,NaN,1.5,2.75,NaN,NaN,0.20112637031242736,0.9790340688506685,-16.787312717936,0.09655744211472493,0.026439666816229446,-0.07011777529849549,147.74658867793272,29.86051059064123,62.176521606984316,11.321866668027605,26.50161172498807,698694452
1238160600,2.085812,2.124146,2.029147,2.044146,NaN,4.036211000000001,NaN,1.216655,NaN,NaN,NaN,NaN,NaN,NaN,NaN,NaN,2.00344176,1.6701459500000007,2.0287962505413852,1.8566656030244137,1.8538147692307687,2.2668023384891436,1.440827199972394,NaN,NaN,2.00344176,1.6701459500000007,2.065813,249685632,336283632.6,55.313157179470714,NaN,1.5,2.75,NaN,NaN,0.19703384386153971,0.7424852350664181,-22.96004016231293,0.08612301467483466,0.037535993045047844,-0.048587021629786814,156.4784692871716,23.701484372305195,58.26667490972024,13.60768869990969,28.12563639037006,449008820
1238419800,1.908313,1.909148,1.781566,1.842482,NaN,4.045638,NaN,1.216655,NaN,NaN,NaN,NaN,NaN,NaN,NaN,NaN,1.9901252200000001,1.6936873500000005,2.021489809343684,1.8553147836887554,1.8833657692307688,2.2282960888572596,1.538435449604278,NaN,NaN,1.9901252200000001,1.6936873500000005,1.8443986666666667,216827000,330513783,49.11174182750781,NaN,1.5,2.75,NaN,NaN,0.201715712157144,0.6560301299144309,-30.797678290510188,0.06264144020880205,0.029714778631215744,-0.0329266615775863,171.4529189498707,2.209692513628555,34.84800657853016,31.85625380183458,33.29573961963526,232181820
1238506200,1.902481,2.000812,1.862482,1.884981,NaN,4.055065000000001,NaN,1.216655,NaN,NaN,NaN,NaN,NaN,NaN,NaN,2.45509303,1.9766586800000001,1.7209370500000005,2.0161365227027552,1.8581401376231597,1.9025322307692305,2.216622678860618,1.588441782677843,NaN,2.45509303,1.9766586800000001,1.7209370500000005,1.9160916666666663,222666928,325175275.2,50.374449238169404,NaN,1.5,2.75,NaN,NaN,0.198616732717348,0.6847597126289755,-26.05008073599037,0.047652249424412055,0.02663865020292877,-0.021013599221483284,164.87616755880947,-2.2894056284979802,59.27802289959236,12.990835698719197,27.731141401688443,454848748
1238592600,1.820816,2.029147,1.804148,1.998479,NaN,4.064492,NaN,1.216655,NaN,NaN,NaN,NaN,NaN,NaN,NaN,2.43257824,1.9733788400000003,1.7496116500000007,2.015444070832059,1.8715057435638112,1.9275446923076918,2.2153238221613236,1.6397655624540597,NaN,2.43257824,1.9733788400000003,1.7496116500000007,1.9439246666666667,260872816,320105762.2,53.68002873100982,NaN,1.5,2.75,NaN,NaN,0.20050118038039458,0.8149582007118271,-20.34920361049468,0.043194059554137895,0.03297897522118909,-0.010215084332948808,163.64705974510076,7.206026560122908,54.93240548378326,15.710549406571277,29.357045109645462,715721564
1238679000,2.170812,2.268311,2.134979,2.176645,NaN,4.073919,NaN,1.216655,NaN,NaN,NaN,NaN,NaN,NaN,NaN,2.41834505,1.9684289000000001,1.7955278500000005,2.0217656758974685,1.9005666251291624,1.9678648461538457,2.236429364040326,1.6993003282673653,NaN,2.41834505,1.9684289000000001,1.7955278500000005,2.1933116666666668,334140748,317702426.2,58.3680572785443,NaN,1.5,2.75,NaN,NaN,0.205453381781795,1.0517412535894572,-12.161814934406722,0.049598715402026886,0.0517833099195848,0.002184594517557913,167.87586391722408,25.275758093748255,54.990942464247844,15.672223817201647,29.336833718550512,1049862312
1238765400,2.178312,2.249978,2.125811,2.247478,NaN,4.083346000000001,NaN,1.216655,NaN,NaN,NaN,NaN,NaN,NaN,NaN,2.40227855,1.9673289200000001,1.8449399000000006,2.030617139587764,1.9336058036882897,2.0020824615384614,2.2903551306553296,1.7138097924215931,NaN,2.40227855,1.9673289200000001,1.8449399000000006,2.207755666666667,205640392,308153450.8,60.0971617868921,NaN,1.5,2.75,NaN,NaN,0.19964721165452395,0.6673311347516475,-8.628967264576072,0.05551346303929768,0.07157642331668002,0.016062960277382334,158.77115553661235,6.139328890628913,82.16175193330074,2.7680015616392253,15.070246505060046,1255502704
1239024600,2.176645,2.211644,2.099979,2.199145,NaN,4.092773,NaN,1.216655,NaN,NaN,NaN,NaN,NaN,NaN,NaN,2.3872287,1.9644122800000003,1.8940644000000006,2.0372260752902047,1.9588952509560718,2.022851538461538,2.325651361397789,1.7200517155252872,NaN,2.3872287,1.9644122800000003,1.8940644000000006,2.170256,206779344,300934850.6,58.317305984304895,NaN,1.5,2.75,NaN,NaN,0.19592233939348655,0.6871232879399843,-12.37229466142503,0.053079662718468305,0.08241253867546772,0.02933287595699941,116.0488688251926,11.162585919121042,80.35567417713368,3.333050587281254,16.311275235585082,1048723360
1239111000,2.085812,2.122479,2.02998,2.033312,NaN,4.102200000000001,NaN,1.216655,NaN,NaN,NaN,NaN,NaN,NaN,NaN,2.37297383,1.95766232,1.9241057000000008,2.0370725821415694,1.9659825603888268,2.0358641538461537,2.3244716720432814,1.747256635649026,NaN,2.37297383,1.95766232,1.9241057000000008,2.061923666666667,216050928,292452186.6,52.56503063041396,NaN,1.5,2.75,NaN,NaN,0.19401110086538037,0.7387564118147715,-17.077700602512635,0.037921183323412225,0.0767343551112647,0.03881317178785247,118.52839911544123,0,57.28550213615365,14.243935349462262,28.470562514384085,832672432
1239197400,2.070813,2.133313,2.036646,2.103313,NaN,4.111627,NaN,1.216655,NaN,NaN,NaN,NaN,NaN,NaN,NaN,2.3632655999999996,1.9505124,1.9563554000000007,2.039670245586998,1.9790616498756053,2.0640049230769226,2.2966682783211785,1.8313415678326668,NaN,2.3632655999999996,1.9505124,1.9563554000000007,2.0910906666666667,220069144,281055807.2,54.60070941486629,NaN,1.5,2.75,NaN,NaN,0.18729609366071034,0.7830087063221515,-12.76492887194307,0.03054569902203276,0.07699529556539342,0.04644959654336066,119.07279426400238,-3.205968951365365,56.143805636294694,14.965593143662508,28.890601220042807,1052741576
1239283800,2.274143,2.35581,2.247478,2.349977,NaN,4.121054,NaN,1.216655,NaN,NaN,NaN,NaN,NaN,NaN,NaN,2.35158239,1.9439124799999998,1.9920634000000006,2.0518391379169194,2.014386921316024,2.0818893846153843,2.3596231919683834,1.804155577262385,NaN,2.35158239,1.9439124799999998,1.9920634000000006,2.317755,244692812,276205214.6,60.95871542300426,NaN,1.5,2.75,NaN,NaN,0.1919533012563739,0.8859094581337422,-5.498920903679355,0.03963968045437555,0.09599919711133009,0.056359516656954545,129.89951157521463,14.961309025871927,52.90313154791265,17.110247685637226,29.986620766450134,1297434388
1239629400,2.282477,2.417475,2.258312,2.36631,NaN,4.1304810000000005,NaN,1.216655,NaN,NaN,NaN,NaN,NaN,NaN,NaN,2.3445708,1.9423056599999997,2.0267130500000006,2.064171328586844,2.0479034050002123,2.1117352307692303,2.420220052692478,1.8032504088459826,NaN,2.3445708,1.9423056599999997,2.0267130500000006,2.3473656666666667,182191724,266650476.6,61.344749140400616,NaN,1.5,2.75,NaN,NaN,0.1896111368809186,0.6832604476207413,-3.437368090870525,0.04379014923344263,0.11109720319875782,0.0673070539653152,122.35186044724998,28.43056268663683,52.40905331836778,17.46459034583795,30.126356335794256,1479626112
1239715800,2.291644,2.362276,2.221644,2.242478,NaN,4.139908,NaN,1.216655,NaN,1.216655,NaN,NaN,NaN,NaN,NaN,2.3384875199999997,1.94128902,2.056212800000001,2.0711637470736344,2.066434318809716,2.127824923076923,2.440066165812247,1.815583680341599,NaN,2.3384875199999997,1.94128902,2.056212800000001,2.275466,226105492,262087061.4,56.762152769060926,NaN,1.5,2.75,NaN,NaN,0.18640076996085297,0.8627113860264756,-7.431849578240466,0.03557973616452667,0.11178172417097354,0.07620198800644687,107.04990933103198,18.965549254873135,50.4586531617048,18.83941188433138,30.701934953963807,1253520620
1239802200,2.195812,2.318311,2.176645,2.312477,NaN,4.149335000000001,NaN,1.216655,NaN,1.216655,NaN,NaN,NaN,NaN,NaN,2.3328459099999996,1.9420223399999998,2.081704200000001,2.080627011894276,2.0898669551135525,2.138555615384615,2.4655080220463033,1.811603208722927,NaN,2.3328459099999996,1.9420223399999998,2.081704200000001,2.269144333333333,229151408,259766305.4,58.6428896067671,NaN,1.5,2.75,NaN,NaN,0.18320542924936348,0.8821444630670718,-3.502473037362766,0.032340913423189274,0.11662812978543347,0.08428721636224419,107.23173670969553,15.711848861058835,77.07310916591844,4.461532781719325,18.465358052362237,1482672028
1239888600,2.361643,2.469975,2.278311,2.414976,NaN,4.158762,NaN,1.216655,NaN,1.216655,NaN,NaN,NaN,NaN,NaN,2.3328625699999996,1.9431056599999996,2.105995650000001,2.09373873691803,2.120829721293214,2.1670809999999996,2.5198001442746563,1.814361855725343,NaN,2.3328625699999996,1.9431056599999996,2.105995650000001,2.3877539999999997,259437600,253343658.8,61.29758393399835,NaN,1.5,2.75,NaN,NaN,0.18380961287440892,1.0240540506475073,1.449678971997359,0.03438833421395818,0.12727263412969192,0.09288429991573374,105.61431932096272,10.949465806321179,78.68389551478201,3.891465754253217,17.42463873096475,1742109628
1239975000,2.439976,2.510667,2.385809,2.469975,NaN,4.168189,NaN,1.216655,NaN,1.216655,NaN,NaN,NaN,NaN,NaN,2.33759584,1.9459556399999998,2.1362870000000007,2.108493100176146,2.1540816525986224,2.215349692307692,2.5483671696918577,1.8823322149235258,NaN,2.33759584,1.9459556399999998,2.1362870000000007,2.4554836666666664,211138748,249194900.4,62.681803027519614,NaN,1.5,2.75,NaN,NaN,0.1795987833833797,0.8472835826940541,5.236993323883138,0.03653202385698366,0.13854932973696332,0.10201730587997966,96.96494256320041,9.899852189876817,78.18187740537196,4.065349000374019,17.75277359425402,1953248376
1240234200,2.33081,2.342477,2.145812,2.152312,NaN,4.177616,NaN,1.216655,NaN,1.216655,NaN,NaN,NaN,NaN,NaN,2.33689418,1.9399690399999994,2.157028450000001,2.1102114884045324,2.1539131142558965,2.235913615384615,2.513130544862694,1.9586966859065356,NaN,2.33689418,1.9399690399999994,2.157028450000001,2.2135336666666667,214110556,248744032,51.274892398499745,NaN,1.5,2.75,NaN,NaN,0.18992479885599542,0.8607666052466336,-3.0357027300040107,0.014757995092542525,0.12046479974565782,0.1057068046531153,128.29778693156717,-2.129600367415534,55.279888150410436,15.626580816411733,29.093531033177836,1739137820
1240320600,2.102479,2.28331,2.095812,2.278311,NaN,4.187043,NaN,1.216655,NaN,1.216655,NaN,NaN,NaN,NaN,NaN,2.33370255,1.9325024399999995,2.165070050000001,2.1168036261141587,2.165760531945811,2.2574391538461533,2.498691521949759,2.0161867857425477,NaN,2.33370255,1.9325024399999995,2.165070050000001,2.219144333333334,271881436,247501069.2,54.789306073773794,NaN,1.5,2.75,NaN,NaN,0.18975145608056718,1.0985061069788704,2.5014445499588405,0.007414070269836537,0.11497439249041097,0.10756032222057443,132.2568425950641,12.04925756598102,82.1552970321328,2.8085217061645324,15.036181261702684,2011019256
1240407000,2.209144,2.389143,2.199145,2.237478,NaN,4.196470000000001,NaN,1.216655,NaN,1.216655,NaN,NaN,NaN,NaN,NaN,2.3286526,1.9238691999999995,2.1780282500000014,2.1215359545018386,2.172590766998591,2.262118615384615,2.499245571519656,2.0249916592495736,NaN,2.3286526,1.9238691999999995,2.1780282500000014,2.2752553333333334,284317016,248107104,53.443979454469044,NaN,1.5,2.75,NaN,NaN,0.18976906636052665,1.1459446804070552,4.1358950910975345,-0.0011640909411780448,0.10610520854410188,0.10726929948527993,122.796943073192,6.378746292159078,52.810303765758434,17.283689172103447,29.90600706213811,1726702240
1240493400,2.264144,2.30831,2.169977,2.301644,NaN,4.205897,NaN,1.216655,NaN,1.216655,NaN,NaN,NaN,NaN,NaN,2.3213860100000003,1.9239491799999993,2.191444850000001,2.1285990151096095,2.184881551093963,2.2662852307692303,2.504139159978093,2.0284313015603677,NaN,2.3213860100000003,1.9239491799999993,2.191444850000001,2.2599769999999997,259103324,242411117.4,55.30137525118673,NaN,1.5,2.75,NaN,NaN,0.18609506162048906,1.0688590803055305,7.452519881452934,-0.003362722141914326,0.10306589680788703,0.10642861894980135,122.43573981271848,-2.0567435340856512,52.22283258185831,17.69023583036803,30.08693158777366,1985805564
1240579800,2.354143,2.462475,2.327476,2.411643,NaN,4.215324000000001,NaN,1.216655,NaN,1.216655,NaN,NaN,NaN,NaN,NaN,2.3143194200000003,1.9254411799999993,2.203378100000001,2.1396987792229583,2.206477879561205,2.2826312307692302,2.5288423196967273,2.036420141841733,NaN,2.3143194200000003,1.9254411799999993,2.203378100000001,2.4005313333333334,262841604,238885232.6,58.367761268821546,NaN,1.5,2.75,NaN,NaN,0.18429048579045412,1.1002840198168031,11.770571481451846,0.001485087666091206,0.10828497853241537,0.10679989086632416,107.5615642032395,1.9157675875096793,54.34898002779851,16.241439354837265,29.40958061736423,2248647168
1240839000,2.329143,2.444142,2.314144,2.349977,NaN,4.224751,NaN,1.216655,NaN,1.216655,NaN,NaN,NaN,NaN,NaN,2.3147360900000002,1.9254111999999992,2.2186696500000016,2.147944983959313,2.2201444624601376,2.3069900769230767,2.508275527346807,2.1057046264993464,NaN,2.3147360900000002,1.9254111999999992,2.2186696500000016,2.369421,235792756,238190588.8,56.04650584389433,NaN,1.5,2.75,NaN,NaN,0.18041245109113596,0.989933133747726,7.708552279133865,-0.0004633040890857226,0.106220760754967,0.10668406484405273,108.7180562166536,4.793759403659692,50.19999627650487,19.00542332301813,30.79458040047702,2012854412
1240925400,2.274977,2.406643,2.258312,2.334142,NaN,4.234178,NaN,1.216655,NaN,1.216655,NaN,NaN,NaN,NaN,NaN,2.31255277,1.926494499999999,2.2432526500000014,2.1552468277256143,2.2310013707972676,2.324746153846154,2.488199947437156,2.1612923602551515,NaN,2.31255277,1.926494499999999,2.2432526500000014,2.333032333333333,191421736,236920325.6,55.43682129569919,NaN,1.5,2.75,NaN,NaN,0.1781209188703405,0.8079582683133034,8.948566153492596,-0.0036434020902273018,0.1021298122312686,0.1057732143214959,103.56133358334607,0.9368741829648488,25.72371816443346,41.64511633980689,32.63116549575964,1821432676
1241011800,2.395809,2.553308,2.38331,2.469142,NaN,4.2436050000000005,NaN,1.216655,NaN,1.216655,NaN,NaN,NaN,NaN,NaN,2.3098028100000003,1.936511059999999,2.272460700000001,2.1675564423246096,2.2536814307213375,2.3339126923076923,2.51446905283368,2.1533563317817044,NaN,2.3098028100000003,1.936511059999999,2.272460700000001,2.4685866666666665,213799128,236476935.6,59.483417219361,NaN,1.5,2.75,NaN,NaN,0.18105271037960188,0.9041013977009604,14.747272905864197,0.0022054376601434167,0.10853001139667517,0.10632457373653176,106.9380657257083,2.2429208406212062,54.376511218149076,16.11295937200585,29.51052940984507,2035231804
1241098200,2.571641,2.620807,2.441642,2.473308,NaN,4.253032,NaN,1.216655,NaN,1.216655,NaN,NaN,NaN,NaN,NaN,2.30928614,1.9467276199999992,2.2962021500000014,2.1795466994883506,2.274598246843115,2.3421433076923077,2.5370419043536083,2.147244711031007,NaN,2.30928614,1.9467276199999992,2.2962021500000014,2.5119190000000002,235925620,235229575.8,59.60531843805111,NaN,1.5,2.75,NaN,NaN,0.18091787392391606,1.0029589995119992,16.612108539451917,0.005052287962645036,0.11263993368983805,0.10758764572719301,104.33735211332127,0.13494063705098353,54.1300536443556,16.276932956927784,29.593013398716607,2271157424
1241184600,2.486642,2.549141,2.424142,2.522475,NaN,4.262459000000001,NaN,1.216655,NaN,1.216655,NaN,NaN,NaN,NaN,NaN,2.3066945000000003,1.9592054999999993,2.313493650000001,2.1929948681358664,2.2982055566675803,2.3636815384615386,2.5712376182822285,2.1561254586408487,NaN,2.3066945000000003,1.9592054999999993,2.313493650000001,2.498586,139582116,225501644.2,61.09310601311922,NaN,1.5,2.75,NaN,NaN,0.17692366864363637,0.6189849147006796,19.73518765923191,0.008728656343587216,0.11849846615667703,0.10976980981308981,104.15019802134418,17.19838945283027,48.08596482951803,20.563647432015824,31.35038773846615,2410739540
1241443800,2.572474,2.775639,2.564141,2.774138,NaN,4.271886,NaN,1.216655,NaN,1.216655,NaN,NaN,NaN,NaN,NaN,2.30351951,1.9779719599999992,2.3398266500000013,2.215784794875636,2.3435324560325728,2.399193923076923,2.6976341654886085,2.100753680665237,NaN,2.30351951,1.9779719599999992,2.3398266500000013,2.704639333333333,203781812,225408715.2,67.65908369107981,NaN,1.5,2.75,NaN,NaN,0.18236940659766235,0.9040547159819844,25.965757456609996,0.025635156559209185,0.1418137555121013,0.1161785989528921,69.97117076633442,21.762919987657533,79.81314408517244,3.5099589658425434,16.676896948985025,2614521352
1241530200,2.745806,2.789139,2.686641,2.744138,NaN,4.281313000000001,NaN,1.216655,NaN,1.216655,NaN,NaN,NaN,NaN,NaN,2.30178619,1.9997383799999995,2.3670763000000012,2.2365045284099248,2.3816853649818515,2.424514076923077,2.7752799594921176,2.0737481943540366,NaN,2.30178619,1.9997383799999995,2.3670763000000012,2.7399726666666666,181343376,224136916.8,66.2243311915378,NaN,1.5,2.75,NaN,NaN,0.17666430612640077,0.8090741078669107,23.9519164610109,0.03191427806946032,0.1560714465397175,0.12415716847025718,69.61044209004005,22.6442449936938,77.68381786638089,4.237760635084178,18.07842149853494,2433177976
1241616600,2.854971,2.890804,2.744138,2.874305,NaN,4.29074,NaN,1.216655,NaN,1.216655,NaN,NaN,NaN,NaN,NaN,2.3004378699999997,2.0205415399999995,2.409125950000001,2.2615163116095354,2.4286015206978657,2.455616384615385,2.8808000995155814,2.0304326697151884,NaN,2.3004378699999997,2.0205415399999995,2.409125950000001,2.836415666666667,247214952,225695118,69.26933066631322,NaN,1.5,2.75,NaN,NaN,0.174521569974515,1.0953491337814405,28.281047933990767,0.04135194723376895,0.17584710251246838,0.13449515527869943,66.96029193076524,24.880520184702764,79.40244681264186,3.6454976098781406,16.952055577480014,2680392928
1241703000,2.96747,2.979969,2.700806,2.756639,NaN,2.979969,NaN,1.216655,NaN,1.216655,NaN,NaN,NaN,NaN,NaN,2.30013787,2.040141319999999,2.441792250000001,2.280932887624848,2.459843185393307,2.502103076923077,2.916485573600844,2.0877205802453105,NaN,2.30013787,2.040141319999999,2.441792250000001,2.8124713333333333,247927276,227088024.6,63.68045793319862,NaN,1.5,2.75,NaN,NaN,0.18199595783347822,1.091767284676094,24.41033015296476,0.036364222134494695,0.17995043294681778,0.1435862108123231,77.01662440861718,14.305434096174253,46.17719955225273,22.037684835870188,31.785115611877085,2432465652
1241789400,2.869137,2.973303,2.807472,2.95247,NaN,2.9736793571428572,NaN,1.216655,NaN,1.216655,NaN,NaN,NaN,NaN,NaN,2.3010561899999997,2.0652743799999995,2.471916900000001,2.307267676345442,2.5067600248796587,2.5539614615384614,3.00998219286249,2.097940730214433,NaN,2.3010561899999997,2.0652743799999995,2.471916900000001,2.9110816666666666,249050296,227305898.8,68.26906835777694,NaN,1.5,2.75,NaN,NaN,0.18447224655965835,1.0956613854492718,31.70488471892624,0.042520168904539135,0.196736421942997,0.15421625303845787,80.92386745620338,25.638250927562265,53.47961819844705,16.722994410162645,29.797387391390306,2681515948
1242048600,2.825805,2.868305,2.759972,2.786639,NaN,2.9673897142857144,NaN,1.216655,NaN,1.216655,NaN,NaN,NaN,NaN,NaN,2.30153952,2.089274159999999,2.492933350000001,2.3260665517828754,2.5334151653673103,2.596204615384615,3.0282417262938433,2.1641675044753867,NaN,2.30153952,2.089274159999999,2.492933350000001,2.804972,160190488,226205837,61.21604892888267,NaN,1.5,2.75,NaN,NaN,0.1850455146625399,0.708162486540964,27.159445581818304,0.03216071241406393,0.19441714355603779,0.16225643114197386,89.20483406309134,19.38600993427136,30.61607130713782,36.1684899934334,33.21543869942878,2521325460
1242135000,2.820806,2.841639,2.651641,2.763306,NaN,2.9611000714285716,NaN,1.216655,NaN,1.216655,NaN,NaN,NaN,NaN,NaN,2.29761456,2.117107199999999,2.518974750000001,2.3432131968109977,2.5553095305704234,2.6317170769230764,3.036075780777777,2.227358373068376,NaN,2.29761456,2.117107199999999,2.518974750000001,2.7521953333333333,210038388,225402481.8,60.27250977912003,NaN,1.5,2.75,NaN,NaN,0.18539926361521558,0.9318370690628305,24.60721344329938,0.021013369633500645,0.18852314318384966,0.16750977355034902,89.3701193690407,11.913612096833631,29.030516639331132,37.872445291639934,33.097038069028926,2311287072
1242221400,2.63414,2.66164,2.524991,2.550808,NaN,2.9548104285714287,NaN,1.216655,NaN,1.216655,NaN,NaN,NaN,NaN,NaN,2.29237296,2.141323619999999,2.5308913000000013,2.3513541694850764,2.55488081337324,2.642422076923076,3.0299262377205585,2.254917916125594,NaN,2.29237296,2.141323619999999,2.5308913000000013,2.5791463333333335,234922412,225691032,52.35764210098525,NaN,1.5,2.75,NaN,NaN,0.1891789590712716,1.0409027329007916,16.6717595450382,-0.002163404977158473,0.16480551732890092,0.1669689223060594,100.8528371396285,3.1334552752831484,7.5611234783679375,69.54921570278246,22.889660818849592,2076364660
1242307800,2.544974,2.662473,2.523308,2.599974,NaN,2.948520785714286,NaN,1.216655,NaN,1.216655,NaN,NaN,NaN,NaN,NaN,2.28932299,2.1648233599999993,2.540141200000001,2.3611039667601714,2.559175402575789,2.661652615384615,3.0122514138638747,2.311053816905355,NaN,2.28932299,2.1648233599999993,2.540141200000001,2.5952516666666665,199944964,222716400.2,53.86712977676176,NaN,1.5,2.75,NaN,NaN,0.18560653342332362,0.8977559076046884,20.791348662019846,-0.014961313564465395,0.14826728035047765,0.16322859391494304,101.24667483257137,3.072339666399072,26.222453265946523,41.03491935082576,32.74262738322771,2276309624
1242394200,2.599974,2.655807,2.491641,2.536641,NaN,2.942231142857143,2.95247,1.216655,NaN,1.216655,NaN,NaN,NaN,NaN,NaN,2.2856980300000003,2.1903897599999995,2.543474500000001,2.3679877719852627,2.5570292689971423,2.6772294615384613,2.9834213756563033,2.3710375474206193,NaN,2.2856980300000003,2.1903897599999995,2.543474500000001,2.561363,178285924,221073759,51.599202218423066,NaN,1.5,2.75,NaN,NaN,0.18407506675022905,0.8064544829130987,17.494737211026035,-0.027728385986543008,0.12856811143176428,0.15629649741830728,102.08498700635809,-8.561109793384478,5.061680031433998,75.43399309833158,19.50432687023444,2098023700
1242653400,2.614974,2.768306,2.599141,2.759139,NaN,2.9359415,2.95247,1.216655,NaN,1.216655,NaN,NaN,NaN,NaN,NaN,2.28562303,2.2203877999999992,2.5738158500000012,2.383327035828978,2.576277814806938,2.6995369230769226,2.983269473634349,2.415804372519496,NaN,2.28562303,2.2203877999999992,2.5738158500000012,2.708862,193039508,220020206.6,58.24958805024736,NaN,1.5,2.75,NaN,NaN,0.18747434769664126,0.8773717240932725,24.35039181142708,-0.021502594597492652,0.12941825417144148,0.15092084876893413,98.49165848198153,0.546656181285337,21.678257616304908,46.66325656482956,31.65848581886554,2291063208
1242739800,2.750805,2.832473,2.721639,2.756639,NaN,2.9296518571428574,2.95247,1.216655,NaN,1.216655,NaN,NaN,NaN,NaN,NaN,2.2863980300000004,2.251187479999999,2.597732250000001,2.3979667206984296,2.5934550705396107,2.7213316153846145,2.974036691517051,2.468626539252178,NaN,2.2863980300000004,2.251187479999999,2.597732250000001,2.7702503333333333,162805388,214566404.2,58.15290189425966,NaN,1.5,2.75,NaN,NaN,0.18200003714688112,0.7587645820277023,27.054885426558332,-0.018008648357821982,0.12841003832165665,0.14641868667947863,98.27549974288046,-4.093720047107049,24.02715225160013,43.71383700566355,32.259010742736336,2128257820
1242826200,2.826638,2.914138,2.692473,2.709139,NaN,2.9233622142857145,2.95247,1.216655,NaN,1.216655,NaN,NaN,NaN,NaN,NaN,2.2863813600000005,2.276720539999999,2.621315300000001,2.410169555180844,2.604472587631076,2.735690384615384,2.9613306507117163,2.5100501185190516,NaN,2.2863813600000005,2.276720539999999,2.621315300000001,2.7719166666666664,232455380,211973322.4,56.242714420660846,NaN,1.5,2.75,NaN,NaN,0.18483324877924676,1.0966256383968438,27.537458438991443,-0.01924087768791541,0.12236758956958438,0.1416084672574998,94.11340728124102,-1.723112819632889,23.45206031271923,44.42068818204463,32.12725150523613,1895802440
1242912600,2.607473,2.64164,2.50165,2.583308,NaN,2.9170725714285717,2.95247,1.216655,NaN,1.216655,NaN,NaN,NaN,NaN,NaN,2.2845397100000002,2.299220319999999,2.635398500000001,2.4169592981149286,2.602456912618593,2.7210111538461534,2.9592159176541606,2.4828063900381463,NaN,2.2845397100000002,2.299220319999999,2.635398500000001,2.575532666666667,203567344,209196523.4,51.42381749585079,NaN,1.5,2.75,NaN,NaN,0.18645151672358626,0.9730914294917006,23.385350540586103,-0.02832583437847644,0.10620117428440423,0.13452700866288067,94.96918211177767,-12.503497071943144,5.559576313226842,74.22075797269683,20.21966571407633,1692235096
1242999000,2.609141,2.653307,2.540809,2.563307,NaN,2.910782928571429,2.95247,1.216655,NaN,1.216655,NaN,NaN,NaN,NaN,NaN,2.28267305,2.317770119999999,2.642981700000001,2.422698423679049,2.59872834951206,2.7071010769230766,2.95900477151529,2.455197382330863,NaN,2.28267305,2.317770119999999,2.642981700000001,2.5858076666666663,161170284,204112957.4,50.68050565899583,NaN,1.5,2.75,NaN,NaN,0.18116912267190152,0.7896131928761128,24.272612645351764,-0.0350380963359713,0.09072938824291654,0.12576748457888784,82.13863904562054,-8.014385788758432,5.742244452396987,73.77096193388671,20.48679361371631,1531064812
1243344600,2.515808,2.788805,2.511642,2.77664,NaN,2.904493285714286,2.95247,1.216655,NaN,1.216655,NaN,NaN,NaN,NaN,NaN,2.28111474,2.339836579999999,2.664314850000001,2.436578485495557,2.615672316225197,2.6995883846153843,2.9364752870172732,2.4627014822134954,NaN,2.28111474,2.339836579999999,2.664314850000001,2.6923623333333335,206825812,202664610.2,57.70322072576955,NaN,1.5,2.75,NaN,NaN,0.1880258281953371,1.0205324540673062,29.551015667245643,-0.02494064165995799,0.09459168250394034,0.11953232416389833,92.67427742146255,0.4825379454899297,6.487225952963005,71.99386321721711,21.51891082981989,1737890624
1243431000,2.77664,2.810805,2.609975,2.61664,NaN,2.898203642857143,2.95247,1.216655,NaN,1.216655,NaN,NaN,NaN,NaN,NaN,2.27695644,2.359119719999999,2.678439750000001,2.443639721358476,2.6157644765847023,2.6888192307692305,2.9270776914286305,2.4505607701098304,NaN,2.27695644,2.359119719999999,2.678439750000001,2.6791400000000003,203509360,203268991.4,51.751334613767824,NaN,1.5,2.75,NaN,NaN,0.18894041189567018,1.0011825148456952,25.214375076546062,-0.028604902634483384,0.0837761958707941,0.11238109850527749,98.69312697547025,2.5808292901700125,6.063317110038331,72.98938421051699,20.947298679444682,1534381264
1243517400,2.693307,2.759139,2.569141,2.721639,NaN,2.891914,2.95247,1.216655,NaN,1.216655,NaN,NaN,NaN,NaN,NaN,2.2708815,2.377499519999999,2.691064600000001,2.454541653854222,2.6258477645290164,2.6710629999999997,2.856667854361252,2.4854581456387477,NaN,2.2708815,2.377499519999999,2.691064600000001,2.683306333333333,230182268,204088148.4,55.029508990737874,NaN,1.5,2.75,NaN,NaN,0.18901595390312229,1.1278571039257859,28.77410003657384,-0.02372584030154326,0.0827237981283484,0.10644963842989166,89.01384823153197,4.679469871621798,28.510476883911025,38.50002115510158,32.98950196098738,1764563532
1243603800,2.770806,2.874971,2.708306,2.860805,NaN,2.885624357142857,2.95247,1.216655,NaN,1.216655,NaN,NaN,NaN,NaN,NaN,2.26619822,2.396132679999999,2.710439450000001,2.4704735497815076,2.6482246440976813,2.676768076923077,2.8799586796970944,2.4735774741490593,NaN,2.26619822,2.396132679999999,2.710439450000001,2.814694,156877892,200135762,59.005162948625724,NaN,1.5,2.75,NaN,NaN,0.1874194571957564,0.7838573697788205,33.30006678413176,-0.01151322283197162,0.09205810988992713,0.10357133272189875,92.29262755638045,12.77926202407042,54.44324693769853,16.08784726270524,29.46890579959622,1921441424
1243863000,2.979969,3.124969,2.956637,3.079136,NaN,2.879334714285714,2.95247,1.216655,NaN,1.216655,NaN,NaN,NaN,NaN,NaN,2.26288992,2.420432439999999,2.7382725000000008,2.4943426654763505,2.6892638208502833,2.701062692307692,2.995063756379429,2.407061628235955,NaN,2.26288992,2.420432439999999,2.7382725000000008,3.053580666666667,167724416,201542877,64.33261083233202,NaN,1.5,2.75,NaN,NaN,0.19290121025320237,0.8322021522000999,38.75964712916375,0.009734085654364427,0.11573893978985428,0.10600485413548985,96.08767735002502,11.597712184851881,77.98608987412115,4.145629704098904,17.868280421779954,2089165840
1243949400,3.054135,3.150802,3.030803,3.106636,NaN,2.8730450714285714,2.95247,1.216655,NaN,1.216655,NaN,NaN,NaN,NaN,NaN,2.26272326,2.447815499999999,2.754897400000001,2.5183541687910034,2.729013552197875,2.7438186923076917,3.0942326395313318,2.3934047450840517,NaN,2.26272326,2.447815499999999,2.754897400000001,3.096080333333333,155811380,199144355.4,64.95044864163079,NaN,1.5,2.75,NaN,NaN,0.18769390952083076,0.7824041996422059,41.494169379996336,0.023329769864393085,0.1351670664659812,0.11183729660158812,86.82673531293942,12.696511948064297,77.10328500518997,4.4627791531861645,18.43393584162387,2244977220
1244035800,3.018303,3.02997,2.889138,2.979137,NaN,2.8667554285714285,2.95247,1.216655,NaN,1.216655,NaN,NaN,NaN,NaN,NaN,2.2609649500000004,2.465048659999999,2.766647350000001,2.5364240837403758,2.7528348329409345,2.772985076923076,3.1336220703618967,2.4123480834842557,NaN,2.2609649500000004,2.465048659999999,2.766647350000001,2.9660816666666663,157965496,197975461.4,59.78011383035649,NaN,1.5,2.75,NaN,NaN,0.18982277312648568,0.7979044215022094,37.460222519572014,0.02147200864381278,0.1386773074063541,0.11720529876254131,92.0503571355985,9.966192210883243,79.58679331401392,3.5976773593136193,16.815529326672475,2087011724
1244122200,3.00747,3.067469,2.942637,3.049136,NaN,2.8604657857142857,2.95247,1.216655,NaN,1.216655,NaN,NaN,NaN,NaN,NaN,2.2619816000000004,2.486465099999999,2.7753889000000007,2.556530433397616,2.7810539917084647,2.8124077692307683,3.1731287397219425,2.451686798739594,NaN,2.2619816000000004,2.486465099999999,2.7753889000000007,3.0197473333333336,175704580,194399942.8,61.588008310682234,NaN,1.5,2.75,NaN,NaN,0.18518057504602242,0.9038304099747914,41.82940363160475,0.022580636040923946,0.14543109381369623,0.12285045777277229,90.93735171853457,18.032228445078932,78.71702657362626,3.8910615811901277,17.391911845183618,2262716304
1244208600,3.157468,3.169967,2.984137,3.057469,NaN,2.854176142857143,2.95247,1.216655,NaN,1.216655,NaN,NaN,NaN,NaN,NaN,2.26522323,2.506948239999999,2.790430400000001,2.5761750830682977,2.807379230593373,2.8353562307692295,3.216956098054446,2.453756363484013,NaN,2.26522323,2.506948239999999,2.790430400000001,3.0705243333333336,223034996,193155328.8,61.80809702301765,NaN,1.5,2.75,NaN,NaN,0.18522696254273513,1.1546924301060235,41.00717717981171,0.021503576380920097,0.1497299282489224,0.1282263518680023,83.18874548081864,19.27829947797904,80.82060124549915,3.1994262970674354,15.979972457433426,2485751300
1244467800,2.987471,3.104968,2.910803,3.026637,NaN,2.8478865,2.95247,1.216655,NaN,1.216655,NaN,NaN,NaN,NaN,NaN,2.2680482200000003,2.524021419999999,2.794138750000001,2.5938402562813057,2.8282609229178135,2.8561253076923068,3.2475897424029374,2.464660872981676,NaN,2.2680482200000003,2.524021419999999,2.794138750000001,3.014136,159589400,188682284,60.42848289474207,NaN,1.5,2.75,NaN,NaN,0.18586539378968261,0.8458101980575983,38.08151079255499,0.016564601860728112,0.14893210419391245,0.13236750233318434,83.4546262251354,9.003579866313244,55.192761226035735,15.593848322548334,29.213390451415925,2326161900
1244554200,3.067469,3.119969,3.011637,3.074136,NaN,2.841596857142857,3.106636,1.216655,NaN,1.216655,NaN,NaN,NaN,NaN,NaN,2.2740314900000005,2.5446212199999994,2.808513600000001,2.61267538348596,2.851677596925641,2.8842019999999993,3.2817793135030557,2.486624686496943,NaN,2.2740314900000005,2.5446212199999994,2.808513600000001,3.068580666666667,155671280,188456323.6,61.84157400834905,NaN,1.5,2.75,NaN,NaN,0.18032729423327673,0.8260337303958741,40.473874530643144,0.014425110475697472,0.1503988904278062,0.13597377995210871,73.14383330431082,17.484101748807646,55.084893969885655,15.66436385997424,29.250742170140104,2481833180
1244640600,3.150802,3.154136,2.933304,3.049136,NaN,2.8353072142857143,3.106636,1.216655,NaN,1.216655,NaN,NaN,NaN,NaN,NaN,2.2794397600000007,2.5687542999999993,2.822805100000001,2.629791486094354,2.8704831591231987,2.920034923076922,3.285335278703914,2.5547345674499295,NaN,2.2794397600000007,2.5687542999999993,2.822805100000001,3.0455253333333334,175159940,186712401.2,60.614684260490264,NaN,1.5,2.75,NaN,NaN,0.1832204875023284,0.9381269742890544,38.658904104697086,0.009492842004739072,0.14783983245803256,0.1383469904532935,60.10587039747891,12.033080066827367,52.91414451000686,17.11722787657255,29.96862761342061,2306673240
1244727000,3.065802,3.209134,3.062469,3.091637,NaN,3.209134,3.106636,1.216655,NaN,1.216655,NaN,NaN,NaN,NaN,NaN,2.28477305,2.592887419999999,2.849846550000001,2.6479030748749675,2.891545429682894,2.960675692307691,3.2717111149813394,2.6496402696340424,NaN,2.28477305,2.592887419999999,2.849846550000001,3.1210800000000005,204194040,185175982.6,61.99509545323481,NaN,1.5,2.75,NaN,NaN,0.18156173839501924,1.1027026136595752,40.973242970023776,0.007354792643062047,0.14754048125712105,0.140185688614059,58.12655674551364,8.068777843998452,54.76235925423062,15.87615634124882,29.36148440452056,2510867280
1244813400,3.04747,3.11247,3.001637,3.10997,NaN,3.218682541666667,3.106636,1.216655,NaN,1.216655,NaN,NaN,NaN,NaN,NaN,2.2942480400000003,2.615117239999999,2.8753463500000005,2.6660233464484984,2.9123477697130946,2.98631646153846,3.287231822841387,2.685401100235533,NaN,2.2942480400000003,2.615117239999999,2.8753463500000005,3.0746923333333336,126096792,181483574,62.60395743816334,NaN,1.5,2.75,NaN,NaN,0.17650968565251787,0.6948110466460177,39.44152698912071,0.005521077407260849,0.14708703537313506,0.1415659579658742,53.12467777114162,1.0013848040489288,48.729248267278976,20.103644170968003,31.167107561753046,2636964072
1245072600,3.000802,3.00247,2.845804,2.885804,NaN,3.2282310833333336,3.106636,1.216655,NaN,1.216655,NaN,NaN,NaN,NaN,NaN,2.2988646600000004,2.629300419999999,2.8928045000000004,2.674642195607381,2.9098197916451807,3.007021384615383,3.2303918781320284,2.7836508910987376,NaN,2.2988646600000004,2.629300419999999,2.8928045000000004,2.9113593333333334,174721648,181305360.2,51.69779171079368,NaN,1.5,2.75,NaN,NaN,0.18277085096305234,0.9636871618536957,32.4904786386392,-0.011514064021971804,0.12717337793840944,0.13868744196038124,54.696621512333834,-7.108396348976839,47.42452315710218,21.04703183758928,31.528445005308537,2462242424
1245159000,2.921637,2.933304,2.765806,2.774972,NaN,3.237779625,3.106636,1.216655,NaN,1.216655,NaN,NaN,NaN,NaN,NaN,2.3035896100000004,2.6398502999999987,2.8935961500000005,2.6785766977404246,2.89697714482183,3.011123923076921,3.2144362914871873,2.807811554666655,NaN,2.3035896100000004,2.6398502999999987,2.8935961500000005,2.8246939999999996,182685048,180787637.2,47.30946962205197,NaN,1.5,2.75,NaN,NaN,0.18167993303712007,1.0104952464083645,28.534552621971216,-0.029925200633653087,0.10128094116831488,0.13120614180196796,56.66493013036981,-6.853159153137305,21.88582598903788,46.33504981030235,31.77912420065976,2279557376
1245245400,2.761639,2.831638,2.69414,2.767473,NaN,3.2473281666666667,3.106636,1.216655,NaN,1.216655,NaN,NaN,NaN,NaN,NaN,2.30781457,2.651216859999999,2.894137850000001,2.6820628272408,2.8846434167435606,3.003944538461537,3.2329501914580923,2.7749388854649815,NaN,2.30781457,2.651216859999999,2.894137850000001,2.764417,208772132,183085974.4,47.01865278191491,NaN,1.5,2.75,NaN,NaN,0.17852408067732578,1.140295605297879,26.151385154190745,-0.04157096592333101,0.0792424343978042,0.12081340032113522,53.28763552682303,-9.23746923718719,21.134440238112333,47.309913001902984,31.55564675998469,2070785244
1245331800,2.778306,2.857471,2.730806,2.813304,NaN,3.2568767083333334,3.106636,1.216655,NaN,1.216655,NaN,NaN,NaN,NaN,NaN,2.31223951,2.6668166999999987,2.8993461000000007,2.6872095398980234,2.877849186577507,2.983495923076922,3.2288815394072654,2.7381103067465786,NaN,2.31223951,2.6668166999999987,2.8993461000000007,2.800527,159744144,179450412.6,49.07885703013754,NaN,1.5,2.75,NaN,NaN,0.17481986062894536,0.8901854372220039,28.53885243145341,-0.044867692623523164,0.06472878454173125,0.10959647716525442,51.98939398637952,-7.985853658696137,16.32257848861066,54.03907493928879,29.638346572100563,2230529388
1245418200,2.894138,2.909138,2.803305,2.842472,NaN,3.26642525,3.10997,1.216655,NaN,1.216655,NaN,NaN,NaN,NaN,NaN,2.3160561399999997,2.681599879999999,2.9123043000000006,2.693298263823591,2.8744799307129827,2.963175615384614,3.2081573741121865,2.7181938566570416,NaN,2.3160561399999997,2.681599879999999,2.9123043000000006,2.8516383333333337,144092100,176476650.4,50.40074436362785,NaN,1.5,2.75,NaN,NaN,0.16989222772687781,0.8164938515854786,31.3317004402072,-0.04371971500727925,0.05494683340615536,0.09866654841343461,52.73978303636221,-6.084806337859483,16.78771715035195,53.347546597403785,29.864736252244278,2374621488
1245677400,2.752472,2.764972,2.591642,2.596641,NaN,3.275973791666667,3.10997,1.216655,NaN,1.216655,NaN,NaN,NaN,NaN,NaN,2.31522282,2.686533159999999,2.9139710000000005,2.6895077828893323,2.848019080168889,2.9337528461538445,3.2465029153497746,2.6210027769579143,NaN,2.31522282,2.686533159999999,2.9139710000000005,2.651085,168833720,176859822.2,40.78986285544453,NaN,1.5,2.75,NaN,NaN,0.17567349717495798,0.9546188495489736,23.753281579228847,-0.0572962093754141,0.027046286694166977,0.08434249606958108,71.18634433405695,-15.532656980693119,17.79096847312338,51.889791626076125,30.319239900800493,2205787768
1245763800,2.604141,2.63414,2.543308,2.591642,NaN,3.2855223333333337,3.10997,1.216655,NaN,1.216655,NaN,NaN,NaN,NaN,NaN,2.31667273,2.691039799999999,2.9047211000000006,2.685669909050535,2.8236022153908995,2.8985609999999986,3.251795491386713,2.545326508613284,NaN,2.31667273,2.691039799999999,2.9047211000000006,2.5896966666666668,173321764,175184619.8,40.62023394793393,NaN,1.5,2.75,NaN,NaN,0.16961339023388952,0.9893663279223556,22.396039794152255,-0.06389008999052714,0.0044798835814221505,0.0683699735719493,69.08998894358233,-15.004053607316962,18.729410330070504,50.56244182536053,30.708147844568966,2032466004
1245850200,2.651641,2.737473,2.612475,2.652807,NaN,3.2950708750000004,3.10997,1.216655,NaN,1.216655,NaN,NaN,NaN,NaN,NaN,2.3202677,2.699246379999999,2.9065294500000007,2.684381167519142,2.80733600440129,2.867433153846153,3.230354840148898,2.5045114675434075,NaN,2.3202677,2.699246379999999,2.9065294500000007,2.6675850000000003,191904560,174604379.8,43.70499823059456,NaN,1.5,2.75,NaN,NaN,0.16791464807432602,1.0990821663226114,26.82468554943755,-0.06139369111568227,-0.008372140322653543,0.05302155079302873,72.82857556813806,-14.194098466281773,49.65170761798023,19.387758289184628,30.960534092835132,2224370564
1245936600,2.614974,2.836637,2.605807,2.826638,NaN,3.3046194166666667,3.10997,1.216655,NaN,1.216655,NaN,NaN,NaN,NaN,NaN,2.32577597,2.709529599999999,2.911779400000001,2.6899598668321167,2.809174289696405,2.8520486153846147,3.2034440649427696,2.50065316582646,NaN,2.32577597,2.709529599999999,2.911779400000001,2.756360666666667,219791508,174084841.8,51.42788163306916,NaN,1.5,2.75,NaN,NaN,0.17240860178330272,1.2625539692451269,31.719410601300353,-0.04600053696623263,-0.004479120414762061,0.04152141655147057,84.37399890157882,-9.110441579822316,53.70150489970664,16.549827651759248,29.748667448534103,2444162072
1246023000,2.794971,2.849138,2.762472,2.807472,NaN,3.3141679583333334,3.10997,1.216655,NaN,1.216655,NaN,NaN,NaN,NaN,NaN,2.33024259,2.717379519999999,2.9091127500000007,2.6945681857798767,2.8090121668681762,2.831535999999999,3.158997221928759,2.5040747780712387,NaN,2.33024259,2.717379519999999,2.9091127500000007,2.8063606666666665,133386348,172910264.6,50.60359183708274,NaN,1.5,2.75,NaN,NaN,0.16628413022735253,0.7714194892279402,34.18343750282326,-0.03554265417394511,-0.002906901165960818,0.03263575300798429,83.86907700272067,-2.714390859531681,30.96423337138577,35.808177803022694,33.22758882559154,2310775724
1246282200,2.841639,2.900804,2.791639,2.88747,NaN,3.3237165,3.10997,1.216655,NaN,1.216655,NaN,NaN,NaN,NaN,NaN,2.3358425300000003,2.725729419999999,2.8995294500000006,2.702132962808117,2.8164843414521594,2.819100153846153,3.124068584706535,2.5141317229857707,NaN,2.3358425300000003,2.725729419999999,2.8995294500000006,2.859971,113770088,170212548.2,53.92326490679102,NaN,1.5,2.75,NaN,NaN,0.16220419235397018,0.6684001221009862,36.68775476273096,-0.022316899639819282,0.004739628458210188,0.02705652809802947,75.24378643441696,4.054022887438143,54.878167067369496,15.795596653858455,29.32623627877206,2424545812
1246368600,2.88747,2.923304,2.763306,2.829973,NaN,3.333265041666667,3.10997,1.216655,NaN,1.216655,NaN,NaN,NaN,NaN,NaN,2.33962584,2.739282639999999,2.8856963000000007,2.7071462975999556,2.8177689755995727,2.798972153846153,3.0608257716144913,2.537118536077815,NaN,2.33962584,2.739282639999999,2.8856963000000007,2.838861,179845892,171414273.8,51.25699666602284,NaN,1.5,2.75,NaN,NaN,0.16204660718582944,1.0491885419637672,34.738395893769166,-0.01677335758578289,0.006089831115800859,0.02286318870158375,72.35626927650696,2.2583779498481107,52.513093635212385,17.388133194171846,30.098773170615747,2244699920
1246455000,2.864138,2.941637,2.84998,2.862472,NaN,3.3428135833333337,3.10997,1.216655,NaN,1.216655,NaN,NaN,NaN,NaN,NaN,2.34173415,2.750965859999999,2.8798630500000004,2.7132375016156436,2.8220264064948517,2.7799338461538454,2.97639829411929,2.583469398188401,NaN,2.34173415,2.750965859999999,2.8798630500000004,2.8846963333333338,120757672,169553882.6,52.68119643527554,NaN,1.5,2.75,NaN,NaN,0.1584478495296988,0.7122082381615719,38.497256393716526,-0.010553914772046709,0.009670795236525365,0.020224710008572074,72.47639204778724,1.747695947540681,48.4167022209133,20.331670058130562,31.25162772095613,2365457592
1246541400,2.748306,2.74914,2.624974,2.62664,NaN,3.352362125,3.10997,1.216655,NaN,1.216655,NaN,NaN,NaN,NaN,NaN,2.3413091500000003,2.758749099999999,2.858738250000001,2.7098415211601283,2.8034181773048656,2.759998153846153,2.9619641127476033,2.558032194944703,NaN,2.3413091500000003,2.758749099999999,2.858738250000001,2.6669180000000003,147103144,168123810.8,42.88823178260889,NaN,1.5,2.75,NaN,NaN,0.164094288849006,0.8749691272165715,33.98845740810152,-0.02133706696919751,-0.006446623702924814,0.014890443266272695,87.87599033074343,-7.593109096589159,16.705266935563817,53.513273308898206,29.78145975553798,2218354448
1246887000,2.540809,2.62664,2.519141,2.618307,NaN,3.3619106666666667,3.10997,1.216655,NaN,1.216655,NaN,NaN,NaN,NaN,NaN,2.34451577,2.7650823599999983,2.836780150000001,2.706251932095025,2.785788541371069,2.7479469999999995,2.963162441822303,2.532731558177696,NaN,2.34451577,2.7650823599999983,2.836780150000001,2.588029333333333,133642240,163654173,42.58698750304001,NaN,1.5,2.75,NaN,NaN,0.16005176821693418,0.8166137016255614,31.337802012548558,-0.02764475947515756,-0.019665506077674255,0.007979253397483305,87.25124629582778,0.834385654389659,15.684429927068958,54.96263752800616,29.352932544924897,2084712208
1246973400,2.606641,2.618307,2.459141,2.463309,NaN,3.3714592083333335,3.10997,1.216655,NaN,1.216655,NaN,NaN,NaN,NaN,NaN,2.34577843,2.7661156799999986,2.808613750000001,2.696724758287377,2.7550762040976338,2.724549769230769,2.9871131165259768,2.461986421935561,NaN,2.34577843,2.7661156799999986,2.808613750000001,2.513585666666667,160021036,163675754.8,37.33412492073464,NaN,1.5,2.75,NaN,NaN,0.15998849905858176,0.9776709824587898,26.689615935935777,-0.0401134705516257,-0.04216258479204882,-0.00204911424042312,78.29639102155399,-4.951802756707894,3.4589885689975786,79.91902246402123,16.62198896698119,1924691172
1247059800,2.504975,2.524141,2.369976,2.463309,2.369976,3.38100775,3.10997,1.216655,NaN,1.216655,NaN,NaN,NaN,NaN,NaN,2.3468967600000004,2.768382319999999,2.778072400000001,2.6875711991388522,2.7272888513264304,2.6976270769230766,2.9885143298362298,2.4067398240099234,NaN,2.3468967600000004,2.768382319999999,2.778072400000001,2.4524753333333336,206893204,166236851,37.33412492073464,NaN,1.5,2.75,NaN,NaN,0.15957253484011164,1.2445688351014301,23.496635830889787,-0.0458071213012088,-0.05930801586693413,-0.013500894565725324,78.33421495820556,-7.14330141619801,6.53613611342583,71.8056257657878,21.658238120786386,1924691172
1247146200,2.505809,2.533307,2.450809,2.470808,2.384132717647059,3.390556291666667,3.10997,1.216655,NaN,1.216655,NaN,NaN,NaN,NaN,NaN,2.3488050700000005,2.771115639999999,2.749156000000001,2.679070681525564,2.7028621035810563,2.669037538461538,2.9702357455719595,2.3678393313511163,NaN,2.3488050700000005,2.771115639999999,2.749156000000001,2.4849746666666666,171767088,166067208.4,37.7648513064216,NaN,1.5,2.75,NaN,NaN,0.15406721092296083,1.034322727857693,26.26957455888022,-0.04637285255578353,-0.07146696026045474,-0.025094107704671208,76.49038525581938,-12.588453137614373,9.102023541008057,66.33296232930991,24.56501412968204,2096458260
1247232600,2.432476,2.500807,2.404376,2.454976,2.3982894352941173,3.4001048333333337,3.10997,1.216655,NaN,1.216655,NaN,NaN,NaN,NaN,NaN,2.3536716900000005,2.770832319999999,2.717322950000001,2.6702826547990712,2.6792539032400033,2.6581402307692303,2.9786583143892957,2.337622147149165,NaN,2.3536716900000005,2.770832319999999,2.717322950000001,2.453386333333333,135936564,162654334.6,37.18376473698891,NaN,1.5,2.75,NaN,NaN,0.1499503387141779,0.8357389573065827,25.66217679889509,-0.04507808345129648,-0.0814417120187918,-0.036363628567495324,62.08471676952799,-12.555637242330478,9.806203785901184,64.96125432723602,25.232541886862794,1960521696
1247491800,2.483309,2.633308,2.418309,2.628306,2.4124461529411763,3.4096533750000004,3.10997,1.216655,NaN,1.216655,NaN,NaN,NaN,NaN,NaN,2.3603299500000006,2.773932279999999,2.6932397500000014,2.6686365114736175,2.674401721979051,2.6609605384615382,2.9797289130791884,2.342192163843888,NaN,2.3603299500000006,2.773932279999999,2.6932397500000014,2.5599743333333334,147015580,163700274,46.829708755331005,NaN,1.5,2.75,NaN,NaN,0.1545966716631652,0.8980777881898964,30.837877600514016,-0.03051044370797181,-0.07450168320246009,-0.04399123949448828,78.12215883664436,-8.975469875011694,36.31904928745581,30.44675711945598,33.234193593088214,2107537276
1247578200,2.652473,2.684141,2.599141,2.680807,2.426602870588235,3.4192019166666667,3.10997,1.216655,NaN,1.216655,NaN,NaN,NaN,NaN,NaN,2.3681522100000003,2.7770989199999985,2.6829899000000017,2.6691137855334754,2.6750117484572367,2.663114384615384,2.9820116399703758,2.3442171292603926,NaN,2.3681522100000003,2.7770989199999985,2.6829899000000017,2.6546963333333333,132473164,161587849.8,49.36596924173527,NaN,1.5,2.75,NaN,NaN,0.14962548083008195,0.8198213180258557,34.50780327147518,-0.01602877056227256,-0.06402720269732898,-0.04799843213505642,76.91004462431316,-5.270933680285985,72.6239035210791,6.188532617896425,21.187563861024476,2240010440
1247664600,2.788306,2.932471,2.776139,2.914138,2.440759588235294,3.4287504583333335,3.10997,1.216655,NaN,1.216655,NaN,NaN,NaN,NaN,NaN,2.3789354400000007,2.779898919999999,2.6899482000000017,2.678722578257653,2.6977856771755953,2.6698451538461536,3.0055163224582997,2.3341739852340075,NaN,2.3789354400000007,2.779898919999999,2.6899482000000017,2.874249333333333,139952284,159451211.6,58.77729582731946,NaN,1.5,2.75,NaN,NaN,0.1569139464850761,0.8777122644328655,42.16321071705865,0.0092165481079036,-0.03647774700017692,-0.04569429510808052,92.08496850866332,1.8049434195338852,79.18222114784163,3.7033952651422988,17.114383587016057,2379962724
1247751000,2.888304,3.033302,2.872471,2.996638,2.4549163058823527,3.438299,3.10997,1.216655,NaN,1.216655,NaN,NaN,NaN,NaN,NaN,2.3923436500000004,2.784948919999999,2.7014064500000012,2.6911898496985294,2.7262478031588717,2.6843963846153844,3.0570352079229184,2.3117575613078505,NaN,2.3923436500000004,2.784948919999999,2.7014064500000012,2.9674703333333334,118165324,154920871.2,61.5019610022691,NaN,1.5,2.75,NaN,NaN,0.15719373602185635,0.7627463174245305,45.458020154760504,0.030238221517018167,-0.007896518211807813,-0.03813473972882598,93.11973416183982,14.086361282855655,78.27830632752112,4.011523061321381,17.710170611157494,2498128048
1247837400,2.991636,3.014969,2.941637,2.99497,2.4690730235294116,3.447847541666667,3.10997,2.454976,NaN,1.216655,NaN,NaN,NaN,NaN,NaN,2.40395188,2.787362219999999,2.7104897500000016,2.7031027967691754,2.7518403933342173,2.692665615384615,3.087096904542553,2.298234326226677,NaN,2.40395188,2.787362219999999,2.7104897500000016,2.9838586666666664,111033544,152485341.2,61.41357818395748,NaN,1.5,2.75,NaN,NaN,0.15120361202029514,0.728158806126605,44.75816594253674,0.04207028089372562,0.014453111388331052,-0.02761716950539457,73.62826675310107,14.385746209287136,78.34948878592411,3.9868538784606127,17.663657335615262,2387094504
1248096600,3.059137,3.108302,3.004137,3.091803,2.4832297411764706,3.4573960833333337,3.10997,2.454976,3.10997,1.216655,NaN,NaN,NaN,NaN,NaN,2.41710341,2.7940654999999985,2.722956300000001,2.7183459419939138,2.7842177844452443,2.712806384615384,3.1568458881896553,2.268766881041113,NaN,2.41710341,2.7940654999999985,2.722956300000001,3.068080666666667,138074928,152184482.6,64.59455809137616,NaN,1.5,2.75,NaN,NaN,0.14849849687598837,0.9072865093802934,49.61083398154108,0.05371242914685489,0.03952336692817404,-0.014189062218680847,73.5325338541494,25.514216852209763,80.75923856969295,3.2287244790451686,16.01203695126188,2525169432
1248183000,3.164968,3.172469,3.019971,3.132469,2.497386458823529,3.466944625,3.10997,2.454976,3.10997,1.216655,NaN,NaN,NaN,NaN,NaN,2.43146993,2.7976654799999983,2.7497477000000012,2.734586061915721,2.8173845668790305,2.7335753846153845,3.226265132215098,2.240885637015671,NaN,2.43146993,2.7976654799999983,2.7497477000000012,3.108303,119048316,149695212.4,65.86715724769357,NaN,1.5,2.75,NaN,NaN,0.14878417567056063,0.7952713656726138,51.02504754391417,0.06091837592316832,0.06195890768527956,0.0010405317621112378,54.870735856954006,27.16508566322778,80.96601835461563,3.1637063840731487,15.870275261311212,2644217748
1248269400,3.069136,3.193302,3.068303,3.139135,2.511543176470588,3.4764931666666667,3.10997,2.454976,3.10997,1.216655,NaN,NaN,NaN,NaN,NaN,2.4469947800000003,2.8047153999999983,2.7771223500000017,2.7504507261543205,2.8480274652715036,2.7729980769230766,3.3055550009937984,2.240441152852355,NaN,2.4469947800000003,2.8047153999999983,2.7771223500000017,3.13358,140414664,148049857.4,66.08236884017127,NaN,1.5,2.75,NaN,NaN,0.14708523455123487,0.9484282286110463,53.00218965036249,0.06265740404899145,0.07936228682335056,0.016704882774359102,54.54346475847777,27.04892488611014,81.33787047035088,3.0482919115034863,15.613837618145633,2784632412
1248355800,3.149134,3.391466,3.140802,3.351633,2.525699894117647,3.4860417083333335,3.10997,2.454976,3.10997,1.216655,NaN,NaN,NaN,NaN,NaN,2.4667945700000002,2.8164819399999983,2.8120636500000016,2.774026501599249,2.895989897150408,2.829407769230769,3.434838881331714,2.2239766571298243,NaN,2.4667945700000002,2.8164819399999983,2.8120636500000016,3.2946336666666665,175584108,147233834.8,72.11764188424199,NaN,1.5,2.75,NaN,NaN,0.15460278922614665,1.1925527052834732,59.015247337188555,0.07387161922933823,0.10904440681103189,0.03517278758169366,57.356193843789285,36.52406377903492,83.62251724967275,2.3821669834543733,13.995315766872869,2960216520
1248442200,3.2958,3.400016,3.253326,3.393299,2.539856611764706,3.4955902500000002,3.10997,2.454976,3.10997,1.216655,NaN,NaN,NaN,NaN,NaN,2.4873276900000003,2.8333317599999988,2.840396700000001,2.7983116976149645,2.943352668850369,2.900945461538461,3.535512030807773,2.266378892269149,NaN,2.4873276900000003,2.8333317599999988,2.840396700000001,3.3488803333333337,111698940,141829206.4,73.12734485659682,NaN,1.5,2.75,NaN,NaN,0.1540375899957076,0.787559507912469,61.748947810826785,0.07936636289200237,0.13438074119669663,0.05501437830469426,53.84621424586108,29.105933631776516,100,0,0,3071915460
1248701400,3.384966,3.439132,3.322467,3.424132,2.5540133294117644,3.505138791666667,3.10997,2.454976,3.10997,1.216655,NaN,NaN,NaN,NaN,NaN,2.5073191400000003,2.8498149199999983,2.8712297000000016,2.8228536702575147,2.9891411765789053,2.9748549230769226,3.6121273430783205,2.3375825030755246,NaN,2.5073191400000003,2.8498149199999983,2.8712297000000016,3.395243666666667,121496520,141234715,73.881112457185,NaN,1.5,2.75,NaN,NaN,0.15136811928172847,0.860245443197163,64.79564322408629,0.08011598032219663,0.15515935370744005,0.07504337338524342,50.009325264693615,27.72765812682524,100,0,0,3193411980
1248787800,3.354966,3.429132,3.290801,3.404133,2.5681700470588233,3.5146873333333337,3.10997,2.454976,3.10997,1.216655,NaN,NaN,NaN,NaN,NaN,2.52877726,2.8671647599999983,2.8970628500000015,2.8456489380905534,3.0286642073809142,3.0466491538461535,3.649995326310173,2.443302981382134,NaN,2.52877726,2.8671647599999983,2.8970628500000015,3.3746886666666662,139706848,142531553,72.46136666911465,NaN,1.5,2.75,NaN,NaN,0.15043689647589073,0.9801818969866974,63.85023045194149,0.0744255683617451,0.1680753338374248,0.09364976547567969,53.307569050088155,16.814406181176047,75.6761799746548,4.959770801328554,19.364049224016643,3053705132
1248874200,3.3283,3.377459,3.2833,3.344967,2.5823267647058823,3.5242358750000005,3.10997,2.454976,3.10997,1.216655,NaN,NaN,NaN,NaN,NaN,2.5496345600000003,2.8788813199999983,2.922812550000001,2.8652300385575904,3.0587882828684463,3.115109999999999,3.629838708786706,2.600381291213292,NaN,2.5496345600000003,2.8788813199999983,2.922812550000001,3.3352420000000005,126028680,139840692.4,68.28089776282694,NaN,1.5,2.75,NaN,NaN,0.14832233244189852,0.9012303774891778,60.284905998046945,0.06232779417747854,0.17155950819752785,0.10923171402004932,42.431942098508785,11.623993288478625,48.97201743203917,19.85836331741496,31.16961925054589,2927676452
1248960600,3.468299,3.569964,3.4458,3.453299,2.596483482352941,3.5337844166666668,3.10997,2.454976,3.10997,1.216655,NaN,NaN,NaN,NaN,NaN,2.572001,2.8928145199999977,2.952353900000001,2.888291566457293,3.0963607321190705,3.178570999999999,3.6380396316879855,2.7191023683120124,NaN,2.572001,2.8928145199999977,2.952353900000001,3.489687666666667,166809540,142143285.8,71.5206900967249,NaN,1.5,2.75,NaN,NaN,0.15379909441033432,1.1735309132694889,66.34387547404789,0.05739546819950571,0.18097604926943145,0.12358058106992574,42.96994041182215,15.30329185267298,48.65801509717883,20.090998556567275,31.25098634625389,3094485992
1249047000,3.457466,3.533297,3.421632,3.463299,2.6106401999999997,3.5433329583333335,3.10997,2.454976,3.10997,1.216655,NaN,NaN,NaN,NaN,NaN,2.5923091300000003,2.907897719999998,2.994186850000001,2.910840877576615,3.131307233822016,3.238762692307691,3.619980838208341,2.8575445464070413,NaN,2.5923091300000003,2.907897719999998,2.994186850000001,3.4727426666666665,152033648,142389811,71.80695375220387,NaN,1.5,2.75,NaN,NaN,0.1507895162381676,1.0677284205398658,69.51060391426573,0.050806732617030725,0.18708899684121416,0.13628226422418344,42.58186403832641,12.015513278174582,52.179680721183466,17.56279845063281,30.257520828183715,3246519640
1249306200,3.574963,3.648297,3.518298,3.635797,2.6247969176470587,3.5528815000000002,3.10997,2.454976,3.10997,1.216655,NaN,NaN,NaN,NaN,NaN,2.6140839100000006,2.9289474999999983,3.045061350000001,2.9392705294363553,3.1793538782199193,3.2942749230769217,3.6803828365164053,2.908167009637438,NaN,2.6140839100000006,2.9289474999999983,3.045061350000001,3.600797333333334,131896784,142302538.2,76.24300887569478,NaN,1.5,2.75,NaN,NaN,0.15323297936401278,0.9268758355850606,75.43330864880627,0.05377962790530652,0.2035067991058166,0.14972717120051007,46.01820369291424,16.068091974733036,54.43644081383554,16.06901807286189,29.494541113302578,3378416424
1249392600,3.593297,3.69413,3.570798,3.67163,2.6389536352941176,3.562430041666667,3.10997,2.454976,3.10997,1.216655,NaN,NaN,NaN,NaN,NaN,2.6344420400000006,2.951113959999998,3.1054774000000007,2.9679905086741454,3.2262373183894506,3.3461973846153836,3.739710032289783,2.9526847369409843,NaN,2.6344420400000006,2.951113959999998,3.1054774000000007,3.6455193333333327,162138588,142408415.8,77.0508129243208,NaN,1.5,2.75,NaN,NaN,0.15109719512372616,1.1385463920033299,78.09658168321599,0.053745508424170724,0.21690905673072347,0.16316354830655275,46.13716875073652,16.963112449767213,82.00754528698724,2.8219154594271734,15.170539253585584,3540555012
1249479000,3.681629,3.69163,3.550798,3.635797,2.653110352941176,3.5719785833333337,3.10997,2.454976,3.10997,1.216655,NaN,NaN,NaN,NaN,NaN,2.654066840000001,2.9682970999999982,3.1641018000000005,2.994178998530061,3.26524300235236,3.3954917692307682,3.7601571591754124,3.030826379286124,NaN,2.654066840000001,2.9682970999999982,3.1641018000000005,3.626075,166737440,140400627.6,74.32900428387096,NaN,1.5,2.75,NaN,NaN,0.15036396690060286,1.1875832953897707,76.2105906903116,0.047132385360251855,0.22207903000686757,0.17494664464661572,47.90871167312793,8.478374571440252,74.78411972600121,5.321604987098781,19.894275286900008,3373817572
1249565400,3.687463,3.709963,3.533297,3.58413,2.667267070588235,3.581527125,3.10997,2.454976,3.10997,1.216655,NaN,NaN,NaN,NaN,NaN,2.673383310000001,2.987646899999998,3.2197679,3.017314331921039,3.2956131926045162,3.4333630769230763,3.7647472127371,3.101978941109053,NaN,2.673383310000001,2.987646899999998,3.2197679,3.6091300000000004,142654280,138944987.2,70.4638950809719,NaN,1.5,2.75,NaN,NaN,0.15224268355055978,1.0266961253856592,73.21270113728403,0.03562442801677629,0.21947717966758606,0.18385275165080978,37.77995837989406,5.623760240403224,47.30708399717469,21.149228269795262,31.543687733030044,3231163292
1249651800,3.688296,3.814129,3.632464,3.72813,2.681423788235294,3.5910756666666668,3.10997,2.454976,3.10997,1.216655,NaN,NaN,NaN,NaN,NaN,2.6926381200000016,3.0077767199999976,3.2834256,3.0451894561594295,3.336805269499324,3.479183153846153,3.795876287699824,3.162490019992482,NaN,2.6926381200000016,3.0077767199999976,3.2834256,3.7249076666666663,153870456,139841681.8,74.45142588259571,NaN,1.5,2.75,NaN,NaN,0.15779670615409122,1.1003189751397855,78.90517470500035,0.034057565064195355,0.22642470798105396,0.1923671429168586,42.17718918755412,8.878103998327166,48.3183800431634,20.384338851196485,31.297281105640117,3385033748
1249911000,3.68913,3.732462,3.627797,3.697463,2.6955805058823525,3.6006242083333335,3.10997,2.454976,3.10997,1.216655,NaN,NaN,NaN,NaN,NaN,2.710321280000002,3.024509879999998,3.3368834500000006,3.070768810819844,3.371153624785103,3.5221314615384602,3.7904546649923607,3.2538082580845598,NaN,2.710321280000002,3.024509879999998,3.3368834500000006,3.6859073333333328,101427592,137562282.4,72.2154134437884,NaN,1.5,2.75,NaN,NaN,0.15400158428594185,0.7373212353737452,77.23900562504926,0.027579261063958888,0.22684121924680722,0.19926195818284834,43.38090616856571,8.616878365210763,28.037603185923803,39.139262720294326,32.823134093781874,3283606156
1249997400,3.655797,3.66663,3.537465,3.564964,2.7097372235294115,3.6101727500000003,3.10997,2.454976,3.10997,1.216655,NaN,NaN,NaN,NaN,NaN,2.7273294400000014,3.0342264399999976,3.3810913000000005,3.090149014317105,3.3896117557579504,3.538541538461537,3.7886218226518076,3.2884612542712666,NaN,2.7273294400000014,3.0342264399999976,3.3810913000000005,3.5896863333333333,127931680,137335208.2,63.36118939400666,NaN,1.5,2.75,NaN,NaN,0.15442989969408885,0.9315286420485436,72.94781864307262,0.011800625309503043,0.21401273981972713,0.20221211451022408,49.929523211884856,6.576955766678707,7.145396054270449,70.60004789628397,22.254556049445583,3155674476
1250083800,3.549131,3.764129,3.546631,3.686631,2.7238939411764704,3.619721291666667,3.10997,2.454976,3.10997,1.216655,NaN,NaN,NaN,NaN,NaN,2.746820920000001,3.0458263399999974,3.4197159500000014,3.113540464736042,3.417899302828622,3.561105538461537,3.807602118652657,3.314608958270417,NaN,2.746820920000001,3.0458263399999974,3.4197159500000014,3.665797,126033180,136639253,67.32311354332072,NaN,1.5,2.75,NaN,NaN,0.15893476400165393,0.9223790179824827,77.0242934754276,0.007213248277856854,0.21122867485754515,0.2040154265796883,50.242960014722186,6.756785323251775,27.64902865293508,39.575100649718735,32.7758706973462,3281707656
1250170200,3.737463,3.771628,3.624964,3.760796,2.7380506588235294,3.6292698333333338,3.10997,2.454976,3.10997,1.216655,NaN,NaN,NaN,NaN,NaN,2.7632540900000016,3.0614595199999974,3.457923850000001,3.1389230347463934,3.450556131130658,3.5870027692307676,3.8411182475474077,3.3328872909141274,NaN,2.7632540900000016,3.0614595199999974,3.457923850000001,3.7191293333333335,115627996,136512386.6,69.48898338068118,NaN,1.5,2.75,NaN,NaN,0.15805828085867865,0.8470146840140292,80.68313164815314,0.0068329061686556725,0.21255655929050787,0.2057236531218522,48.7648960886598,8.589988909418445,55.87160779258447,15.227434348963742,28.900957858451804,3397335652
1250256600,3.764962,3.771628,3.558298,3.66663,2.752207376470588,3.6388183750000005,3.10997,2.454976,3.10997,2.454976,NaN,1.216655,NaN,NaN,NaN,2.7801372500000014,3.0738093999999974,3.4915068500000013,3.1596174255406524,3.4711345948325003,3.6071948461538446,3.8408721264461922,3.373517565861497,NaN,2.7801372500000014,3.0738093999999974,3.4915068500000013,3.665518666666667,104624736,136191946.2,63.71454105056664,NaN,1.5,2.75,NaN,NaN,0.16200626079734445,0.7682152940700102,76.19964027253366,-0.0016486745365225652,0.203662809951199,0.20531148448772157,52.50181790210983,0.8480396457778002,26.316975351242966,41.09727135555937,32.58575329319766,3292710916
1250515800,3.449132,3.468299,3.379133,3.395715,2.766364094117647,3.648366916666667,3.10997,2.454976,3.10997,2.454976,NaN,1.216655,NaN,NaN,NaN,2.793761280000001,3.080574319999997,3.506702450000001,3.168876153950823,3.463951776277024,3.6110985384615373,3.8282327821267663,3.3939642947963082,NaN,2.793761280000001,3.080574319999997,3.506702450000001,3.4143823333333336,97573764,134166888,50.66904920811907,NaN,1.5,2.75,NaN,NaN,0.17096988502610558,0.7272566685753343,68.02574891039775,-0.02603928677022052,0.17276237602494593,0.19880166279516645,63.1909003807684,-7.514782262918646,25.39244124086668,41.96992859288517,32.63763016624815,3195137152
1250602200,3.420799,3.515798,3.403299,3.487466,2.780520811764706,3.6579154583333335,3.10997,2.454976,3.10997,2.454976,NaN,1.216655,NaN,NaN,NaN,2.806906160000001,3.0897908999999975,3.524452300000001,3.1813698734037317,3.4661912261554026,3.6137267692307677,3.8238718991008045,3.403581639360731,NaN,2.806906160000001,3.0897908999999975,3.524452300000001,3.4688543333333333,78695236,132149234,54.096932630382824,NaN,1.5,2.75,NaN,NaN,0.1673351075242409,0.5955027783210609,73.25387795751712,-0.03591892989211776,0.15390300043001925,0.189821930322137,65.50655912757594,-4.079738225208949,50.94269194182361,18.426454136250367,30.63085392192603,3273832388
1250688600,3.393299,3.606631,3.386633,3.579131,2.7946775294117643,3.6674640000000003,3.10997,2.454976,3.10997,2.454976,NaN,1.216655,NaN,NaN,NaN,2.822256010000001,3.099890799999997,3.546452100000001,3.1969683489565264,3.4769473950929832,3.622636923076921,3.8156370771453516,3.4296367690084906,NaN,2.822256010000001,3.099890799999997,3.546452100000001,3.524131666666667,100219420,130139471.8,57.29003740087092,NaN,1.5,2.75,NaN,NaN,0.17109674270108086,0.7700924140372913,75.94359316571939,-0.03610909329335224,0.14468556370544672,0.18079465699879896,67.74469613482707,-0.13947596766858897,47.665537238026474,20.831153384557826,31.50330937741569,3374051808
1250775000,3.589132,3.705796,3.563799,3.682463,2.8088342470588232,3.677012541666667,3.760796,2.454976,3.10997,2.454976,NaN,1.216655,NaN,NaN,NaN,2.8406558200000007,3.1125573399999973,3.562993600000001,3.2160073548798,3.4965203098460322,3.626226615384613,3.821791201256137,3.430662029513089,NaN,2.8406558200000007,3.1125573399999973,3.562993600000001,3.650686,92182112,125969372,60.6159286665436,NaN,1.5,2.75,NaN,NaN,0.16901818965100365,0.7317819445825292,80.26293529362619,-0.029389249230873854,0.14405809546020665,0.1734473446910805,69.22801454400893,-1.2249304611159038,44.39093808533089,23.392343493379986,32.21671842128912,3466233920
1250861400,3.768296,3.912461,3.749963,3.889128,2.822990964705882,3.6865610833333338,3.760796,2.454976,3.10997,2.454976,NaN,1.216655,NaN,NaN,2.6578951600000007,2.860697290000001,3.1285071599999976,3.587785050000001,3.2424042429237296,3.5339115184321246,3.6429572307692286,3.883286936264574,3.4026275252738833,2.6578951600000007,2.860697290000001,3.1285071599999976,3.587785050000001,3.850517333333333,92506392,125009744.6,66.27279579684676,NaN,1.5,2.75,NaN,NaN,0.1733738903902177,0.7399934484787357,85.42045407691724,-0.012029156989899925,0.1584108984537056,0.17044005544360552,72.63546845098757,5.183689464911481,76.5798792024918,4.618360277654763,18.801760519853435,3558740312
1251120600,3.946627,4.004127,3.847462,3.882461,2.837147682352941,3.696109625,3.760796,2.454976,3.10997,2.454976,NaN,1.216655,NaN,NaN,2.656057675000001,2.879537110000001,3.1439569799999973,3.610701500000001,3.267504507907113,3.567106707152875,3.6619313846153827,3.9338732560925154,3.38998951313825,2.656057675000001,2.879537110000001,3.1439569799999973,3.610701500000001,3.91135,94839576,123676897.4,65.94373426767899,NaN,1.5,2.75,NaN,NaN,0.17218039821948788,0.7668334021451608,86.08617310036618,-0.0024969410234928213,0.1673188791642395,0.1698158201877323,72.32097354552668,8.906036638799169,77.05835200435624,4.589411196084173,18.352236799559588,3463900736
1251207000,3.934961,4.019126,3.885794,3.906628,2.8513044,3.705658166666667,3.760796,2.454976,3.10997,2.454976,NaN,1.216655,NaN,NaN,2.6575909950000005,2.8968369400000014,3.1643734599999975,3.635826250000001,3.292568174263697,3.5994420683764106,3.6867389230769207,3.9834740996735327,3.3900037464803088,2.6575909950000005,2.8968369400000014,3.1643734599999975,3.635826250000001,3.9371826666666667,126613924,123022251.2,66.59129196610556,NaN,1.5,2.75,NaN,NaN,0.169643584060953,1.0291953103196017,88.47694483218923,0.003602664112806686,0.17431915032874068,0.170716486215934,67.3763436921911,5.967426628810959,80.1123920207733,3.5139207366174783,16.373687242609225,3590514660
1251293400,3.875794,3.963294,3.834953,3.911628,2.8654611176470586,3.7152067083333336,3.760796,2.454976,3.10997,2.454976,NaN,1.216655,NaN,NaN,2.6578784950000003,2.9134784400000013,3.187106579999998,3.6641593000000006,3.3168450301749246,3.6291740618643713,3.7008541538461515,4.020681027880162,3.381027279812141,2.6578784950000003,2.9134784400000013,3.187106579999998,3.6641593000000006,3.9032916666666666,104155364,121928585.4,66.73223286707876,NaN,1.5,2.75,NaN,NaN,0.16669339948517065,0.8542325301184048,87.24372411661017,0.005999619538502421,0.178216010639062,0.17221639110055958,65.62569323075412,4.010640300617206,80.68422953948351,3.3269316101022093,15.988838850414277,3694670024
1251379800,3.899127,3.970793,3.767463,3.941295,2.8796178352941175,3.7247552500000003,3.760796,2.454976,3.10997,2.454976,NaN,1.216655,NaN,NaN,2.6590643200000006,2.9308999400000015,3.210583019999998,3.6885591000000004,3.341333264285712,3.658899865496336,3.719610461538459,4.064090854174284,3.3751300689026333,2.6590643200000006,2.9308999400000015,3.210583019999998,3.6885591000000004,3.893183666666667,116315984,119403907.6,67.6054801052817,NaN,1.5,2.75,NaN,NaN,0.16931029952194418,0.974138839657204,88.46186654167464,0.007510689460504982,0.18160475292619083,0.17409406346568584,65.04345850693969,7.490938545749098,81.95463082311392,2.928031811968733,15.117337364917349,3810986008
1251466200,4.028293,4.049126,3.856628,3.933294,2.893774552941176,3.734303791666667,3.760796,2.454976,3.10997,2.454976,NaN,1.216655,NaN,NaN,2.6614367950000006,2.9498997600000014,3.232982819999998,3.7120588500000005,3.3645474107843114,3.6850326402109705,3.747943538461536,4.097438168013862,3.3984489089092107,2.6614367950000006,2.9498997600000014,3.232982819999998,3.7120588500000005,3.9463493333333335,100246192,116814534.8,67.09397214805759,NaN,1.5,2.75,NaN,NaN,0.17096656384180534,0.8581654001501875,87.50161765618822,0.005966288587790164,0.18155192420042354,0.17558563561263338,62.432183238040004,15.83109889964264,57.87163464649473,14.176265000556338,27.952100352948925,3710739816
1251725400,3.814129,3.841629,3.756629,3.828295,2.907931270588235,3.743852333333334,3.760796,2.454976,3.10997,2.454976,NaN,1.216655,NaN,NaN,2.665207590000001,2.9671495800000014,3.252699279999998,3.7216837500000004,3.382733590753554,3.698676674476592,3.7588407692307664,4.108842745918946,3.4088387925425865,2.665207590000001,2.9671495800000014,3.252699279999998,3.7216837500000004,3.808851,81864624,114312926.8,60.61270753592221,NaN,1.5,2.75,NaN,NaN,0.17137359499596208,0.7161449390866266,83.28728931346483,-0.0036160462725322584,0.17106557777196807,0.17468162404450033,40.86058164687562,9.772969829670018,58.22585085330168,13.717871947354213,28.056277199344102,3628875192
1251811800,3.770796,3.919793,3.55413,3.576631,2.922087988235294,3.7534008750000005,3.760796,2.454976,3.10997,2.454976,NaN,1.216655,NaN,NaN,2.6654992550000016,2.9794161200000016,3.272299079999998,3.716933800000001,3.390337410724003,3.687053276907393,3.744674230769228,4.107872457424636,3.3814760041138197,2.6654992550000016,2.9794161200000016,3.272299079999998,3.716933800000001,3.6835179999999994,173787236,114895359.2,48.51567291021231,NaN,1.5,2.75,NaN,NaN,0.18525140963910763,1.5125696739194319,78.12378617064769,-0.027085656571103678,0.14082455333062072,0.1679102099017244,59.994330527122386,-0.06984935728812236,22.350313499023525,45.86536275390936,31.784323747067095,3455087956
1251898200,3.525798,3.600798,3.509965,3.535049,2.936244705882353,3.762949416666667,3.760796,2.454976,3.10997,2.454976,NaN,1.216655,NaN,NaN,2.6678371550000013,2.9911035100000016,3.2911672199999975,3.7118964000000014,3.3960123750093363,3.672576679106689,3.734552615384613,4.11290414775104,3.3562010830181856,2.6678371550000013,2.9911035100000016,3.2911672199999975,3.7118964000000014,3.548604,89493520,111033163.2,46.851835770559326,NaN,1.5,2.75,NaN,NaN,0.17850723752202854,0.8060071191414998,75.52967519293185,-0.04456055017926058,0.11220952217764868,0.15677007235690926,58.49104073572856,-4.003135944610983,6.433083016531675,72.17577134360432,21.391145639864,3365594436
1251984600,3.598297,3.63913,3.512464,3.62663,2.950401423529412,3.7724979583333336,3.941295,2.454976,3.10997,2.454976,NaN,1.216655,NaN,NaN,2.671716275000001,3.0049450300000013,3.310643679999998,3.7140214000000014,3.405056203440343,3.6682008049060517,3.752315307692305,4.0841965681365835,3.4204340472480266,2.671716275000001,3.0049450300000013,3.310643679999998,3.7140214000000014,3.5927413333333327,75853884,107693143.4,50.849798560036085,NaN,1.5,2.75,NaN,NaN,0.1748042919847408,0.7043520284133521,80.01669350505554,-0.048762294629511926,0.09581720407001937,0.1445794986995313,57.97742637063801,-6.749533571535828,2.652582624641559,82.64864455205121,14.69877282330723,3441448320
1252071000,3.64413,3.783295,3.611631,3.783295,2.9645581411764703,3.7820465000000003,3.941295,2.454976,3.10997,2.454976,NaN,1.216655,NaN,NaN,2.676249560000001,3.0196532100000013,3.329776819999998,3.7167796500000008,3.4198890974230745,3.679162156819761,3.7750713846153823,4.069666012970544,3.48047675626022,2.676249560000001,3.0196532100000013,3.329776819999998,3.7167796500000008,3.7260736666666667,68810896,103440165.4,56.832032172306036,NaN,1.5,2.75,NaN,NaN,0.17457998541440214,0.6652241489938685,85.04389225512772,-0.04015977597911485,0.09437977872563774,0.1345395547047526,53.9137950645188,-2.5542046655459076,12.625369454780751,60.04215679369571,27.33247375152353,3510259216
1252416600,3.889128,3.894962,3.822462,3.890794,2.9787148588235293,3.791595041666667,3.941295,2.454976,3.10997,2.454976,NaN,1.216655,NaN,NaN,2.683636980000001,3.034411390000001,3.351443259999998,3.7264462000000007,3.43835595634766,3.699317570455974,3.7990454615384595,4.076163453949485,3.521927469127434,2.683636980000001,3.034411390000001,3.351443259999998,3.7264462000000007,3.8694059999999992,70467752,101892173.4,60.39419702225095,NaN,1.5,2.75,NaN,NaN,0.17008620074194486,0.6915914112790924,89.86744557883698,-0.02702887852598726,0.10075345654726853,0.1277823350732558,56.742972844533924,-0.4053111788478428,29.46876646037862,37.38102222243765,33.150211317183725,3580726968
1252503000,3.903294,4.02246,3.868295,3.980794,2.9928715764705878,3.8011435833333334,3.941295,2.454976,3.10997,2.454976,NaN,1.216655,NaN,NaN,2.6935577100000008,3.0495195800000015,3.373309739999998,3.747237700000001,3.459628036490889,3.726124849460167,3.8219939999999983,4.106018127387904,3.5379698726120923,2.6935577100000008,3.0495195800000015,3.373309739999998,3.747237700000001,3.957183,86225036,99806841.2,63.13683096072524,NaN,1.5,2.75,NaN,NaN,0.16894897211752022,0.8639190957583376,93.63762935609316,-0.012803165328460625,0.11177837841268001,0.12458154374114064,58.17081706872661,1.768215177925919,74.75870796365196,5.320815403416093,19.920476632931937,3666952004
1252589400,3.989127,4.114126,3.924962,4.104126,3.0070282941176467,3.810692125,3.941295,2.454976,3.10997,2.454976,NaN,1.216655,NaN,NaN,2.7029659500000003,3.0690377200000016,3.398792799999998,3.7681124500000003,3.484902466432423,3.7621249590353893,3.838532307692306,4.158970627421714,3.5180939879628985,2.7029659500000003,3.0690377200000016,3.398792799999998,3.7681124500000003,4.047738,78853724,97447868.4,66.55474747668782,NaN,1.5,2.75,NaN,NaN,0.17039290268055446,0.8091888031488228,98.60065050730422,0.0035193731488266655,0.12898076017717397,0.1254613870283473,60.429470848126996,4.1314085852492575,99.99999999999999,0,0,3745805728
1252675800,4.132459,4.175792,4.049126,4.104292,3.0211850117647057,3.820240666666667,3.941295,2.454976,3.10997,2.454976,NaN,1.216655,NaN,NaN,2.71050004,3.087297530000002,3.423629199999998,3.7852872500000005,3.509192252062524,3.7947122962701143,3.8555962307692293,4.205816164467297,3.505376297071161,2.71050004,3.087297530000002,3.423629199999998,3.7852872500000005,4.109736666666667,86366456,95984791.4,66.55924177500407,NaN,1.5,2.75,NaN,NaN,0.16726955248908632,0.8997931311855724,99.23119817516589,0.012432318905447826,0.1410017856601571,0.12856946675470926,60.45806533538676,4.347450254163558,99.99999999999999,0,0,3832172184
1252935000,4.008294,4.191625,4.004127,4.178292,3.0353417294117646,3.8297892083333336,3.941295,2.454976,3.10997,2.454976,NaN,1.216655,NaN,NaN,2.717679135,3.106705670000002,3.454662239999998,3.8108703500000005,3.5354314578639934,3.8312436966253416,3.87649346153846,4.266553338234819,3.486433584842101,2.717679135,3.106705670000002,3.454662239999998,3.8108703500000005,4.124681333333334,81614076,94834258.4,68.58581161694767,NaN,1.5,2.75,NaN,NaN,0.1687144415970087,0.8605969759974418,102.45467527260293,0.020917421768642808,0.15471624396551276,0.13379882219686995,60.80205225926044,9.142372779527182,100,0,0,3913786260
1253021400,4.198291,4.284124,4.123292,4.237458,3.0494984470588236,3.8393377500000003,3.941295,2.454976,3.10997,2.454976,NaN,1.216655,NaN,NaN,2.7237249099999996,3.1260638100000016,3.487045259999998,3.852957500000001,3.562961910496778,3.869930773137214,3.9015573076923067,4.336695202129238,3.4664194132553754,2.7237249099999996,3.1260638100000016,3.487045259999998,3.852957500000001,4.214958,108474616,95379301,70.14373504588063,NaN,1.5,2.75,NaN,NaN,0.16815141005436524,1.1372972423020797,106.90715339197743,0.027695211621434485,0.16841783672366306,0.14072262510222858,57.085390740689846,18.476242027763007,100,0,0,4022260876
1253107800,4.289957,4.437456,4.246625,4.434123,3.063655164705882,3.848886291666667,3.941295,2.454976,3.10997,2.454976,NaN,1.216655,NaN,NaN,2.7303040149999998,3.1462886100000014,3.526461539999998,3.900290350000001,3.5971250904772964,3.923663366171765,3.9394671538461523,4.459448013580192,3.4194862941121125,2.7303040149999998,3.1462886100000014,3.526461539999998,3.900290350000001,4.372734666666666,79447872,95416932.8,74.64490188639107,NaN,1.5,2.75,NaN,NaN,0.17042616647905343,0.83263913090277,113.04786453429094,0.04175932977941901,0.19292178732650234,0.15116245754708332,31.82540972496785,25.433141096488328,100,0,0,4101708748
1253194200,4.417455,4.575788,4.337457,4.406623,3.077811882352941,4.575788,3.941295,2.454976,3.10997,2.454976,NaN,1.216655,NaN,NaN,2.7407955799999995,3.1668550700000013,3.5653278199999976,3.9416649500000007,3.6288701065370104,3.969659521774454,3.9758770769230747,4.552257803494276,3.399496350351874,2.7407955799999995,3.1668550700000013,3.5653278199999976,3.9416649500000007,4.439956,133173956,97064659.6,72.98787089682662,NaN,1.5,2.75,NaN,NaN,0.17527651173054964,1.3720128061933676,110.77816958749409,0.04525224847646944,0.20772776814267013,0.1624755196662007,29.834786371321936,21.507377372381516,65.81074292668718,9.379538803976974,24.809718269335843,3968534792
1253280600,4.460789,4.469955,4.371624,4.415873,3.0919686,4.595885852941176,3.941295,2.454976,3.10997,2.454976,NaN,1.216655,NaN,NaN,2.750112575,3.1876723800000013,3.6042291199999976,3.9783354500000008,3.6597329651041863,4.01215604351022,4.021075384615383,4.635005053109716,3.4071457161210494,2.750112575,3.1876723800000013,3.6042291199999976,3.9783354500000008,4.419150666666667,81915156,96551311.8,73.20334977646289,NaN,1.5,2.75,NaN,NaN,0.16978040374979608,0.8484105961157951,113.14303588235995,0.044178399697130805,0.2176985192876142,0.17352011959048338,31.78938632288815,16.720292760675562,65.94820269819614,9.309320619273446,24.7424766825304,4050449948
1253539800,4.320791,4.416623,4.184126,4.384123,3.1061253176470585,4.615983705882353,3.941295,2.454976,3.10997,2.454976,NaN,1.216655,NaN,NaN,2.7583125,3.2068221900000013,3.6428120599999976,4.003085200000001,3.6881404174530417,4.047581467937818,4.083190153846152,4.6673587027116294,3.4990216049806744,2.7583125,3.2068221900000013,3.6428120599999976,4.003085200000001,4.328290666666667,54317280,94641856.2,71.10661932108957,NaN,1.5,2.75,NaN,NaN,0.17426016062481067,0.5739245000141914,109.84133411389249,0.03758126673823822,0.22049670301328117,0.18291543627504295,31.60526614592693,12.679391404427982,46.90448875791,21.44879962027913,31.646711621810883,3996132668
1253626200,4.458289,4.490788,4.395789,4.457456,3.1202820352941174,4.63608155882353,3.941295,2.454976,3.10997,2.454976,NaN,1.216655,NaN,NaN,2.767974905,3.2266636700000015,3.679395059999998,4.03183495,3.718309655984295,4.086617137658026,4.154144538461536,4.675456280963594,3.632832795959478,2.767974905,3.2266636700000015,3.679395059999998,4.03183495,4.448011,74481984,93623976.6,73.02821388524893,NaN,1.5,2.75,NaN,NaN,0.16943193486589567,0.7955439055768542,113.83075674852854,0.03448857512849465,0.22602615518566127,0.19153758005716662,30.512566103626927,11.974043369237386,42.86765857885852,24.679489965072527,32.45285145606896,4070614652
1253712600,4.488288,4.564954,4.314124,4.326623,3.1344387529411764,4.656179411764706,3.941295,2.454976,3.10997,2.454976,NaN,1.216655,NaN,NaN,2.775699825,3.2447051500000015,3.7123113799999983,4.0528347,3.7421650812398126,4.109474838833452,4.207990153846152,4.636592519102447,3.779387788589858,2.775699825,3.2447051500000015,3.7123113799999983,4.0528347,4.401900333333333,111861648,92886362.8,64.7539021688891,NaN,1.5,2.75,NaN,NaN,0.1752460823754746,1.2042849415996295,110.27106173751586,0.020646519878662756,0.21734572990549506,0.1966992100268323,38.54253139746246,5.421300418164543,16.376698667902584,53.96270249760631,29.660598834491097,3958753004
1253799000,4.36579,4.387455,4.126625,4.179958,3.1485954705882353,4.676277264705883,3.941295,2.454976,3.10997,2.454976,NaN,1.216655,NaN,NaN,2.78114143,3.2587633500000015,3.737627779999998,4.066251200000001,3.759333430995114,4.116187520849314,4.23850269230769,4.591660574756349,3.8853448098590304,2.78114143,3.2587633500000015,3.737627779999998,4.066251200000001,4.231345999999999,88442528,92100721,56.96236603039746,NaN,1.5,2.75,NaN,NaN,0.181359219348655,0.9602805172393819,105.42821908056324,-0.00026482369061414657,0.19636818041356463,0.19663300410417878,42.67191848796065,1.8435822792335441,20.819786073714447,47.72835849836345,31.45185542792209,3870310476
1253885400,4.149124,4.218291,4.072459,4.120792,3.162752188235294,4.696375117647059,3.941295,2.454976,3.10997,2.454976,NaN,1.216655,NaN,NaN,2.7871580400000004,3.2725298900000013,3.760110859999998,4.07522605,3.773508276838443,4.116626042673189,4.256194846153845,4.5570791350131445,3.9553105572945446,2.7871580400000004,3.2725298900000013,3.760110859999998,4.07522605,4.137180666666667,78173652,90193604.4,54.13262533458742,NaN,1.5,2.75,NaN,NaN,0.17882156082375106,0.8667316548666504,103.5040618748285,-0.018926267686246362,0.17297516949637082,0.19190143718261718,43.665977092501926,-1.3761604023845175,4.5714238045715,76.74075512767972,18.687821067748768,3792136824
1254144600,4.163293,4.362457,4.157458,4.332458,3.1769089058823528,4.716472970588235,3.941295,2.454976,3.10997,2.454976,NaN,1.216655,NaN,NaN,2.7937746450000005,3.287111420000001,3.7868606199999983,4.095184250000001,3.7954278738251706,4.137181467180504,4.283245923076921,4.540261012322623,4.026230833831218,2.7937746450000005,3.287111420000001,3.7868606199999983,4.095184250000001,4.284124333333334,48139500,87588269.8,61.500999226564495,NaN,1.5,2.75,NaN,NaN,0.18331037790776886,0.5496112676951178,109.03612962431473,-0.01787225216657856,0.169561121974394,0.18743337414097255,51.56176158021372,2.2419101263068506,12.829649468832281,59.53667816801706,27.633672363150673,3840276324
1254231000,4.35829,4.423289,4.278291,4.309957,3.1910656235294117,4.736570823529412,4.457456,2.454976,3.10997,2.454976,NaN,1.216655,NaN,NaN,2.8013912350000005,3.302644600000001,3.811223699999998,4.11926735,3.8156054866163402,4.15363627982998,4.299079076923075,4.5344544159508455,4.063703737895304,2.8013912350000005,3.302644600000001,3.811223699999998,4.11926735,4.337179,73020260,87146051.6,60.39036556771309,NaN,1.5,2.75,NaN,NaN,0.18057377948578532,0.8379066940997245,107.79091406154946,-0.019419478215180197,0.1631590263719973,0.1825785045871775,51.32016829179228,-2.800238062859325,1.719047436896938,86.11562470678827,12.165327856314786,3767256064
1254317400,4.349957,4.359706,4.135792,4.254124,3.20522234117647,4.756668676470588,4.457456,2.454976,3.10997,2.454976,NaN,1.216655,NaN,NaN,2.8083586650000005,3.315661140000001,3.833656799999998,4.153142000000001,3.8328022910627584,4.1632065388937916,4.310604615384613,4.519931079108387,4.101278151660839,2.8083586650000005,3.315661140000001,3.833656799999998,4.153142000000001,4.249874000000001,98585208,83385950.2,57.61025368321318,NaN,1.5,2.75,NaN,NaN,0.18366950952251493,1.182276004093553,105.2705742677803,-0.02459891338957315,0.15182986285021105,0.1764287762397842,43.502071117113445,-3.460677257845741,1.8650600319393993,85.50825518109218,12.626684786968413,3668670856
1254403800,4.22079,4.229957,3.925794,3.930878,3.219379058823529,4.7767665294117645,4.457456,2.454976,3.10997,2.454976,NaN,1.216655,NaN,NaN,2.814321525000001,3.327103530000001,3.849491659999998,4.17293345,3.8366483972955914,4.141080011380097,4.291572769230767,4.576790109520484,4.006355428941049,2.814321525000001,3.327103530000001,3.849491659999998,4.17293345,4.028876333333333,106565660,84239557.2,44.76230170290742,NaN,1.5,2.75,NaN,NaN,0.19400240169947816,1.2650311034635875,99.57508513240062,-0.048793039360985224,0.11543747703855267,0.1642305163995379,61.18866510410483,-10.982992490952537,1.7522240984164328,85.97560608048133,12.272169821102239,3562105196
1254490200,3.819962,3.946627,3.810795,3.880795,3.810795,4.7968643823529415,4.457456,2.454976,3.10997,2.454976,NaN,1.216655,NaN,NaN,2.817946490000001,3.338278420000001,3.8600748999999985,4.1856417,3.838379636617333,4.116290962677231,4.264137153846151,4.623798843156319,3.9044754645359827,2.817946490000001,3.338278420000001,3.8600748999999985,4.1856417,3.879405666666667,89539456,84923835.8,43.15639205820997,NaN,1.5,2.75,NaN,NaN,0.18984737300665827,1.0543501145057794,96.24717287394186,-0.06609307537792813,0.08161417217712774,0.14770724755505588,60.57976757062476,-11.480699788760484,1.6980423160727571,86.20491592979039,12.097041754136836,3472565740
1254749400,3.931627,4.081626,3.886628,4.048293,3.8344149836065577,4.816962235294118,4.457456,2.454976,3.10997,2.454976,NaN,1.216655,NaN,NaN,2.8228131150000006,3.3532532700000006,3.873174779999998,4.1988916000000005,3.8466115332205746,4.10981496623178,4.234457923076921,4.596779963516053,3.8721358826377883,2.8228131150000006,3.3532532700000006,3.873174779999998,4.1988916000000005,4.005515666666667,69181252,84942353.6,49.66094865385801,NaN,1.5,2.75,NaN,NaN,0.19063191779189695,0.814449436211525,102.13928464580053,-0.06412898229801328,0.06754601968253926,0.13167500198055254,68.40870969789232,-9.179294198305032,2.7180964317753102,82.33815822750135,14.943745340723328,3541746992
1254835800,4.139125,4.29579,4.129959,4.225792,3.858034967213115,4.837060088235294,4.457456,2.454976,3.10997,2.454976,NaN,1.216655,NaN,NaN,2.8294172200000003,3.369511450000001,3.889207979999999,4.2156415,3.8614813554472187,4.1208603980192295,4.220547846153844,4.568981709032469,3.8721139832752183,2.8294172200000003,3.369511450000001,3.889207979999999,4.2156415,4.217180333333333,76917720,85264852,55.47538005163925,NaN,1.5,2.75,NaN,NaN,0.19469370937819003,0.902103483390788,107.54761155899651,-0.049409063934688954,0.06991367206219135,0.1193227359968803,73.34346523002415,-2.3304780656877075,14.15722344799212,57.37377636988073,28.469000182127147,3618664712
1254922200,4.195792,4.269124,4.172467,4.257457,3.8816549508196725,4.857157941176471,4.457456,2.454976,3.10997,2.454976,NaN,1.216655,NaN,NaN,2.8362088200000004,3.3867196100000014,3.9062744599999983,4.22947465,3.877009812096347,4.133869598207874,4.2083619999999975,4.539258194045571,3.8774658059544236,2.8362088200000004,3.3867196100000014,3.9062744599999983,4.22947465,4.233015999999999,79050548,84906127.6,56.44196225768247,NaN,1.5,2.75,NaN,NaN,0.18769108727974787,0.9310346642166261,108.82366742927445,-0.036659855783293366,0.07349791626776359,0.11015777205105695,71.90383511232724,1.854061691528947,39.460277090843135,27.583795805103584,32.95592710405328,3697715260
1255008600,4.369122,4.431622,4.304957,4.364123,3.9052749344262296,4.877255794117647,4.457456,2.454976,3.10997,2.454976,NaN,1.216655,NaN,NaN,2.84419624,3.4027694500000014,3.9266575799999988,4.242474500000001,3.8961122900533534,4.155798493616648,4.206823538461536,4.534608053644314,3.879039023278757,2.84419624,3.4027694500000014,3.9266575799999988,4.242474500000001,4.366900666666666,78604960,84893689.4,59.62187988836411,NaN,1.5,2.75,NaN,NaN,0.18672493818833732,0.9259222982951192,113.06801576012846,-0.02094424134125321,0.08397747037449044,0.10492171171574365,70.00852997769165,5.9049571053331595,73.81346289721466,5.6989355949642215,20.487601507821115,3776320220
1255095000,4.364123,4.440788,4.33329,4.438288,3.9288949180327872,4.897353647058823,4.457456,2.454976,3.10997,2.454976,NaN,1.216655,NaN,NaN,2.8529919850000005,3.419585940000001,3.946357359999999,4.259174300000001,3.9173740826002805,4.182702256129348,4.205349076923074,4.528753867800924,3.8819442860452247,2.8529919850000005,3.419585940000001,3.946357359999999,4.259174300000001,4.404122,46450412,82897887.2,61.714724642794444,NaN,1.5,2.75,NaN,NaN,0.1810658711748847,0.5603328814392268,115.76523655198069,-0.0062195811120868555,0.09714723532563507,0.10336681643772193,69.26353010474298,2.4427241995190743,99.99999999999999,0,0,3822770632
1255354200,4.511622,4.553288,4.44329,4.497455,3.9525149016393444,4.9174515,4.457456,2.454976,3.10997,2.454976,NaN,1.216655,NaN,NaN,2.8619252299999998,3.4374691000000013,3.9670404799999988,4.275132450000001,3.9401223538708576,4.212678707926553,4.218489999999997,4.572931383538831,3.864048616461163,2.8619252299999998,3.4374691000000013,3.9670404799999988,4.275132450000001,4.498011,42588736,80946620.2,63.34690016278113,NaN,1.5,2.75,NaN,NaN,0.17634688037667864,0.5261335914306648,117.47740092765116,0.0061691155553733334,0.11107821088193859,0.10490909532656525,63.99815864154397,4.350345026644131,100,0,0,3865359368
1255440600,4.457456,4.489955,4.379123,4.464955,3.976134885245902,4.9375493529411765,4.457456,2.454976,3.10997,2.454976,NaN,1.216655,NaN,NaN,2.87041264,3.4562855700000013,3.983623639999999,4.286507300000001,3.960704026268079,4.236705021457357,4.240412846153844,4.6171623415857725,3.863663350721915,2.87041264,3.4562855700000013,3.983623639999999,4.286507300000001,4.444677666666666,60476296,78546704.2,61.78866712962008,NaN,1.5,2.75,NaN,NaN,0.17220296034977306,0.7699405928734053,115.35737604701757,0.010580205115422264,0.11813435172084308,0.10755414660542081,64.11313957523939,4.955920419809102,77.44377739867073,4.3323787724144935,18.223843828914752,3804883072
1255527000,4.627454,4.707454,4.562454,4.69162,3.999754868852459,4.957647205882353,4.457456,2.454976,3.10997,2.454976,NaN,1.216655,NaN,NaN,2.8801208750000002,3.477568700000001,4.004023439999999,4.299382150000001,3.989367397786978,4.280030257509038,4.28432269230769,4.723033871765383,3.845611512849997,2.8801208750000002,3.477568700000001,4.004023439999999,4.299382150000001,4.653842666666667,76685168,78408569,67.74744215388966,NaN,1.5,2.75,NaN,NaN,0.17722410603907504,0.9780202467411439,120.30351451195015,0.026275038904452527,0.14039794523598648,0.11412290633153395,68.1121801883424,19.35297915631064,77.88419560878869,4.175072034859392,17.940732356351923,3881568240
1255613400,4.627454,4.739119,4.61662,4.734953,4.023374852459017,4.97774505882353,4.457456,2.454976,3.10997,2.454976,NaN,1.216655,NaN,NaN,2.889133285,3.4971518300000013,4.026006559999999,4.315798650000001,4.0186060488541555,4.323356232984368,4.315283846153843,4.815686246823142,3.814881445484544,2.889133285,3.4971518300000013,4.026006559999999,4.315798650000001,4.696897333333333,60450928,74772417.6,68.75072575349964,NaN,1.5,2.75,NaN,NaN,0.1733151698934268,0.8084656072428505,119.67673134142214,0.03645984978047524,0.159697718557128,0.12323786877665276,38.420986882824266,22.00987168866173,76.77602053567703,4.5758934731801295,18.64808599114284,3942019168
1255699800,4.624121,4.683287,4.548288,4.633288,4.046994836065574,4.997842911764706,4.457456,2.454976,3.10997,2.454976,NaN,1.216655,NaN,NaN,2.8971373750000002,3.517318310000001,4.046989719999999,4.326669400000002,4.042711223408895,4.352873544128714,4.340155461538459,4.868393412214021,3.811917510862897,2.8971373750000002,3.517318310000001,4.046989719999999,4.326669400000002,4.621621,73204008,74336860.2,63.74098008310414,NaN,1.5,2.75,NaN,NaN,0.17426872918675343,0.9847605589346643,116.4060481679777,0.033320647434830986,0.16488867807019147,0.1315680306353605,41.30261992876455,14.450411568530244,46.42625353789022,21.870883034572568,31.702863427537235,3868815160
1255959000,4.658286,4.794119,4.611621,4.750785,4.070614819672131,5.017940764705883,4.457456,2.454976,3.10997,2.454976,NaN,1.216655,NaN,NaN,2.9042456350000005,3.5376097700000013,4.067442819999999,4.345002500000001,4.070478822490899,4.390769873259313,4.378360153846152,4.946516485401714,3.810203822290589,2.9042456350000005,3.5376097700000013,4.067442819999999,4.345002500000001,4.718841666666667,73150616,75278527,66.75600939658949,NaN,1.5,2.75,NaN,NaN,0.17485653424484246,0.9717328289380582,121.0187396899552,0.03590523624715097,0.17644957594429922,0.14054433969714825,38.664945181231126,12.423540959895785,52.64326463554277,17.341941923979178,30.014793440478044,3941965776
1256045400,4.782452,4.782452,4.596621,4.669952,4.094234803278689,5.038038617647059,4.457456,2.454976,3.10997,2.454976,NaN,1.216655,NaN,NaN,2.9109497300000005,3.555701240000001,4.0868926,4.355627300000001,4.09398757455008,4.417358647234616,4.435211999999998,4.959065491238796,3.9113585087612006,2.9109497300000005,3.555701240000001,4.0868926,4.355627300000001,4.683008333333333,91663108,76137583.2,62.882102871121674,NaN,1.5,2.75,NaN,NaN,0.17564042465592516,1.203914074330639,117.21933396392807,0.029203105491401038,0.17704822156139954,0.1478451160699985,38.734450678462224,9.688764912951575,44.63138933755177,23.320421768453258,32.048188893994976,3850302668
1256131800,4.647454,4.808285,4.532455,4.543288,4.117854786885246,4.808285,4.457456,2.454976,3.10997,2.454976,NaN,1.216655,NaN,NaN,2.91661634,3.5703427600000013,4.106459079999999,4.366460550000001,4.111607199077528,4.4293519189265576,4.486172999999997,4.902166330950238,4.0701796690497565,2.91661634,3.5703427600000013,4.106459079999999,4.366460550000001,4.628009333333334,93166168,75202809.2,57.27341779396025,NaN,1.5,2.75,NaN,NaN,0.18279682289478766,1.2388655289754786,113.76951736475917,0.014040188457980746,0.16539535164247443,0.15135516318449369,44.34487507317925,4.10540674495197,17.12716329429962,52.95601486667363,29.916821839026753,3757136500
1256218200,4.527455,4.71662,4.44329,4.67162,4.141474770491803,4.817972375,4.457456,2.454976,3.10997,2.454976,NaN,1.216655,NaN,NaN,2.9243579299999998,3.5859926000000018,4.1261588599999985,4.391043650000002,4.1335684853882135,4.45242506950498,4.5341212307692285,4.873885056254524,4.194357405283933,2.9243579299999998,3.5859926000000018,4.1261588599999985,4.391043650000002,4.6105100000000006,94532720,75507318.8,61.062774176546746,NaN,1.5,2.75,NaN,NaN,0.18926347840230281,1.2519676436981364,117.52470701048445,0.01061032823812369,0.1646180734821483,0.1540077452440246,44.84492895834676,5.257252345949606,22.74297891649889,45.35319842156611,31.903822661935,3851669220
1256304600,4.722453,4.727453,4.455789,4.507455,4.1650947540983605,4.82765975,4.457456,2.454976,3.10997,2.454976,NaN,1.216655,NaN,NaN,2.931120365,3.601275780000002,4.141092039999998,4.410376800000002,4.148230701647499,4.457666015266411,4.555787615384613,4.8465266154564866,4.26504861531274,2.931120365,3.601275780000002,4.141092039999998,4.410376800000002,4.563565666666666,127668244,77982048.4,54.41445483348695,NaN,1.5,2.75,NaN,NaN,0.19514922994499545,1.6371491467515746,113.09102521692107,-0.003976338635753418,0.14903732194933283,0.15301366058508625,50.34883039861874,0.22234797235324835,18.03265202709239,51.650602084470854,30.31674588843677,3724000976
1256563800,4.521621,4.668287,4.32579,4.359123,4.1887147377049185,4.837347125,4.750785,2.454976,3.10997,2.454976,NaN,1.216655,NaN,NaN,2.938178625,3.614375650000002,4.154941899999999,4.411710050000002,4.1565009878574015,4.448280966193419,4.5636080769230745,4.8259059286723485,4.3013102251738005,2.938178625,3.614375650000002,4.154941899999999,4.411710050000002,4.451066666666667,122611692,81705658,49.201839841662704,NaN,1.5,2.75,NaN,NaN,0.2056740706632101,1.500651178893878,108.76652539598238,-0.02377173064494792,0.12329899727890137,0.1470707279238493,53.41146866377162,-2.3702814474053935,4.252174483527257,77.62125073778138,18.126574778691353,3601389284
1256650200,4.375789,4.416623,4.262457,4.29329,4.212334721311476,4.8470344999999995,4.750785,2.454976,3.10997,2.454976,NaN,1.216655,NaN,NaN,2.945978545,3.626733860000002,4.1728933999999995,4.410876700000001,4.161865262843386,4.433519921794046,4.558159384615382,4.839087598511375,4.277231170719389,2.945978545,3.626733860000002,4.1728933999999995,4.410876700000001,4.3241233333333335,122535564,84181423.2,47.04770309536278,NaN,1.5,2.75,NaN,NaN,0.2019949227586951,1.455612881584069,105.51804396938512,-0.04047506946976881,0.09647689108663826,0.13695196055640707,53.829640896310615,-8.490244307936289,3.906155900660606,78.61012138739109,17.48372271194832,3478853720
1256736600,4.254124,4.296624,4.022926,4.033292,4.235954704918033,4.856721875,4.750785,2.454976,3.10997,2.454976,NaN,1.216655,NaN,NaN,2.9524243149999996,3.6368004100000024,4.183809919999999,4.3998351000000016,4.15682317410443,4.39540297686128,4.527005846153844,4.921191165144287,4.132820527163401,2.9524243149999996,3.6368004100000024,4.183809919999999,4.3998351000000016,4.117614,130396444,85771985,39.662204498411164,NaN,1.5,2.75,NaN,NaN,0.20711657113307405,1.5202684652803593,97.13651666226501,-0.06666365846406311,0.05362238747632819,0.1202860459403913,51.46608459037384,-14.818753216768988,3.5868059330435744,79.5586316228778,16.854562444078613,3348457276
1256823000,4.123292,4.312457,4.099959,4.287457,4.259574688524591,4.866409249999999,4.750785,2.454976,3.10997,2.454976,NaN,1.216655,NaN,NaN,2.9614825549999995,3.6489336200000024,4.197976439999999,4.417664050000002,4.161946069237589,4.385122407636396,4.510852153846151,4.925250649409834,4.096453658282468,2.9614825549999995,3.6489336200000024,4.197976439999999,4.417664050000002,4.233291,79736812,84430542.6,48.219525807985875,NaN,1.5,2.75,NaN,NaN,0.2122628874807116,0.9444071960755113,102.97570786020962,-0.06445994795128637,0.03971111100128333,0.1041710589525697,66.75066256556454,-7.464051446834309,2.2684081138714305,83.96197640123562,13.769615484892928,3428194088
1256909400,4.254124,4.282457,3.900794,3.924127,4.283194672131148,4.876096625,4.750785,2.454976,3.10997,2.454976,NaN,1.216655,NaN,NaN,2.9685616449999994,3.6576835300000026,4.2028097199999985,4.4198306500000015,4.1526198312282725,4.341218083099596,4.469249999999997,4.988939290433603,3.9495607095663914,2.9685616449999994,3.6576835300000026,4.2028097199999985,4.4198306500000015,4.035792666666667,163900264,88148583,39.578293807157046,NaN,1.5,2.75,NaN,NaN,0.2247200383749465,1.859363570257278,95.6552062660739,-0.08383618736306298,-0.0006241752512590182,0.08321201211180396,80.61114069512192,-17.400450662364214,2.144609996780023,84.42955506257798,13.425834940642,3264293824
1257172200,3.979127,4.124959,3.854961,4.00496,3.854961,4.885783999999999,4.750785,2.454976,3.10997,2.454976,NaN,1.216655,NaN,NaN,2.975794904999999,3.666816760000003,4.205126359999999,4.417664000000001,4.146829249611478,4.309193503756777,4.4164299999999965,4.973233382345493,3.8596266176545004,2.975794904999999,3.666816760000003,4.205126359999999,4.417664000000001,3.99496,164203784,92899709.6,42.06577636056151,NaN,1.5,2.75,NaN,NaN,0.22795417849102173,1.7675381839944957,97.19526953483752,-0.08718606218320088,-0.02577056561719715,0.06141549656600373,79.77321869133839,-14.239803749588875,16.85107828277801,53.285024720046856,29.863896997175132,3428497608
1257258600,3.930794,4.066626,3.908293,4.050793,3.857064142857143,4.895471375,4.750785,2.454976,3.10997,2.454976,NaN,1.216655,NaN,NaN,2.985236514999999,3.676224990000003,4.208492999999999,4.408914050000002,4.143063122175733,4.284583931970418,4.363802307692304,4.919562431290958,3.8080421840936505,2.985236514999999,3.676224990000003,4.208492999999999,4.408914050000002,4.0085706666666665,125825708,95345109,43.48644871262405,NaN,1.5,2.75,NaN,NaN,0.22298123717023446,1.3196870748765939,100.2647768242897,-0.0823502197480743,-0.04152227811908915,0.04082794162898515,81.42238161080894,-10.840056804675397,40.5003504836692,26.716568170439803,32.78308134589099,3554323316
1257345000,4.149959,4.243208,4.04746,4.065792,3.8591672857142854,4.905158749999999,4.750785,2.454976,3.10997,2.454976,NaN,1.216655,NaN,NaN,2.993444764999999,3.6880248700000027,4.211676279999998,4.399330800000001,4.14003288209041,4.263746605116093,4.320148769230766,4.8735271125734645,3.7667704258880668,2.993444764999999,3.6880248700000027,4.211676279999998,4.399330800000001,4.11882,130391092,97912136.2,43.970668885678855,NaN,1.5,2.75,NaN,NaN,0.22103600594378917,1.3317153221298015,101.5143381508247,-0.07441729220995545,-0.05219367363345917,0.022223618576496285,81.52900135679192,-12.968263685830607,69.4980082889607,7.598953074615807,22.903038636423474,3684714408
1257431400,4.162458,4.31079,4.139958,4.304123,3.8612704285714283,4.9148461249999995,4.750785,2.454976,3.10997,2.454976,NaN,1.216655,NaN,NaN,3.0034529949999995,3.7033163800000026,4.219526179999998,4.396330800000001,4.1464677886751,4.2675919760574175,4.2857901538461505,4.780283599248986,3.791296708443315,3.0034529949999995,3.7033163800000026,4.219526179999998,4.396330800000001,4.251623666666667,78401332,97901954.8,51.13522223610336,NaN,1.5,2.75,NaN,NaN,0.22274757694780423,0.8008147759680893,106.90100029284345,-0.05053689034213646,-0.040947494351174285,0.00958939599096217,88.05246371029348,-4.511015639645887,69.440526301868,7.625681392916096,22.933792305215903,3763115740
1257517800,4.229957,4.374124,4.209958,4.33829,3.8633735714285713,4.924533499999999,4.750785,2.454976,3.10997,2.454976,NaN,1.216655,NaN,NaN,3.01341956,3.7190245500000025,4.227466079999998,4.391330900000002,4.1539902283349,4.274325121194806,4.260277692307689,4.704528709470377,3.8160266751450007,3.01341956,3.7190245500000025,4.227466079999998,4.391330900000002,4.307457333333333,79258032,99542335.8,52.08122068698559,NaN,1.5,2.75,NaN,NaN,0.21856317859438962,0.7962243538191114,107.68863623055222,-0.03082685636480231,-0.028944174465040717,0.0018826818997615923,86.60583318207019,-0.4779172324341512,100,0,0,3842373772
1257777000,4.442456,4.635787,4.435789,4.635787,3.8654767142857143,4.934220874999999,4.750785,2.454976,3.10997,2.454976,NaN,1.216655,NaN,NaN,3.024744445,3.7372493800000024,4.241515939999998,4.398247500000001,4.17288421938059,4.308750062033396,4.267392999999997,4.732042044522188,3.802743955477806,3.024744445,3.7372493800000024,4.241515939999998,4.398247500000001,4.569121,62144396,100520118.8,59.44354451145545,NaN,1.5,2.75,NaN,NaN,0.22420130869479035,0.6182284376687386,113.33949487237211,0.002111405316242901,0.004521938545065218,0.0024105332288223173,92.8049211260608,7.97749511446932,100,0,0,3904518168
1257863400,4.604953,4.681619,4.559954,4.634954,3.867579857142857,4.94390825,4.750785,2.454976,3.10997,2.454976,NaN,1.216655,NaN,NaN,3.03561517,3.7551742000000026,4.257649119999998,4.40674745,4.191004602934292,4.339817103744501,4.264572538461535,4.71972055953033,3.80942451739274,3.03561517,3.7551742000000026,4.257649119999998,4.40674745,4.625509,82961520,101644380,59.416017453202066,NaN,1.5,2.75,NaN,NaN,0.21687728664516248,0.8161938712204255,110.35620809433685,0.022570649776866177,0.03062384544990504,0.008053195673038863,91.93712951195502,14.917392541873964,75.51200627408387,5.019704326679263,19.468289399236856,3821556648
1257949800,4.734119,4.799119,4.642454,4.706703,3.8696829999999998,4.953595624999999,4.750785,2.454976,3.10997,2.454976,NaN,1.216655,NaN,NaN,3.0457488199999996,3.776274820000003,4.280250559999998,4.407501600000001,4.211228069485888,4.374758617673596,4.279899307692304,4.778112336055679,3.781686279328928,3.0457488199999996,3.776274820000003,4.280250559999998,4.407501600000001,4.716092,89607380,102290490.6,61.08749234717573,NaN,1.5,2.75,NaN,NaN,0.2131121233133652,0.8760088985241411,113.48670326283656,0.0387163511993422,0.05644863467221661,0.017732283472874415,80.36142126727997,9.778430430905786,73.79299327495508,5.699604588906548,20.50740213613837,3911164028
1258036200,4.681619,4.765786,4.525788,4.564121,3.8717861428571427,4.963283,4.750785,2.454976,3.10997,2.454976,NaN,1.216655,NaN,NaN,3.05633617,3.795999610000003,4.300831999999999,4.398960000000001,4.225067007937422,4.39279313027611,4.295668384615381,4.815424442196562,3.775912327034201,3.05633617,3.795999610000003,4.300831999999999,4.398960000000001,4.618565,97978684,104166878.4,56.139308918663275,NaN,1.5,2.75,NaN,NaN,0.21503254307669625,0.9405934545121206,108.64680062598046,0.037545676965050276,0.06466437967918726,0.027118702714136984,78.53477131105805,16.309207117914383,41.263272783724865,25.99010206726758,32.746625149007556,3813185344
1258122600,4.595787,4.695787,4.526671,4.63912,3.8738892857142853,4.972970374999999,4.750785,2.454976,3.10997,2.454976,NaN,1.216655,NaN,NaN,3.06806522,3.8158627400000027,4.321081799999998,4.399251600000001,4.241304380175171,4.4162528321545755,4.322270692307689,4.873277923127972,3.771263461487406,3.06806522,3.8158627400000027,4.321081799999998,4.399251600000001,4.620526,81538232,104583589.6,58.06355477958091,NaN,1.5,2.75,NaN,NaN,0.21175278999978936,0.7796465230525995,112.28225037055964,0.039382739539447695,0.0763471271384466,0.03696438759899891,50.227549525618834,15.834365386920235,42.38836395616111,25.036290153150375,32.57534589068853,3894723576
1258381800,4.736619,4.904951,4.729119,4.849118,3.8759924285714282,4.904951,4.750785,2.454976,3.10997,2.454976,NaN,1.216655,NaN,NaN,3.080931755,3.8360875400000025,4.342398259999999,4.4041682500000014,4.265140208403595,4.457478086235092,4.385026538461535,4.974574134875867,3.7954789420472017,3.080931755,3.8360875400000025,4.342398259999999,4.4041682500000014,4.827729333333333,70769204,104464519,62.96318288331073,NaN,1.5,2.75,NaN,NaN,0.21561551928551867,0.6774472775775668,117.45392985180327,0.05153425098823624,0.10138220133429421,0.04984795034605797,52.66722527981016,19.70786954554331,44.23995909969182,23.509963962341825,32.25007693796634,3965492780
1258468200,4.810785,4.867451,4.750785,4.862452,3.878095571428571,4.910321333333333,4.750785,2.454976,3.10997,2.454976,NaN,1.216655,NaN,NaN,3.0934399649999995,3.8566373400000025,4.361831419999998,4.413793250000002,4.288564200230906,4.4960470304031785,4.429256923076919,5.067179923955172,3.7913339221986666,3.0934399649999995,3.8566373400000025,4.361831419999998,4.413793250000002,4.8268960000000005,60363276,102899527.4,63.25673098132947,NaN,1.5,2.75,NaN,NaN,0.2085476964794102,0.5866234522667011,115.78761783279816,0.0568455628385007,0.12090490389418385,0.06405934105568314,53.35863502759047,19.594214362171012,70.96493627453408,6.90267995177753,22.132383773688378,4025856056
1258554600,4.851618,4.873285,4.761703,4.845784,3.880198714285714,4.915691666666667,4.750785,2.454976,3.10997,2.454976,NaN,1.216655,NaN,NaN,3.106031504999999,3.8762204800000024,4.379131219999998,4.428918050000002,4.3104159570845955,4.529355313221924,4.500153615384612,5.101580083245321,3.8987271475239025,3.106031504999999,3.8762204800000024,4.379131219999998,4.428918050000002,4.826924,56313188,101056878.4,62.58892419986405,NaN,1.5,2.75,NaN,NaN,0.20162157530230948,0.5572425043360532,113.89779546775202,0.05554692226713731,0.13349299388960478,0.07794607162246747,54.218626055322886,12.584700762501454,45.1218400261121,22.8022204612468,32.075939512641106,3969542868
1258641000,4.741618,4.752452,4.560788,4.642454,3.8823018571428567,4.921061999999999,4.750785,2.454976,3.10997,2.454976,NaN,1.216655,NaN,NaN,3.1169855649999993,3.894345290000002,4.389897779999997,4.4274597500000015,4.323437056806768,4.5401266167245975,4.549191615384612,5.081050789852405,4.017332440916819,3.1169855649999993,3.894345290000002,4.389897779999997,4.4274597500000015,4.651898,98598048,101260144.8,54.96570303216529,NaN,1.5,2.75,NaN,NaN,0.20757689135214455,0.9737103200350155,108.40956354342772,0.03813443302324186,0.1256141129015198,0.08747967987827794,57.80259743238915,7.0111495543174875,44.61190069370807,23.210001709503853,32.178097596788064,3870944820
1258727400,4.039951,4.095792,4.008294,4.064959,3.8844049999999997,4.926432333333333,4.750785,2.454976,3.10997,2.454976,NaN,1.216655,NaN,NaN,3.1240521549999993,3.906370160000002,4.389111119999998,4.405334950000001,4.313300662422189,4.494872557988922,4.5502813076923045,5.07809412392017,4.022468491464439,3.1240521549999993,3.906370160000002,4.389111119999998,4.405334950000001,4.056348333333333,73693060,98561385.6,40.046714607558904,NaN,1.5,2.75,NaN,NaN,0.2380471133984199,0.7476869318687825,106.21238667141752,-0.012430365201530486,0.07194172337636484,0.08437208857789533,99.06385235208083,-12.313507932957224,19.04845638350153,50.06907042555739,30.882473190941088,3797251760
1258986600,4.206625,4.299958,4.179958,4.203291,3.8865081428571426,4.931802666666666,4.750785,2.454976,3.10997,2.454976,NaN,1.216655,NaN,NaN,3.1317229099999997,3.9221366700000018,4.389611099999998,4.397543350000001,4.308986558013475,4.467102885799501,4.560858153846151,5.053769060996939,4.067947246695362,3.1317229099999997,3.9221366700000018,4.389611099999998,4.397543350000001,4.227735666666667,71460712,96003836.6,43.969809388722894,NaN,1.5,2.75,NaN,NaN,0.2378293910128185,0.7443526689224002,110.56698194537812,-0.03541295999694609,0.04010588858171271,0.0755188485786588,91.76705211164864,-9.313210012440242,17.934422274102637,51.65163469127012,30.41394303462725,3868712472
1259073000,4.22329,4.235791,4.117459,4.214541,3.888611285714285,4.937173,4.862452,2.454976,3.10997,2.454976,NaN,1.216655,NaN,NaN,3.14130739,3.9380990100000015,4.389152759999998,4.393605900000002,4.3052828106403975,4.4430493728662155,4.553967230769228,5.063274182773105,4.044660278765351,3.14130739,3.9380990100000015,4.389152759999998,4.393605900000002,4.189263666666666,59027040,92828410.4,44.28908858893835,NaN,1.5,2.75,NaN,NaN,0.22929386308333144,0.6358725711843063,109.03168299822065,-0.04793214149694419,0.015603671707478561,0.06353581320442275,91.8906165615898,-10.456618996354782,16.122631690290035,54.30827713419276,29.569091175517208,3927739512
1259159400,4.248291,4.284957,4.205791,4.269124,3.890714428571428,4.942543333333333,4.862452,2.454976,3.10997,2.454976,NaN,1.216655,NaN,NaN,3.150967795,3.9561571600000014,4.385852779999998,4.405397500000001,4.303864818066264,4.426485051640862,4.548646769230766,5.068196903072404,4.029096635389128,3.150967795,3.9561571600000014,4.385852779999998,4.405397500000001,4.2532906666666666,46115884,88614382.4,45.899869241047675,NaN,1.5,2.75,NaN,NaN,0.21857044429166494,0.5204108266741133,112.20830212724904,-0.05036212419982174,0.0005831579546455856,0.05094528215446732,91.65511168479772,-6.463391307986804,33.571537533472764,33.11167142536196,33.31679104116528,3973855396
1259332200,3.929127,4.149792,3.909128,4.063292,3.909128,4.9479136666666665,4.862452,2.454976,3.10997,2.454976,NaN,1.216655,NaN,NaN,3.159526875,3.9721569900000016,4.3789861599999975,4.394189250000002,4.294430589906803,4.391895237198875,4.504608692307689,5.081081885617802,3.928135498997575,3.159526875,3.9721569900000016,4.3789861599999975,4.394189250000002,4.040737333333333,65483008,87901692.2,41.0767063453873,NaN,1.5,2.75,NaN,NaN,0.22867226969940316,0.7449573081142572,105.7342737462284,-0.06284530030309977,-0.027611343224407392,0.03523395707869238,93.81349001012087,-12.412440290399914,43.63977892800828,24.01235458044941,32.3478664915423,3908372388
1259591400,4.052459,4.119125,3.99496,4.100793,3.9121372777777776,4.953284,4.862452,2.454976,3.10997,2.454976,NaN,1.216655,NaN,NaN,3.168630955,3.988456840000002,4.372684559999998,4.403022550000001,4.286836958930065,4.364171214608506,4.463519384615381,5.07221869699499,3.854820072235772,3.168630955,3.988456840000002,4.372684559999998,4.403022550000001,4.071625999999999,82438244,83828591.2,42.267013767483306,NaN,1.5,2.75,NaN,NaN,0.2212074647208744,0.9834144033664733,108.10935809020981,-0.0653030538067915,-0.04639486017979699,0.018908193626994505,93.12692670257786,-15.432187874165974,76.31864187290319,4.715469369045147,18.965888758051662,3990810632
1259677800,4.219958,4.296624,4.192458,4.247458,3.9151465555555554,4.958654333333333,4.862452,2.454976,3.10997,2.454976,NaN,1.216655,NaN,NaN,3.180026675,4.0063816600000015,4.369951259999998,4.415147450000001,4.285292686030847,4.353055670360077,4.428192846153843,5.029599910877049,3.826785781430637,3.180026675,4.0063816600000015,4.369951259999998,4.415147450000001,4.245513333333333,68005052,79018654.6,46.79392203930981,NaN,1.5,2.75,NaN,NaN,0.2193948600979548,0.8606202211901492,113.43226456443358,-0.05423279682779907,-0.04888280240775433,0.005349994420044737,91.22864507995642,-12.64781636918987,76.08613252792063,4.802645769144445,19.111221702934923,4058815684
1259764200,4.254124,4.348289,4.224124,4.265791,3.9181558333333335,4.964024666666666,4.862452,2.454976,3.10997,2.454976,NaN,1.216655,NaN,NaN,3.19154323,4.022756510000002,4.366117959999998,4.425897350000001,4.2845279140296375,4.344744749373403,4.405244384615381,5.006920420360424,3.8035683488703382,3.19154323,4.022756510000002,4.366117959999998,4.425897350000001,4.279401333333333,58404344,75647586.4,47.34966066460563,NaN,1.5,2.75,NaN,NaN,0.21259272723381523,0.7720582609361347,116.43405614416926,-0.043330007041857445,-0.04881251438227707,-0.005482507340419626,91.33285574978775,-11.969022969245017,76.0936440691041,4.7998180916823125,19.106537839213594,4117220028
1259850600,4.30079,4.369122,4.150792,4.161625,3.921165111111111,4.969395,4.862452,2.454976,3.10997,2.454976,NaN,1.216655,NaN,NaN,3.20285845,4.037564690000002,4.362817999999997,4.430689000000001,4.279708191910828,4.327304773242602,4.368513999999997,4.9668860723259805,3.770141927674013,3.20285845,4.037564690000002,4.362817999999997,4.430689000000001,4.227179666666667,80898100,73172936.8,44.50521666453485,NaN,1.5,2.75,NaN,NaN,0.21300253243139983,1.1055740487923125,113.08664995353027,-0.04082256685391779,-0.056510715907816866,-0.015688149053899075,91.32621659392183,-10.357216248130836,45.826384406087264,22.24973676337355,31.92387883053918,4036321928
1259937000,4.33329,4.389955,4.016627,4.234458,3.924174388888889,4.974765333333333,4.862452,2.454976,3.10997,2.454976,NaN,1.216655,NaN,NaN,3.214851665,4.050767890000002,4.363907999999998,4.427205750000001,4.277933674580992,4.318462223409973,4.321232461538459,4.8537413075302,3.788723615546718,3.214851665,4.050767890000002,4.363907999999998,4.427205750000001,4.21368,122587548,75382247.6,46.906845775535196,NaN,1.5,2.75,NaN,NaN,0.2244543515434427,1.626212429357174,116.89534695375308,-0.03231990774157853,-0.05608803373087223,-0.023768125989293704,91.19410517189905,4.169759153782365,76.68371321388697,4.58005384357014,18.73623294254289,4158909476
1260196200,4.229124,4.294124,4.179124,4.213291,3.9271836666666666,4.9801356666666665,4.862452,2.454976,3.10997,2.454976,NaN,1.216655,NaN,NaN,3.227639035,4.062934420000002,4.365757979999997,4.420955800000001,4.275398667734678,4.308445916418547,4.271296999999998,4.703787123356145,3.838806876643851,3.227639035,4.062934420000002,4.365757979999997,4.420955800000001,4.228846333333333,49506024,73894647.2,46.27999683837655,NaN,1.5,2.75,NaN,NaN,0.21663618357605396,0.6699541289642966,118.6676408461495,-0.026430481786235638,-0.05680622822208825,-0.030375746435852613,46.33133838506737,0.23790881954163504,57.50645233224386,14.09522080549915,28.39832686225699,4109403452
1260282600,4.131625,4.154126,4.039126,4.07996,3.9301929444444443,4.985505999999999,4.862452,2.454976,3.10997,2.454976,NaN,1.216655,NaN,NaN,3.2388681000000004,4.0737843200000015,4.360708019999997,4.393164450000001,4.2677344062548865,4.286685352950114,4.212387461538459,4.50027913086471,3.9244957922122072,3.2388681000000004,4.0737843200000015,4.360708019999997,4.393164450000001,4.091070666666667,66080532,74091454,42.43328358701684,NaN,1.5,2.75,NaN,NaN,0.2136025276063358,0.8918779215751388,115.3286385744802,-0.029585517217468563,-0.06735764295768831,-0.03777212574021975,46.14971235707174,-3.193254022205499,32.76580991918997,33.96075464068894,33.2734354401211,4043322920
1260369000,4.08246,4.144125,4.014127,4.122459,3.933202222222222,4.990876333333333,4.862452,2.454976,3.10997,2.454976,NaN,1.216655,NaN,NaN,3.2505971450000004,4.0840908800000015,4.3569580599999975,4.367539700000002,4.262037331499793,4.271044747907246,4.1723878461538435,4.320914501423003,4.023861190884684,3.2505971450000004,4.0840908800000015,4.3569580599999975,4.367539700000002,4.093570333333333,60172116,72951983.8,44.03020114980122,NaN,1.5,2.75,NaN,NaN,0.20763077563445465,0.8248180908275725,117.13319122165075,-0.02695556244738647,-0.07146657879945284,-0.04451101635206637,46.70056343858034,-3.4354823144045383,32.719017898061615,34.008130007228566,33.27285209470982,4103495036
1260455400,4.199957,4.247458,4.175042,4.197458,3.9362114999999998,4.996246666666666,4.862452,2.454976,3.10997,2.454976,NaN,1.216655,NaN,NaN,3.26310535,4.0947407700000005,4.355824739999997,4.3420774500000014,4.25950480869588,4.264036486201794,4.182580076923074,4.317809385365521,4.0473507684806265,3.26310535,4.0947407700000005,4.355824739999997,4.3420774500000014,4.206652666666667,47047476,70823988.6,46.833139220009436,NaN,1.5,2.75,NaN,NaN,0.20172850594627928,0.6642872977080537,119.58777876337746,-0.018702043214405224,-0.0678885703700729,-0.049186527155667674,47.3972595505546,3.301903973428453,58.7892705396407,13.309340374012875,27.90138908634642,4150542512
1260541800,4.248291,4.277457,4.193292,4.258292,3.939220777777778,5.0016169999999995,4.862452,2.454976,3.10997,2.454976,NaN,1.216655,NaN,NaN,3.2764635600000003,4.105932340000001,4.362373019999998,4.326786000000001,4.259457247570551,4.263489392277814,4.18681092307692,4.327690895167647,4.045930950986193,3.2764635600000003,4.105932340000001,4.362373019999998,4.326786000000001,4.243013666666666,53850956,68617602.2,49.06148026838381,NaN,1.5,2.75,NaN,NaN,0.19333111266440223,0.7847979858439297,122.68288944717013,-0.008217797307570558,-0.05945877379013087,-0.05124097648256031,36.89247947726814,3.8406961775441872,46.70828067868283,21.60519688012403,31.686522441193144,4204393468
1260801000,4.339124,4.359957,4.28329,4.348289,3.9422300555555556,5.006987333333333,4.862452,2.454976,3.10997,2.454976,NaN,1.216655,NaN,NaN,3.2913467350000003,4.115898900000001,4.371722899999997,4.312244450000001,4.262940845705039,4.271565545394212,4.197099230769227,4.362054667946207,4.0321437935922475,3.2913467350000003,4.115898900000001,4.371722899999997,4.312244450000001,4.330512,41586028,66619992,52.24993979368538,NaN,1.5,2.75,NaN,NaN,0.18678353318837346,0.6242274541251821,126.93666360603125,0.004994867919515929,-0.0449973915831654,-0.04999225950268133,38.009918429445634,2.3739139975015724,71.43297892942302,6.705987266696326,21.86103380388065,4245979496
1260887400,4.30329,4.35829,4.259124,4.294124,3.9452393333333333,5.0123576666666665,4.862452,2.454976,3.10997,2.454976,NaN,1.216655,NaN,NaN,3.3061174200000005,4.124907150000001,4.376639519999998,4.28449475,4.26416371450092,4.273713969642382,4.199022307692305,4.3678295481173794,4.03021506726723,3.3061174200000005,4.124907150000001,4.376639519999998,4.28449475,4.303846,38758164,65019440,50.21278380196958,NaN,1.5,2.75,NaN,NaN,0.18052513796063252,0.596101166051261,124.07746791493209,0.010013557408542935,-0.037475312742002664,-0.0474888701505456,34.23998798221189,0.6641910023252414,81.65290965515243,2.921139589017443,15.425950755830128,4207221332
1260973800,4.351623,4.389123,4.294124,4.32329,3.948248611111111,5.017728,4.862452,2.454976,3.10997,2.454976,NaN,1.216655,NaN,NaN,3.320608935000001,4.133898730000001,4.378589479999997,4.2575366500000005,4.266482392363629,4.278435496343108,4.219022153846151,4.380201888485363,4.0578424192069384,3.320608935000001,4.133898730000001,4.378589479999997,4.2575366500000005,4.335512333333333,43067144,64154633.4,51.31353592817751,NaN,1.5,2.75,NaN,NaN,0.1744161281063016,0.6713021603830098,127.10010974557687,0.014928500473359037,-0.028828244558846805,-0.04375674503220584,34.35324553363691,3.8846604391313533,80.30754202074912,3.3382714844279753,16.35418649482288,4250288476
1261060200,4.231624,4.256624,4.158291,4.172459,3.9512578888888887,5.0230983333333326,4.862452,2.454976,3.10997,2.454976,NaN,1.216655,NaN,NaN,3.3351796250000008,4.141581990000001,4.376889519999997,4.223870400000001,4.262795200506232,4.268342496691384,4.22453492307692,4.373610395595861,4.075459450557979,3.3351796250000008,4.141581990000001,4.376889519999997,4.223870400000001,4.195791333333333,53842568,64031102.4,45.687903628285966,NaN,1.5,2.75,NaN,NaN,0.17374347609870863,0.8408814776239117,122.79807967983265,0.007999754745873847,-0.03375705159986353,-0.04175680634573738,37.73118216766502,-1.4641543262443537,48.93034775080158,19.901059157431117,31.168593091767296,4196445908
1261146600,4.242458,4.247458,4.133293,4.236624,3.954267166666667,5.028468666666666,4.862452,2.454976,3.10997,2.454976,NaN,1.216655,NaN,NaN,3.3500665600000006,4.150498560000001,4.374339539999998,4.203578900000001,4.261768878917752,4.265321687482681,4.223701538461535,4.372375692320266,4.075027384602804,3.3500665600000006,4.150498560000001,4.374339539999998,4.203578900000001,4.205791666666666,48304212,61516410.6,48.285342437914665,NaN,1.5,2.75,NaN,NaN,0.1694878706630866,0.7852248128404292,125.22503453934486,0.007713140024893192,-0.03211538131462088,-0.039828521339514075,37.403468340382624,0.5537951212009816,47.45943730935516,21.004502122971754,31.536060567673093,4244750120
1261405800,4.30579,4.408288,4.299958,4.364956,3.9572764444444446,5.0338389999999995,4.862452,2.454976,3.10997,2.454976,NaN,1.216655,NaN,NaN,3.3658080650000013,4.159615130000001,4.372872899999997,4.218578750000001,4.265815432685684,4.274810669627187,4.231329615384612,4.397056800812561,4.065602429956663,3.3658080650000013,4.159615130000001,4.372872899999997,4.218578750000001,4.357734,35197476,59591631.4,53.11487687545153,NaN,1.5,2.75,NaN,NaN,0.16964330847286613,0.5906446118875678,129.05474297037023,0.01568211738447286,-0.020225874608923,-0.03590799199339586,40.85646491174561,6.985264561417281,44.93592208236327,22.9510397779705,32.11303813966624,4279947596
1261492200,4.399122,4.440788,4.379123,4.417455,3.9602857222222223,5.039209333333333,4.862452,2.454976,3.10997,2.454976,NaN,1.216655,NaN,NaN,3.3807329100000008,4.169156690000001,4.3712728999999975,4.2292869500000005,4.271762082384284,4.288395843948408,4.251008846153843,4.438307261073163,4.063710431234522,3.3807329100000008,4.169156690000001,4.3712728999999975,4.2292869500000005,4.412455333333334,31474584,57592325,54.96762842389912,NaN,1.5,2.75,NaN,NaN,0.16294250072480426,0.546506570102874,131.7634035443926,0.02353256534348211,-0.006492285314043222,-0.03002485065752533,34.04531924623039,7.155826170739363,69.73719477542693,7.4579908143519305,22.80481441022116,4311422180
1261578600,4.458289,4.469122,4.395789,4.456622,3.963295,5.0445796666666665,4.862452,2.454976,4.862452,2.454976,3.10997,1.216655,NaN,NaN,3.3957244250000014,4.17736494,4.371106239999998,4.241391000000001,4.279011490918234,4.304417382619988,4.2680983846153815,4.484515660376158,4.051681108854605,3.3957244250000014,4.17736494,4.371106239999998,4.241391000000001,4.440511,28063912,56044168.6,56.35338408438244,NaN,1.5,2.75,NaN,NaN,0.15654182210160394,0.5007463345615586,135.54350362593885,0.029992735345664177,0.007466068524554892,-0.022526666821109285,34.01692866770871,6.174308355199746,67.19955286541709,8.667427091130877,24.133020043452042,4339486092
1261665000,4.480789,4.531621,4.480789,4.526622,3.9663042777777777,5.049949999999999,4.862452,2.454976,4.862452,2.454976,3.10997,1.216655,NaN,NaN,3.4101784500000014,4.1859148600000005,4.367806279999997,4.254265900000001,4.288721706960656,4.32557972713237,4.292200769230766,4.545485046786066,4.038916491675467,3.4101784500000014,4.1859148600000005,4.367806279999997,4.254265900000001,4.513010666666666,14532420,54464995.4,58.79392188660636,NaN,1.5,2.75,NaN,NaN,0.15071733480863223,0.2668212838956744,139.1684174180172,0.03714218378995879,0.0239010629163392,-0.013241120873619588,33.77648000220338,6.301352748942527,100,0,0,4354018512
1262010600,4.570788,4.578288,4.494955,4.540789,3.9693135555555554,5.0553203333333325,4.862452,2.454976,4.862452,2.454976,3.10997,1.216655,NaN,NaN,3.4245158100000013,4.19496478,4.363922999999997,4.27814075,4.2986066988445515,4.3460758483578585,4.327649153846152,4.5811849670067035,4.0741133406856,3.4245158100000013,4.19496478,4.363922999999997,4.27814075,4.538010666666667,18202824,52100986.2,59.2900570325357,NaN,1.5,2.75,NaN,NaN,0.14590416803658707,0.3493758050975242,138.65126960504193,0.04070108653299387,0.03763523729262275,-0.0030658492403711213,33.5602798221206,4.427028654259178,100,0,0,4372221336
1262097000,4.580788,4.580788,4.516622,4.521621,3.972322833333333,5.060690666666666,4.862452,2.454976,4.862452,2.454976,3.10997,1.216655,NaN,NaN,3.4388615000000016,4.20433969,4.361689659999998,4.299182150000001,4.307352357713393,4.3627944342285385,4.358353923076921,4.60152352427229,4.115184321881552,3.4388615000000016,4.20433969,4.361689659999998,4.299182150000001,4.539677,21062788,49032213.4,58.26782124481879,NaN,1.5,2.75,NaN,NaN,0.14006572746254514,0.4295704097257825,137.15653409859465,0.039602813395756706,0.046437667504324764,0.006834854108568057,32.68019909736803,5.2978675045247785,79.66031759584564,3.5951117056188213,16.744570698535522,4351158548
1262183400,4.473288,4.527455,4.469205,4.507455,3.9753321111111113,5.0660609999999995,4.862452,2.454976,4.862452,2.454976,3.10997,1.216655,NaN,NaN,3.452385530000002,4.21213294,4.356823059999997,4.312182000000002,4.315199520156005,4.3765716309686775,4.382199846153844,4.618275907582354,4.146123784725334,3.452385530000002,4.21213294,4.356823059999997,4.312182000000002,4.5013716666666665,17838008,46523861.2,57.47908073456511,NaN,1.5,2.75,NaN,NaN,0.13422174692950622,0.3834163274479032,135.56327908496326,0.03587203906578104,0.051674902940794354,0.015802863875013316,31.3720056441033,4.259834524170253,51.707521978454835,18.057771956585114,30.234706064960065,4333320540
1262269800,4.535787,4.539121,4.375789,4.375789,3.978341388888889,5.071431333333333,4.862452,2.454976,4.862452,2.454976,3.10997,1.216655,NaN,NaN,3.4646187400000024,4.218916199999999,4.350939799999997,4.317681900000001,4.317575578189103,4.376497094685947,4.3912380769230746,4.616390795448437,4.166085358397712,3.4646187400000024,4.218916199999999,4.350939799999997,4.317681900000001,4.430233,18996884,44553488.2,50.620379958300255,NaN,1.5,2.75,NaN,NaN,0.13630105072025575,0.4263837640438667,132.05870332147185,0.0231065022116353,0.04468599163955744,0.021579489427922142,36.996685509626865,4.873145547985019,19.376763979988798,49.866411811981585,30.75682420802962,4314323656
1262615400,4.490788,4.607453,4.489955,4.599954,3.9813506666666667,5.076801666666666,4.862452,2.454976,4.862452,2.454976,3.10997,1.216655,NaN,NaN,3.478297770000003,4.2292661,4.352073119999997,4.339598350000001,4.328649241789531,4.397778704715857,4.410596923076921,4.659656968949658,4.161536877204183,3.478297770000003,4.2292661,4.352073119999997,4.339598350000001,4.565787333333334,28258660,41921516.2,59.48444076780088,NaN,1.5,2.75,NaN,NaN,0.14311268995452314,0.674084874821393,137.17700086039724,0.028002980517118255,0.05658321507431996,0.028580234557201704,38.438847844070246,8.575932157302617,27.731771629729227,39.285631689970124,32.98259668030063,4342582316
1262701800,4.594954,4.645787,4.541621,4.643287,3.9843599444444444,5.082172,4.862452,2.454976,4.862452,2.454976,3.10997,1.216655,NaN,NaN,3.4928267900000027,4.23883266,4.351506459999998,4.360039800000001,4.340987977405628,4.421160447123871,4.4374556153846125,4.705095508046995,4.16981572272223,3.4928267900000027,4.23883266,4.351506459999998,4.360039800000001,4.610231666666667,33210560,37452666.8,60.94395676975139,NaN,1.5,2.75,NaN,NaN,0.1403307835292001,0.8867341857749901,139.83532113204748,0.03210888603024689,0.06871634209501032,0.03660745606476343,38.27875738661901,6.376490393030299,37.27160213173284,29.56019973640165,33.168198131865516,4375792876
1262788200,4.629954,4.685786,4.61912,4.655787,3.987369222222222,5.0875423333333325,4.862452,2.454976,4.862452,2.454976,3.10997,1.216655,NaN,NaN,3.505518330000003,4.247782569999999,4.354473099999998,4.382164600000001,4.353333037115211,4.443505833112074,4.4630323076923055,4.745293368947944,4.180771246436667,3.505518330000003,4.247782569999999,4.354473099999998,4.382164600000001,4.653564333333333,44198660,37187298.6,61.376189923324695,NaN,1.5,2.75,NaN,NaN,0.1350690132771144,1.1885418318608385,142.4173100295191,0.03346316480667,0.07843641207310093,0.04497324726643093,36.02265938962482,5.395233228182285,69.79578690010145,7.437356546275523,22.766856553623025,4419991536
1262874600,4.63162,4.725787,4.586955,4.710453,3.9903785000000003,5.092912666666666,4.862452,2.454976,4.862452,2.454976,3.10997,1.216655,NaN,NaN,3.5191790250000032,4.258220799999999,4.361499699999998,4.413689250000001,4.367337741542065,4.468929372815686,4.504416461538459,4.760692437874806,4.248140485202112,3.5191790250000032,4.258220799999999,4.361499699999998,4.413689250000001,4.674398333333333,43790236,36072783.8,63.28961197626561,NaN,1.5,2.75,NaN,NaN,0.13533779804303486,1.2139411319843856,145.36998845074191,0.03563645001213382,0.08951880978159821,0.053882359769464386,36.007260790552024,5.695591863074766,88.47023113633549,1.2063911465523467,10.32337771711217,4463781772
1262961000,4.669952,4.766619,4.643287,4.760786,3.993387777777778,5.0982829999999995,4.862452,2.454976,4.862452,2.454976,3.10997,1.216655,NaN,NaN,3.5328163950000033,4.2718715099999995,4.370849619999998,4.4456056,4.382767085011004,4.496725242071335,4.544736615384613,4.784178092073804,4.3052951386954215,3.5328163950000033,4.2718715099999995,4.370849619999998,4.4456056,4.723564,39688212,35048588.6,65.0084654411037,NaN,1.5,2.75,NaN,NaN,0.13448024103996098,1.1323768969116206,147.95481314137737,0.03785140076346302,0.10119661072379316,0.06334520996033013,36.06593590215632,5.173040735453517,100,0,0,4503469984
1263220200,4.823285,4.834117,4.718286,4.77912,3.9963970555555557,4.834117,4.862452,2.454976,4.862452,2.454976,3.10997,1.216655,NaN,NaN,3.5458471050000036,4.2847880499999995,4.385766179999997,4.474688700000001,4.3983103365792,4.523619980921684,4.576595384615382,4.822014626217664,4.331176143013101,3.5458471050000036,4.2847880499999995,4.385766179999997,4.474688700000001,4.777174333333334,39461180,34669273.8,65.63956464269933,NaN,1.5,2.75,NaN,NaN,0.13314815239424949,1.138217668695443,150.34733021154312,0.03784798286993467,0.11065518854774847,0.0728072056778138,35.62366990974486,5.248669339183116,100,0,0,4542931164
1263306600,4.679953,4.70662,4.583288,4.63912,3.9994063333333334,4.832202567567568,4.862452,2.454976,4.862452,2.454976,3.10997,1.216655,NaN,NaN,3.5588219750000043,4.295387939999999,4.3927994399999974,4.493730100000001,4.40775385279178,4.534619982738667,4.593646538461536,4.822727300155365,4.364565776767708,3.5588219750000043,4.295387939999999,4.3927994399999974,4.493730100000001,4.6430093333333335,71001660,35526809,57.16155054093736,NaN,1.5,2.75,NaN,NaN,0.13762557008037454,1.9985374988223683,146.39545926848118,0.02626354446665266,0.10563663626112962,0.07937309179447696,40.97465864517954,2.598603465438622,66.20696280116263,9.342985738637825,24.450051460199543,4471929504
1263393000,4.674954,4.795785,4.601621,4.758287,4.002415611111111,4.830288135135135,4.862452,2.454976,4.862452,2.454976,3.10997,1.216655,NaN,NaN,3.573401000000004,4.306146179999999,4.409482639999998,4.514230000000001,4.421500250721514,4.555921603430222,4.616851538461535,4.846824183048288,4.3868788938747825,3.573401000000004,4.306146179999999,4.409482639999998,4.514230000000001,4.718564333333334,58325128,36363764,61.69656633704822,NaN,1.5,2.75,NaN,NaN,0.14166402936034783,1.6039353901867806,149.93253002904243,0.024507194721209186,0.11000708519598845,0.08549989047477927,42.766131793614896,5.564825383725404,68.62840949884163,8.13845000233432,23.23314049882406,4530254632
1263479400,4.744953,4.819952,4.736619,4.796619,4.005424888888889,4.828373702702703,4.862452,2.454976,4.862452,2.454976,3.10997,1.216655,NaN,NaN,3.587959190000004,4.315221089999999,4.425315819999997,4.539354750000002,4.436210789908905,4.578845165008296,4.637620538461535,4.879695866224947,4.395545210698123,3.587959190000004,4.315221089999999,4.425315819999997,4.539354750000002,4.784396666666667,39723348,36412023.2,63.051542123819445,NaN,1.5,2.75,NaN,NaN,0.13749752726318012,1.0909404232171311,151.78250672973448,0.023788413591900676,0.1152354074646551,0.09144699387275443,42.45857879746234,9.617237028567866,68.12565632017184,8.382271800150196,23.492071879677958,4569977980
1263565800,4.773286,4.789952,4.581621,4.634954,4.0084341666666665,4.82645927027027,4.862452,2.454976,4.862452,2.454976,3.10997,1.216655,NaN,NaN,3.601141565000004,4.322746019999999,4.436999039999997,4.554937950000001,4.4440046412850265,4.584188863578935,4.6448639999999966,4.8804648306397755,4.409263169360218,3.601141565000004,4.322746019999999,4.436999039999997,4.554937950000001,4.668842333333334,65681108,37542721.4,54.32343165447925,NaN,1.5,2.75,NaN,NaN,0.1430332753158101,1.749503114071001,147.85714678391736,0.010940080147650938,0.1051220940573181,0.09418201390966716,43.94606682973827,0.7608771739891149,38.31486830929076,28.946197788126238,32.738933902583014,4504296872
1263911400,4.62912,4.808285,4.622454,4.801619,4.011443444444445,4.824544837837838,4.862452,2.454976,4.862452,2.454976,3.10997,1.216655,NaN,NaN,3.6142664350000033,4.331695929999999,4.4517155799999975,4.586395950000002,4.458028733783653,4.604896495619037,4.666402307692304,4.904182297756014,4.428622317628594,3.6142664350000033,4.331695929999999,4.4517155799999975,4.586395950000002,4.744119333333333,42061380,36953662,60.40818546202372,NaN,1.5,2.75,NaN,NaN,0.14609025565039505,1.1382195355902751,153.12205877231887,0.012091028076532978,0.10929579900533337,0.0972047709288004,39.10753138797475,3.4099119869178818,36.8727180664108,29.988672441679356,33.13860949190985,4546358252
1263997800,4.70412,4.709953,4.547455,4.659953,4.014452722222222,4.822630405405405,4.862452,2.454976,4.862452,2.454976,3.10997,1.216655,NaN,NaN,3.6263288100000035,4.339179179999999,4.458832179999997,4.607562400000001,4.4659473324588035,4.610139972226747,4.6781329230769195,4.8977418436642095,4.4585240024896295,3.6263288100000035,4.339179179999999,4.458832179999997,4.607562400000001,4.6391203333333335,70345408,38055721.8,53.84249198829895,NaN,1.5,2.75,NaN,NaN,0.15380980881822395,1.848484397949325,148.9067022311434,0.0022515977653462665,0.10001926813548323,0.09776767037013696,43.490183762196345,0.08948003849831768,36.95838008053149,29.908768448435648,33.13285147103286,4476012844
1264084200,4.663288,4.710786,4.389123,4.407956,4.017462,4.820715972972973,4.862452,2.454976,4.862452,2.454976,3.10997,1.216655,NaN,NaN,3.6373728650000032,4.343845789999999,4.460225499999997,4.609712400000001,4.463673162558458,4.5908843558242,4.680607307692305,4.886852406033514,4.474362209351096,3.6373728650000032,4.343845789999999,4.460225499999997,4.609712400000001,4.502621666666667,137732456,43182470.8,44.56389383877666,NaN,1.5,2.75,NaN,NaN,0.1657993224740651,3.1895455134540383,143.27711008851819,-0.021006788025330944,0.07150918533847328,0.09251597336380422,53.92707734247366,-6.421823973193232,7.655812473556864,69.3770603542779,22.967127172165238,4338280388
1264170600,4.351623,4.395789,4.097527,4.115792,4.020471277777778,4.818801540540541,4.862452,2.454976,4.862452,2.454976,3.10997,1.216655,NaN,NaN,3.6477852650000036,4.345670769999999,4.449825599999998,4.5946292500000006,4.450030764026754,4.545637464793324,4.643364076923074,5.008256052753613,4.278472101092535,3.6477852650000036,4.345670769999999,4.449825599999998,4.5946292500000006,4.203036,138271476,48522315.4,36.673097690262175,NaN,1.5,2.75,NaN,NaN,0.1761300137259176,2.849647113088919,137.72670311750608,-0.05397215750979559,0.025050776476559733,0.07902293398635532,63.39969917457448,-13.54805698050701,1.213835465469007,88.45960858119847,10.326555953332523,4200008912
1264429800,4.225792,4.242458,4.133293,4.176625,4.0234805555555555,4.816887108108109,4.862452,2.454976,4.862452,2.454976,3.10997,1.216655,NaN,NaN,3.658151825000003,4.349154069999998,4.440659019999997,4.580629400000001,4.439308969359038,4.510493420527293,4.607466999999998,5.049078928092108,4.165855071907888,3.658151825000003,4.349154069999998,4.440659019999997,4.580629400000001,4.184125333333333,71226244,50680432,39.091415721594274,NaN,1.5,2.75,NaN,NaN,0.17259686988835207,1.4053993067778112,140.00174689199133,-0.06864311983788218,-0.006780965810997408,0.061862154026884775,64.00079168950623,-12.606818828570956,7.414673898406337,69.84131371592903,22.74401238566462,4271235156
1264516200,4.123292,4.25079,4.093292,4.121626,4.026489833333334,4.814972675675675,4.862452,2.454976,4.862452,2.454976,3.10997,1.216655,NaN,NaN,3.6670100700000035,4.354604019999998,4.428957479999998,4.560379600000001,4.426850813697899,4.473458428096123,4.56637769230769,5.076453677010051,4.05630170760533,3.6670100700000035,4.354604019999998,4.428957479999998,4.560379600000001,4.1552359999999995,68534796,53380550.8,37.69004802443723,NaN,1.5,2.75,NaN,NaN,0.17151837918204121,1.283890761202112,136.54602280209247,-0.07831410217420158,-0.036030473690867204,0.042283628483334376,63.09329898598456,-11.15500353515322,2.243310132247433,84.03406472472935,13.722625143023214,4202700360
1264602600,4.11246,4.201625,4.011627,4.180792,4.029499111111111,4.813058243243243,4.862452,2.454976,4.862452,2.454976,3.10997,1.216655,NaN,NaN,3.6760824800000034,4.361061449999998,4.421290899999997,4.54237975,4.417201448454844,4.445585434944111,4.525634538461536,5.06683419741567,3.9844348795074023,3.6760824800000034,4.361061449999998,4.421290899999997,4.54237975,4.131348,97211940,57331006.6,40.17465672694169,NaN,1.5,2.75,NaN,NaN,0.17283835209760973,1.6956259058601633,135.6656819590095,-0.076879987772867,-0.053816356232749385,0.023063631540117622,64.31862343625346,-12.136615550932506,13.207618001595408,58.913024284969694,27.879357713434892,4299912300
1264689000,4.224958,4.224958,3.955794,4.03246,4.032508388888889,4.811143810810811,4.862452,2.454976,4.862452,2.454976,3.10997,1.216655,NaN,NaN,3.6850323900000035,4.365119749999998,4.409157699999997,4.5179217000000005,4.402113548515438,4.406240155425625,4.469609461538459,5.051128923642095,3.8880899994348237,3.6850323900000035,4.365119749999998,4.409157699999997,4.5179217000000005,4.0710706666666665,97955056,61175620,36.26989765749794,NaN,1.5,2.75,NaN,NaN,0.17971875551920902,1.6012106783715474,131.1542585498768,-0.08162740508800684,-0.07897062481989092,0.0026567802681159124,61.42866784035852,-15.93120070616406,16.497623625240703,53.742319621550294,29.760056753208996,4201957244
1264775400,4.080793,4.165793,3.873295,3.884961,4.035517666666667,4.809229378378379,4.862452,2.454976,4.862452,2.454976,3.10997,1.216655,NaN,NaN,3.692894810000004,4.366136409999998,4.389874559999997,4.486797000000001,4.381833056416793,4.356594521575565,4.400827999999997,5.029269628868888,3.7723863711311063,3.692894810000004,4.366136409999998,4.389874559999997,4.486797000000001,3.974683,99804108,65273925,32.850690049632064,NaN,1.5,2.75,NaN,NaN,0.18777441583926552,1.529004238675704,127.37382647580554,-0.08976121378478583,-0.10954473696286637,-0.019783523178080548,60.289152441572135,-16.181239339160637,20.32476591163926,48.345557151304135,31.329676937056607,4102153136
1265034600,3.97496,4.074126,3.96496,4.069126,4.0385269444444445,4.807314945945946,4.862452,2.454976,4.862452,2.454976,3.10997,1.216655,NaN,NaN,3.7011655600000033,4.367919729999998,4.374008039999998,4.471463850000001,4.369570034596527,4.329216567139797,4.356982307692305,4.992302389567156,3.721662225817454,3.7011655600000033,4.367919729999998,4.374008039999998,4.471463850000001,4.036070666666666,67259364,67687049,40.40495168237629,NaN,1.5,2.75,NaN,NaN,0.18787374327931797,0.9936814352772271,132.24209105366077,-0.07822055368644258,-0.11755921528613378,-0.039338661599691196,70.65325805985178,-15.255125406659708,19.89103404423185,48.91619254506568,31.192773410702475,4169412500
1265121000,4.100793,4.246625,4.052459,4.224958,4.041536222222223,4.805400513513514,4.862452,2.454976,4.862452,2.454976,3.10997,1.216655,NaN,NaN,3.709940475000004,4.370361369999998,4.3615915199999975,4.452714050000002,4.363898974416271,4.319287179793149,4.3159569999999965,4.909850980783668,3.7220630192163244,3.709940475000004,4.370361369999998,4.3615915199999975,4.452714050000002,4.174680666666667,66940136,69621122.8,45.946238381513524,NaN,1.5,2.75,NaN,NaN,0.1883231901879381,0.9614917615203988,136.67529907193978,-0.05658316358221155,-0.11006761607745563,-0.053484452495244084,71.22576813168983,-9.334750801134687,40.383048822996464,26.74995252472646,32.86699865227708,4236352636
1265207400,4.168292,4.227458,4.122459,4.161625,4.0445455,4.803486081081081,4.862452,2.454976,4.862452,2.454976,3.10997,1.216655,NaN,NaN,3.719987040000003,4.370936359999998,4.351974939999997,4.428630950000001,4.355966661694064,4.304271734098564,4.267111307692304,4.7957011247526875,3.7385214906319217,3.719987040000003,4.370936359999998,4.351974939999997,4.428630950000001,4.170514000000001,62983144,71109752,44.14950203576446,NaN,1.5,2.75,NaN,NaN,0.1823714623173711,0.8857173907736312,133.8679956717081,-0.043609240275008385,-0.10799600283900457,-0.06438676256399618,70.42454488785621,-5.588327106713417,15.591611077747991,55.098489388532776,29.309899533719225,4173369492
1265293800,4.057459,4.064126,3.768296,3.774962,4.047554777777778,4.801571648648649,4.862452,2.454976,4.862452,2.454976,3.10997,1.216655,NaN,NaN,3.727470295000003,4.367643059999998,4.346174999999997,4.384589700000001,4.333182165157043,4.253861283232034,4.200958076923074,4.743908656432685,3.658007497413463,3.727470295000003,4.367643059999998,4.346174999999997,4.384589700000001,3.869128,109684984,74384068.2,35.11979594538707,NaN,1.5,2.75,NaN,NaN,0.1974398578661303,1.4745762991220746,126.19824991320996,-0.05728029557743039,-0.13598713203578416,-0.07870683645835377,83.01877746318299,-8.281030722640988,15.202017918614558,55.699238576309675,29.098743505075756,4063684508
1265380200,3.779962,3.816628,3.564964,3.793295,3.564964,4.799657216216216,4.862452,2.454976,4.862452,2.454976,3.10997,1.216655,NaN,NaN,3.7352493800000026,4.363793089999998,4.337975079999997,4.3387318000000015,4.31201011946461,4.209997827686126,4.12339469230769,4.582581748498475,3.664207636116904,3.7352493800000026,4.363793089999998,4.337975079999997,4.3387318000000015,3.7249623333333335,148968036,79642958.2,35.790349878476405,NaN,1.5,2.75,NaN,NaN,0.20131301087569245,1.8704483028607544,124.03257661257794,-0.060958796008318106,-0.1549053314687514,-0.0939465354604333,76.27681529573202,-9.177984616765919,50.81359082154937,18.514341056771396,30.672068121679228,4212652544
1265639400,3.793295,3.864128,3.703296,3.707464,3.5576413617021276,4.797742783783784,4.862452,2.454976,4.862452,2.454976,3.10997,1.216655,NaN,NaN,3.742278480000002,4.358493149999998,4.327833539999997,4.286065700000002,4.288302428505213,4.162137463144591,4.050126307692304,4.442589001154525,3.657663614230083,3.742278480000002,4.358493149999998,4.327833539999997,4.286065700000002,3.758296,94868964,82401995.8,34.01770463206334,NaN,1.5,2.75,NaN,NaN,0.19842151009885728,1.151294493282164,120.5791043616057,-0.06468988926976768,-0.1748088970476429,-0.11011900777787523,75.20343499689426,-10.048509981254975,21.428085672713166,48.88869752561219,29.68321680167463,4117783580
1265725800,3.840795,3.944961,3.749963,3.848294,3.550318723404255,4.795828351351352,4.862452,2.454976,4.862452,2.454976,3.10997,1.216655,NaN,NaN,3.7494617350000023,4.352634859999998,4.319416939999997,4.239524400000001,4.271047196014813,4.132247609511772,4.007075384615382,4.35312467623062,3.6610260930001433,3.7494617350000023,4.352634859999998,4.319416939999997,4.239524400000001,3.8477393333333336,140023352,87430104.4,39.327563887084004,NaN,1.5,2.75,NaN,NaN,0.2012126165203675,1.601546206091457,125.4765134097265,-0.05364593978277561,-0.17717643250634474,-0.12353049272356913,80.28149278945857,-7.95299072520231,29.326171292764688,39.47162694670338,31.202201760531924,4257806932
1265812200,3.833295,3.892453,3.729129,3.824128,3.542996085106383,4.7939139189189195,4.862452,2.454976,4.862452,2.454976,3.10997,1.216655,NaN,NaN,3.756832490000002,4.3468099099999975,4.3146336599999975,4.198774800000001,4.253520953033839,4.102902884796365,3.98463969230769,4.337341189133272,3.631938195482108,3.756832490000002,4.3468099099999975,4.3146336599999975,4.198774800000001,3.8152366666666673,90808052,88420424,38.751280731116104,NaN,1.5,2.75,NaN,NaN,0.19850628676891272,1.027003127693665,123.92949743470675,-0.0443276111336115,-0.17894000664058352,-0.13461239550697202,79.16493596084858,-5.166374867946622,26.807551853684917,42.30721731564875,30.885230830666327,4166998880
1265898600,3.823295,3.965794,3.748379,3.95146,3.5356734468085103,4.791999486486486,4.862452,2.454976,4.862452,2.454976,3.10997,1.216655,NaN,NaN,3.764919080000002,4.342165779999998,4.311646999999997,4.158433450000001,4.241675425463885,4.088479752910997,3.967319307692305,4.302276119266467,3.632362496118142,3.764919080000002,4.342165779999998,4.311646999999997,4.158433450000001,3.8885443333333334,85056800,89757007.6,43.45309223495225,NaN,1.5,2.75,NaN,NaN,0.1998569091425618,0.9476340875695594,128.56554723453405,-0.026810070354987836,-0.1681249834507068,-0.14131491309571897,80.35901992731083,1.7117031548064412,52.07181747663612,19.046442794911883,28.881739728451993,4252055680
1265985000,3.830795,3.95246,3.782462,3.95246,3.528350808510638,4.790085054054054,4.862452,2.454976,4.862452,2.454976,3.10997,1.216655,NaN,NaN,3.7723356700000017,4.337849149999998,4.305747039999997,4.116225500000001,4.230333644073145,4.075525490728998,3.9543065384615357,4.277200252281391,3.6314128246416804,3.7723356700000017,4.337849149999998,4.305747039999997,4.116225500000001,3.8957939999999995,89487184,92245199.4,43.48978177856313,NaN,1.5,2.75,NaN,NaN,0.19772412991809304,0.9701012581907866,130.12132824272723,-0.013072828224688138,-0.15765594837657915,-0.144583120151891,77.1684019357145,-2.8671021737837545,46.45677274518961,23.34267546190137,30.20055179290902,4341542864
1266330600,4.044959,4.154117,4.000802,4.140792,3.521028170212766,4.788170621621622,4.862452,3.707464,4.862452,2.454976,3.10997,1.216655,NaN,NaN,3.780673090000002,4.334682509999998,4.303247059999997,4.0915174000000025,4.2268222070506685,4.081741348754807,3.9512296153846127,4.266094287186069,3.636364943583156,3.780673090000002,4.334682509999998,4.303247059999997,4.0915174000000025,4.098570333333334,54301848,91676236.4,50.061484089230916,NaN,1.5,2.75,NaN,NaN,0.19800504920965786,0.5923219596741648,135.111986181984,0.009559753235386742,-0.1326334286076576,-0.14219318184304433,77.21777633707259,-1.9921144778243889,73.65576780987463,6.283188834036463,20.06104335608891,4395844712
1266417000,4.196625,4.22079,4.148292,4.202124,3.5137055319148933,4.7862561891891895,4.862452,3.707464,4.862452,2.454976,3.10997,1.216655,NaN,NaN,3.7890713350000023,4.333437519999999,4.304057039999997,4.061542650000002,4.225853649911427,4.093206363159111,3.9642806923076894,4.304569955668129,3.62399142894725,3.7890713350000023,4.333437519999999,4.304057039999997,4.061542650000002,4.190402,67714096,92958872.2,52.018404984894815,NaN,1.5,2.75,NaN,NaN,0.18957597426611086,0.7284306962579522,138.08688113811272,0.028454691821094197,-0.10662481706667659,-0.1350795088877708,74.4045747733923,0.9731535157540746,68.70761136073159,8.610556872392262,22.68183176687615,4463558808
1266503400,4.180792,4.302457,4.179124,4.278291,3.506382893617021,4.784341756756757,4.862452,3.707464,4.862452,2.454976,3.10997,1.216655,NaN,NaN,3.796592100000002,4.334420849999998,4.304933699999998,4.042459550000002,4.227910016581567,4.110833471429672,3.994536846153844,4.369421341481997,3.619652350825691,3.796592100000002,4.334420849999998,4.304933699999998,4.042459550000002,4.253290666666667,51902628,92036733.2,54.40782426424473,NaN,1.5,2.75,NaN,NaN,0.184844333247103,0.5639338359306303,141.50628279517315,0.04489832540453628,-0.07895660213210043,-0.12385492753663671,74.45621761840133,13.333352759577458,100,0,0,4515461436
1266589800,4.244123,4.354123,4.216625,4.311624,3.4990602553191485,4.782427324324325,4.862452,3.707464,4.862452,2.454976,3.10997,1.216655,NaN,NaN,3.804429530000002,4.336329169999998,4.3069003599999975,4.037642950000001,4.231192917892094,4.12995637891256,4.0131905384615365,4.423521357682108,3.6028597192409655,3.804429530000002,4.336329169999998,4.3069003599999975,4.037642950000001,4.294124,51320672,87716144,55.45332704360913,NaN,1.5,2.75,NaN,NaN,0.18146245230088143,0.5850766992219814,143.84452814251117,0.05610762788040817,-0.053720392686126495,-0.10982802056653466,38.44255222084289,13.664347223192502,100,0,0,4566782108
1266849000,4.357456,4.359957,4.274123,4.304123,3.4917376170212764,4.780512891891892,4.862452,3.707464,4.862452,2.454976,3.10997,1.216655,NaN,NaN,3.811578620000002,4.336045819999999,4.311383619999997,4.047059500000001,4.234052921112012,4.1465436761589824,4.019280153846152,4.4440954599283975,3.594464847763907,3.811578620000002,4.336045819999999,4.311383619999997,4.047059500000001,4.312734333333334,44558484,83030494.4,55.146859066212585,NaN,1.5,2.75,NaN,NaN,0.17463184856510414,0.5366520375675373,143.14704231004825,0.060714731747943895,-0.033934605881604796,-0.09464933762954869,39.14962132378347,16.09345363839001,81.31958954454117,3.0287132583822065,15.651697197076638,4522223624
1266935400,4.270791,4.30579,4.11246,4.148292,3.484414978723404,4.7785984594594595,4.862452,3.707464,4.862452,2.454976,3.10997,1.216655,NaN,NaN,3.818536885000002,4.334429169999999,4.311900279999998,4.045642850000002,4.23068974773507,4.14671018319146,4.018254538461536,4.441752597891194,3.594756479031877,3.818536885000002,4.334429169999999,4.311900279999998,4.045642850000002,4.188847333333333,72424804,83090422.4,49.07853879102511,NaN,1.5,2.75,NaN,NaN,0.17596743081045388,0.8716384140081107,139.256169800072,0.0513377382069478,-0.030477164870863938,-0.08181490307781174,44.26897193000486,7.795610210654371,48.38140210313073,20.33583924270953,31.28275865415972,4449798820
1267021800,4.179958,4.273291,4.149124,4.25079,3.4770923404255316,4.776684027027027,4.862452,3.707464,4.862452,2.454976,3.10997,1.216655,NaN,NaN,3.8250284850000025,4.334395829999999,4.312966919999997,4.052101050000001,4.23147799292193,4.156622546697035,4.054856692307689,4.47008772069801,3.639625663917369,3.8250284850000025,4.334395829999999,4.312966919999997,4.052101050000001,4.224401666666667,52687316,82298048.4,52.760657402821344,NaN,1.5,2.75,NaN,NaN,0.17232682860970724,0.6402012808848089,143.31818900238997,0.05005628500986002,-0.019244546815486707,-0.06930083182534673,42.06424428758575,11.157105619895576,45.34339203843149,22.676506114663216,31.98010184690529,4502486136
1267108200,4.074958,4.25079,4.039126,4.244624,3.4697697021276594,4.774769594594595,4.862452,3.707464,4.862452,2.454976,3.10997,1.216655,NaN,NaN,3.8323184100000027,4.337533289999999,4.312693559999997,4.055292650000001,4.231993522611266,4.165003637487794,4.089574307692305,4.4865950078311,3.6925536075535113,3.8323184100000027,4.337533289999999,4.312693559999997,4.055292650000001,4.17818,78348732,81354888,52.514648856193226,NaN,1.5,2.75,NaN,NaN,0.17513662656615672,0.9630488582320954,143.78551202193609,0.0468673645377807,-0.010716626153120856,-0.05758399069090155,41.468349501506644,7.41913115658516,16.876985112066563,53.23049886015493,29.892516027778505,4424137404
1267194600,4.257457,4.289957,4.174959,4.249958,3.462447063829787,4.772855162162163,4.862452,3.707464,4.862452,2.454976,3.10997,1.216655,NaN,NaN,3.8397516700000027,4.341224919999999,4.310726939999997,4.066167550000001,4.232698011920628,4.173094529155623,4.131304615384613,4.468423114556675,3.7941861162125505,3.8397516700000027,4.341224919999999,4.310726939999997,4.066167550000001,4.238291333333334,48749968,78894633.6,52.720025665973274,NaN,1.5,2.75,NaN,NaN,0.1708410103828598,0.6179123442940991,146.1083560536361,0.04327713194193562,-0.0034875757634820204,-0.046764707705417644,39.1442154749547,7.526907293179451,16.1482239731692,54.31532332658625,29.536452700244556,4472887372
1267453800,4.312457,4.403289,4.30579,4.385789,3.4551244255319147,4.77094072972973,4.862452,3.707464,4.862452,2.454976,3.10997,1.216655,NaN,NaN,3.8489265750000032,4.344599879999999,4.312560239999996,4.091208950000001,4.238701580080604,4.193351145426516,4.172650384615382,4.492170706556342,3.8531300626744227,3.8489265750000032,4.344599879999999,4.312560239999996,4.091208950000001,4.364955999999999,42188604,76013858.4,57.733291645788576,NaN,1.5,2.75,NaN,NaN,0.16959029535551262,0.5550120055476621,150.99565738317517,0.047852946944328255,0.013051475974992677,-0.03480147096933558,41.134629542859685,5.916670047662372,33.642031792751055,33.0677250392639,33.29024316798504,4515075976
1267540200,4.447456,4.493297,4.409123,4.429956,3.4478017872340425,4.769026297297297,4.862452,3.707464,4.862452,2.454976,3.10997,1.216655,NaN,NaN,3.8580764850000033,4.346641519999999,4.314693559999996,4.109250450000002,4.2462017534107765,4.215884941100181,4.219252538461536,4.495662743607233,3.9428423333158387,3.8580764850000033,4.346641519999999,4.314693559999996,4.109250450000002,4.444125333333333,44278820,74864831.2,59.24647777274451,NaN,1.5,2.75,NaN,NaN,0.16515584568726174,0.5914502081986929,154.4854922458042,0.05134836171313936,0.029383981172088625,-0.021964380541050738,34.15448596969728,5.421829531922413,64.49765081402604,10.068087401713177,25.43426178426078,4559354796
1267626600,4.471622,4.524955,4.414123,4.441622,3.44047914893617,4.767111864864865,4.862452,3.707464,4.862452,2.454976,3.10997,1.216655,NaN,NaN,3.867601390000003,4.348483169999999,4.320076819999996,4.1200836500000015,4.253865292492707,4.237383708614449,4.256957307692305,4.509673228214064,4.004241387170547,3.867601390000003,4.348483169999999,4.320076819999996,4.1200836500000015,4.460233333333334,53861312,74210890,59.65731283471744,NaN,1.5,2.75,NaN,NaN,0.16127557099531448,0.7257871722061277,155.960986513273,0.05179219593350408,0.042775864375829364,-0.009016331557674716,33.82780179943294,3.8176692515773105,65.04226788164463,9.781917402499106,25.175814715856248,4613216108
1267713000,4.463289,4.496623,4.407456,4.478289,3.4331565106382977,4.765197432432433,4.862452,3.707464,4.862452,2.454976,3.10997,1.216655,NaN,NaN,3.8761971400000035,4.349624829999999,4.324910119999996,4.135916850000002,4.262666222198875,4.260327069698787,4.29740569230769,4.506846352213485,4.087965032401894,3.8761971400000035,4.349624829999999,4.324910119999996,4.135916850000002,4.4607893333333335,36190596,72871262.6,60.98848212213514,NaN,1.5,2.75,NaN,NaN,0.15612495878136343,0.49663742206108014,158.24544487358514,0.05177755258389792,0.05570560917219769,0.003928056588299766,32.9721986772459,3.8654808489794115,100,0,0,4649406704
1267799400,4.570788,4.680787,4.531621,4.667452,3.425833872340425,4.763283,4.862452,3.707464,4.862452,2.454976,3.10997,1.216655,NaN,NaN,3.8857512050000036,4.351916469999999,4.3309600399999955,4.180541350000001,4.278540174269507,4.299100872584617,4.337917999999997,4.606035498249724,4.06980050175027,3.8857512050000036,4.351916469999999,4.3309600399999955,4.180541350000001,4.62662,40528196,69413423.2,67.03219703717716,NaN,1.5,2.75,NaN,NaN,0.15943731886840884,0.5838668391735505,163.47357392070452,0.06109023894988236,0.08029085527565272,0.019200616325770355,39.19953772747444,8.441417682533707,100,0,0,4689934900
1268058600,4.678287,4.705786,4.651621,4.673287,3.418511234042553,4.761368567567568,4.862452,3.707464,4.862452,2.454976,3.10997,1.216655,NaN,NaN,3.895571945000003,4.3536747899999995,4.336076679999995,4.2245409500000015,4.294020441945213,4.334737646624178,4.374161307692305,4.683298358186976,4.065024257197635,3.895571945000003,4.3536747899999995,4.336076679999995,4.2245409500000015,4.6768979999999996,27538352,63341939,67.2009926570058,NaN,1.5,2.75,NaN,NaN,0.15191786752066536,0.434757009885662,165.73034667306882,0.06392212678918781,0.09910327481225512,0.03518114802306731,38.96701724207523,12.655690583015868,100,0,0,4717473252
1268145000,4.627454,4.765786,4.62662,4.69912,3.4111885957446804,4.759454135135136,4.862452,3.707464,4.862452,2.454976,3.10997,1.216655,NaN,NaN,3.9061510050000035,4.356016439999999,4.340926639999995,4.274123750000001,4.3099066991238315,4.369440727898065,4.4065327692307665,4.754437602807337,4.058627935654196,3.9061510050000035,4.356016439999999,4.340926639999995,4.274123750000001,4.697175333333334,43672012,60782091.4,67.98257762653199,NaN,1.5,2.75,NaN,NaN,0.15100701984061787,0.7185013051393622,167.53914161181527,0.06367405760984891,0.11477372003537845,0.05109966242552953,26.700879719851763,10.546980678885557,100,0,0,4761145264
1268231400,4.711619,4.801619,4.697453,4.764952,3.403865957446808,4.7575397027027035,4.862452,3.707464,4.862452,2.454976,3.10997,1.216655,NaN,NaN,3.9171592300000033,4.35674976,4.345693239999995,4.319956650000001,4.327751612883681,4.40710846809825,4.441404153846151,4.832466320239048,4.050341987453255,3.9171592300000033,4.35674976,4.345693239999995,4.319956650000001,4.754674666666666,48394752,56200661.4,69.94791450426247,NaN,1.5,2.75,NaN,NaN,0.1476612327091451,0.8611064495408234,170.733237288374,0.06391605191401607,0.13099472731804962,0.06707867540403355,25.644473083571196,12.258518068973839,100,0,0,4809540016
1268317800,4.739953,4.827451,4.689953,4.818286,3.396543319148936,4.75562527027027,4.862452,3.707464,4.862452,2.454976,3.10997,1.216655,NaN,NaN,3.927367460000003,4.357583089999999,4.351243179999995,4.369664550000001,4.346988255515694,4.446268233041274,4.480955153846152,4.910580897378533,4.0513294103137705,3.927367460000003,4.357583089999999,4.351243179999995,4.369664550000001,4.7785633333333335,38848780,53602697.8,71.47554988988131,NaN,1.5,2.75,NaN,NaN,0.14693528751563473,0.7247541932488332,172.32033146470013,0.0635092520006424,0.14646524040483655,0.08295598840419414,24.319423495613577,13.37255568172672,100,0,0,4848388796
1268404200,4.889118,4.894952,4.788286,4.830868,3.3892206808510634,4.753710837837838,4.862452,3.707464,4.862452,2.454976,3.10997,1.216655,NaN,NaN,3.938438600000003,4.35955889,4.357428119999995,4.4136349500000005,4.36596393176998,4.482896782275438,4.533460999999997,4.954381019417537,4.112540980582458,3.938438600000003,4.35955889,4.357428119999995,4.4136349500000005,4.838035333333333,48933896,51796552.6,71.83923022922431,NaN,1.5,2.75,NaN,NaN,0.14405890983594652,0.944732680915911,173.9778153250296,0.059971677696803755,0.15792058552519883,0.09794890782839508,24.09902108954616,10.148208224335457,100,0,0,4897322692
1268659800,4.804118,4.839952,4.721619,4.821618,3.3818980425531913,4.751796405405406,4.862452,3.707464,4.862452,2.454976,3.10997,1.216655,NaN,NaN,3.948938495000003,4.36026722,4.363711379999995,4.45709285,4.383832718759392,4.515155945868254,4.577370846153844,4.990196380797044,4.164545311510644,3.948938495000003,4.36026722,4.363711379999995,4.45709285,4.794396333333334,45922116,49618299.2,71.12130536114945,NaN,1.5,2.75,NaN,NaN,0.14222134484766466,0.9255076602867516,172.00046611209075,0.05312728532781123,0.16435801448815912,0.11123072916034789,22.188731192597324,8.8412164816084,76.3490722145565,4.71495676145887,18.93597102398463,4851400576
1268746200,4.870785,4.961616,4.832453,4.950784,3.374575404255319,4.7498819729729735,4.862452,3.707464,4.862452,3.707464,3.10997,2.454976,NaN,1.216655,3.9593883900000026,4.36307554,4.375211279999995,4.497592450000001,4.406066102337455,4.556644331976039,4.631690846153844,5.040907473123996,4.222474219183692,3.9593883900000026,4.36307554,4.375211279999995,4.497592450000001,4.914950999999999,46968684,49251641,74.89425948019361,NaN,1.5,2.75,NaN,NaN,0.1420625345014029,0.9536470876168369,175.52129363060033,0.05328133574227477,0.17783239883819135,0.12455106309591658,24.236608072113142,11.463424847949689,77.01854322475012,4.467811865782351,18.51364490946753,4898369260
1268832600,4.999118,5.089941,4.98995,5.043283,3.3672527659574465,4.747967540540541,4.862452,3.707464,4.862452,3.707464,3.10997,2.454976,NaN,1.216655,3.9692091250000026,4.368075489999999,4.384077859999995,4.539650400000001,4.4310550002850055,4.602990871787845,4.692715846153844,5.0925291804693975,4.29290251183829,3.9692091250000026,4.368075489999999,4.384077859999995,4.539650400000001,5.041058,37956580,47763765.2,77.19230618033855,NaN,1.5,2.75,NaN,NaN,0.14185499632273127,0.7946731134169464,178.99349462928703,0.055352357712693645,0.19374151023678365,0.13838915252409,23.914201008361246,12.616291623876876,76.04648390611911,4.828637128948468,19.124878964932428,4936325840
1268919000,5.045783,5.064949,4.97245,5.014117,3.3599301276595743,4.746053108108109,4.862452,3.707464,4.862452,3.707464,3.10997,2.454976,NaN,1.216655,3.978746530000003,4.371500459999998,4.391494459999995,4.576441700000001,4.453920176744417,4.642145741141383,4.741048769230767,5.13259028540117,4.349507253060365,3.978746530000003,4.371500459999998,4.391494459999995,4.576441700000001,5.0171719999999995,39699864,47153627,74.86533448522198,NaN,1.5,2.75,NaN,NaN,0.13832956801396476,0.8419259880051221,176.84261977791547,0.05062579863435088,0.2016714008170286,0.15104560218267774,26.121847187965102,7.427285808188275,50.24725608310149,18.95319985194907,30.79954406494944,4896625976
1269005400,5.057449,5.070783,4.886618,4.930784,3.3526074893617017,4.744138675675676,4.862452,3.707464,4.862452,3.707464,3.10997,2.454976,NaN,1.216655,3.988504765000003,4.375733749999998,4.396994399999995,4.607399700000001,4.4726207188328715,4.669635099127918,4.779573999999998,5.1382753751889725,4.420872624811024,3.988504765000003,4.375733749999998,4.396994399999995,4.607399700000001,4.962728333333334,44769876,46826087.2,68.51056953962089,NaN,1.5,2.75,NaN,NaN,0.14160352744153865,0.9560883404325954,173.14468808639106,0.03831422365118306,0.19893838174665657,0.1606241580954735,22.723685148186522,5.509976168807947,21.81415688387851,46.425000495371215,31.760842620750257,4851856100
1269264600,4.853286,5.055783,4.845784,5.02495,3.3452848510638296,4.7422242432432435,4.862452,3.707464,4.862452,3.707464,3.10997,2.454976,NaN,1.216655,3.998383835000003,4.382392019999998,4.4032843399999955,4.643441050000002,4.494280690643347,4.703474613496687,4.824445384615382,5.146930824169851,4.501959945060913,3.998383835000003,4.382392019999998,4.4032843399999955,4.643441050000002,4.975505666666667,43570584,46776692.2,71.45874653884381,NaN,1.5,2.75,NaN,NaN,0.14648891833857158,0.9314592792005929,176.03348242717803,0.03313414639367768,0.20204184108757062,0.16890769469389294,23.753664483604528,6.93385144452578,48.3209572132212,20.334731465692276,31.344311321086526,4895426684
1269351000,4.937451,5.029117,4.88745,5.019951,3.337962212765957,4.740309810810811,4.862452,3.707464,4.862452,3.707464,3.10997,2.454976,NaN,1.216655,4.008196245000003,4.389658629999999,4.408467639999995,4.687024000000002,4.514895212578902,4.733615221735098,4.8661116923076895,5.134336017674332,4.597887366941047,4.008196245000003,4.389658629999999,4.408467639999995,4.687024000000002,4.978839333333333,47030676,45506985.8,71.07829491136114,NaN,1.5,2.75,NaN,NaN,0.14614449560010218,1.0334825559903378,179.8627018448028,0.026291503905600117,0.20177207457589308,0.17548057067029296,24.216289809216896,5.3515544332870455,19.573335977719445,49.349273012061,31.077391010219547,4848396008
1269437400,4.959116,5.008359,4.918284,4.940783,3.330639574468085,4.738395378378379,5.043283,3.707464,4.862452,3.707464,3.10997,2.454976,NaN,1.216655,4.017766975000003,4.3987335399999985,4.411700899999995,4.721523650000002,4.531596694438553,4.753345486331756,4.887137153846151,5.131571923343009,4.642702384349293,4.017766975000003,4.3987335399999985,4.411700899999995,4.721523650000002,4.955808666666666,52600316,45502635.8,65.1615021276528,NaN,1.5,2.75,NaN,NaN,0.1429675316286663,1.1559839353306212,176.73448921045164,0.013972284403078322,0.19294592617414086,0.17897364177106254,26.819763852382913,2.5423355940265915,4.4598550022902845,77.00897698252656,18.531168015183145,4795795692
1269523800,5.042449,5.098282,4.895784,4.909951,3.3233169361702126,4.736480945945947,5.043283,3.707464,4.862452,3.707464,3.10997,2.454976,NaN,1.216655,4.026946050000003,4.404958479999998,4.417117519999995,4.754790000000002,4.546434118186061,4.768260297157303,4.905342076923075,5.116319503431894,4.694364650414256,4.026946050000003,4.404958479999998,4.417117519999995,4.754790000000002,4.9680056666666665,56379236,44404161,62.9632710270758,NaN,1.5,2.75,NaN,NaN,0.14721970794090447,1.2696836226677044,174.25397692939546,0.0019190913055315284,0.18137250590297693,0.1794534145974454,26.895070692121408,1.637035000749362,3.8711889503402044,78.67782018254763,17.450990867112157,4739416456
1269610200,4.937451,5.007117,4.841619,4.914618,3.31599429787234,4.734566513513514,5.043283,3.707464,4.862452,3.707464,3.10997,2.454976,NaN,1.216655,4.036273460000003,4.414863389999998,4.420244139999995,4.788023000000002,4.560872701786607,4.7821991259994645,4.921918846153845,5.096141099643409,4.74769659266428,4.036273460000003,4.414863389999998,4.420244139999995,4.788023000000002,4.921118,63374132,45135369.2,63.165831136249054,NaN,1.5,2.75,NaN,NaN,0.1485253002308399,1.4040902539022544,174.77101342005474,-0.0070744240454477525,0.1706103845406357,0.17768480858608346,26.895581309761685,1.928813107965002,22.01452164801045,46.12269495826984,31.862783393719727,4802790588
1269869400,4.980784,5.02495,4.954117,4.998283,3.308671659574468,4.732652081081081,5.043283,3.707464,4.862452,3.707464,3.10997,2.454976,NaN,1.216655,4.045806690000004,4.424796619999999,4.424277419999995,4.818647700000001,4.578026046814584,4.802778542570944,4.939867384615383,5.0924386512005695,4.787296118030196,4.045806690000004,4.424796619999999,4.424277419999995,4.818647700000001,4.992450000000001,34342132,44743045.6,66.6836202490585,NaN,1.5,2.75,NaN,NaN,0.14579720735720844,0.7675412243282786,178.28628621987312,-0.008621145875232966,0.16690837624204224,0.1755295221172752,28.0990463980108,0.9594238003516248,19.89877861283638,48.919879673130424,31.181341714033206,4837132720
1269955800,5.017451,5.066616,4.947451,5.010783,3.3013490212765957,4.730737648648649,5.043283,3.707464,4.862452,3.707464,3.10997,2.454976,NaN,1.216655,4.055310755000003,4.434396519999998,4.431793999999996,4.847689050000001,4.594996907723815,4.8225884908975205,4.954674846153845,5.093958807907348,4.815390884400341,4.055310755000003,4.434396519999998,4.431793999999996,4.847689050000001,5.008283333333334,38172920,44437750.6,67.18782259003476,NaN,1.5,2.75,NaN,NaN,0.1438949068316935,0.8590200783025232,179.04138584151022,-0.009941214790400804,0.1631030036292742,0.17304421841967502,24.056372153919614,-0.6444215008358594,41.87377061725142,25.481071351768698,32.645158030979886,4875305640
1270042200,4.951617,5.03245,4.914543,4.95995,3.294026382978723,4.728823216216217,5.043283,3.707464,4.862452,3.707464,3.10997,2.454976,NaN,1.216655,4.065681485000003,4.443338099999998,4.434960619999996,4.873605450000002,4.609308793695431,4.835670539383471,4.96460423076923,5.084177907798284,4.845030553740176,4.065681485000003,4.443338099999998,4.434960619999996,4.873605450000002,4.968980999999999,41521408,43820755.4,63.011560907341256,NaN,1.5,2.75,NaN,NaN,0.14203862777228682,0.9475283486327121,176.5635268975353,-0.015069127918994785,0.15420780852093152,0.1692769364399263,22.062357539611625,-1.0802899094695964,45.587167798457365,22.444706698573523,31.9681255029691,4833784232
1270128600,5.055783,5.117449,4.975784,5.068283,3.286703744680851,4.726908783783784,5.043283,3.707464,4.862452,3.707464,3.10997,2.454976,NaN,1.216655,4.077148040000003,4.450979699999999,4.443127219999996,4.903105150000002,4.6273077821779625,4.857824107061235,4.98357846153846,5.082948794738962,4.884208128337959,4.077148040000003,4.450979699999999,4.443127219999996,4.903105150000002,5.053838666666667,49807012,44501576.2,67.62948191010659,NaN,1.5,2.75,NaN,NaN,0.1431429400742663,1.1192190536388236,180.36657276824693,-0.012122962480786592,0.15412323333894307,0.16624619581972966,25.510470797796838,2.788582910952904,79.04452574612311,3.749713969183406,17.205760284693476,4883591244
1270474200,5.128281,5.210781,5.085782,5.204949,3.2793811063829783,4.724994351351352,5.043283,3.707464,4.862452,3.707464,3.10997,2.454976,NaN,1.216655,4.089335420000003,4.4596462899999985,4.459067079999995,4.929980000000002,4.6499603789552975,4.890883620674451,5.003129615384614,5.155093401268039,4.851165829501189,4.089335420000003,4.4596462899999985,4.459067079999995,4.929980000000002,5.167170666666667,27762828,43863307.8,72.32378925846307,NaN,1.5,2.75,NaN,NaN,0.14309687292610443,0.6329396799390492,184.60630255232223,-0.0024347873257179187,0.16320271166258227,0.16563749898830019,26.533261069287825,3.582105294580055,74.9561086108222,5.241222344922148,19.80266904425566,4911354072
1270560600,5.161615,5.272447,5.142489,5.244948,3.272058468085106,4.72307991891892,5.043283,3.707464,4.862452,3.707464,3.10997,2.454976,NaN,1.216655,4.101493640000004,4.465737899999999,4.481650199999995,4.958563050000001,4.673293226839403,4.924604037753075,5.018642307692305,5.2177075806849125,4.819577034699698,4.101493640000004,4.465737899999999,4.481650199999995,4.958563050000001,5.219961333333334,35388676,44255824,73.53352711644936,NaN,1.5,2.75,NaN,NaN,0.14215838200281122,0.7996388452737881,186.64841243329275,0.004807766019426368,0.17164720651258314,0.16683944049315677,25.19204983094239,4.482055701340514,75.36658970300975,5.081498114920003,19.55191218207025,4946742748
1270647000,5.215781,5.247448,5.083283,5.154116,3.2647358297872335,4.721165486486487,5.043283,3.707464,4.862452,3.707464,3.10997,2.454976,NaN,1.216655,4.113051860000003,4.470929519999999,4.501200019999995,4.981312850000002,4.692149021865309,4.94646231987183,5.0294114615384595,5.241080772995473,4.817742150081446,4.113051860000003,4.470929519999999,4.501200019999995,4.981312850000002,5.161615666666667,63939396,45269193.2,66.4322267993751,NaN,1.5,2.75,NaN,NaN,0.14373028328832474,1.412426232504625,183.76967508631728,0.0017774977333760156,0.16906131265987678,0.16728381492650077,28.05884119485693,4.31779740174787,37.03171538666421,29.786459066475093,33.18182554686069,4882803352
1270733400,5.097449,5.225782,5.049125,5.202447,3.2574131914893614,4.719251054054054,5.043283,3.707464,4.862452,3.707464,3.10997,2.454976,NaN,1.216655,4.126080890000003,4.4758869599999995,4.522816439999995,5.003187600000002,4.712160707282356,4.97084181321737,5.050308615384614,5.272292401685863,4.828324829083364,4.126080890000003,4.4758869599999995,4.522816439999995,5.003187600000002,5.159117999999999,44216828,45060297,68.19239833347487,NaN,1.5,2.75,NaN,NaN,0.14608219162487293,0.9812813262193989,184.8787287369582,0.001344281810327197,0.16896416718940976,0.16761988537908257,25.593948680311495,5.957208126924278,64.43721209707823,10.088926758366455,25.473861144555336,4927020180
1270819800,5.237448,5.309947,5.204115,5.299948,3.250090553191489,4.717336621621622,5.043283,3.707464,4.862452,3.707464,3.10997,2.454976,NaN,1.216655,4.139622420000004,4.483245229999999,4.545199559999995,5.0272707000000025,4.735211189349715,5.002185259577621,5.071462307692306,5.329269119314897,4.813655496069715,4.139622420000004,4.483245229999999,4.545199559999995,5.0272707000000025,5.271336666666667,35546848,44895200.4,71.44534774148744,NaN,1.5,2.75,NaN,NaN,0.14332632079452484,0.791773901960353,188.21682057854332,0.005696408529432956,0.17474039604087377,0.1690439875114408,25.50602763316237,7.840487297283324,61.971117618927344,11.434011163059296,26.594871218013374,4962567028
1271079000,5.324113,5.37078,5.30578,5.336612,3.2427679148936166,4.71542218918919,5.043283,3.707464,4.862452,3.707464,3.10997,2.454976,NaN,1.216655,4.153041445000003,4.490220149999999,4.571282599999995,5.052557900000003,4.7587955348654125,5.034035425332133,5.095820846153844,5.387208343773656,4.804433348534031,4.153041445000003,4.490220149999999,4.571282599999995,5.052557900000003,5.337724000000001,32091308,44053071,72.58091986658832,NaN,1.5,2.75,NaN,NaN,0.13814815502348737,0.7284692592713911,189.99414398880745,0.008924291154006225,0.1801993514539486,0.17127506029994238,25.161896652977017,6.768904441785307,64.94471118580132,9.930131049471845,25.12515776472685,4994658336
1271165400,5.320781,5.37078,5.234948,5.344947,3.2354452765957444,4.713507756756758,5.043283,3.707464,4.862452,3.707464,3.10997,2.454976,NaN,1.216655,4.165632990000003,4.495178439999999,4.600482319999995,5.078724350000003,4.781781866831475,5.063646051490978,5.126910384615384,5.431444593539856,4.822376175690911,4.165632990000003,4.495178439999999,4.600482319999995,5.078724350000003,5.316891666666667,31627984,43338364.4,72.84530270261082,NaN,1.5,2.75,NaN,NaN,0.13798271537895254,0.7297918238926433,189.13119506154476,0.00945007755632124,0.18308765724534393,0.1736375796890227,24.770207612873747,6.66889785488616,64.31017726409375,10.267071205820335,25.422751530085918,5026286320
1271251800,5.406613,5.528278,5.38078,5.524945,3.228122638297872,4.711593324324325,5.043283,3.707464,4.862452,3.707464,3.10997,2.454976,NaN,1.216655,4.1792203550000036,4.501803369999999,4.6295986999999945,5.107432400000003,4.810925519112593,5.107579284682314,5.174217615384614,5.517807281974586,4.830627948794642,4.1792203550000036,4.501803369999999,4.6295986999999945,5.107432400000003,5.478001,30341400,42507000.2,77.8192704177821,NaN,1.5,2.75,NaN,NaN,0.14122187856617022,0.7137977240746337,193.08706869074638,0.01918827278842461,0.19762292067455345,0.17843464788612884,28.767469423819072,11.391143055877572,100,0,0,5056627720
1271338200,5.499945,5.577443,5.494111,5.545778,3.2207999999999997,4.709678891891892,5.043283,3.707464,4.862452,3.707464,3.10997,2.454976,NaN,1.216655,4.1925118950000035,4.508803309999999,4.656015099999995,5.132557150000003,4.839743263461119,5.14931249566495,5.2227683846153825,5.583833858034125,4.86170291119664,4.1925118950000035,4.508803309999999,4.656015099999995,5.132557150000003,5.539110666666666,29304928,42074417.6,78.31437701897758,NaN,1.5,2.75,NaN,NaN,0.13708688724001517,0.696502285036977,192.0777661648479,0.023988862698738067,0.20842072625955144,0.18443186356081337,26.232220755239908,9.4212379221918,100,0,0,5085932648
1271424600,5.491611,5.515778,5.200781,5.286197,3.2134773617021275,4.70776445945946,5.043283,3.707464,4.862452,3.707464,3.10997,2.454976,NaN,1.216655,4.2047930150000035,4.515240739999999,4.678506539999995,5.146161150000003,4.85725125312931,5.162349115125431,5.244915615384613,5.582759412177918,4.907071818591309,4.2047930150000035,4.515240739999999,4.678506539999995,5.146161150000003,5.334251999999999,90876068,44633227.8,60.26398921310344,NaN,1.5,2.75,NaN,NaN,0.1519376095800141,2.0360630964718176,187.36281449693345,0.007492960542663019,0.19379806423914214,0.18630510369647912,41.794263444774465,1.5609759096582798,47.92523557141046,20.821411166598796,31.25335326199073,4995056580
1271683800,5.238281,5.342437,5.154948,5.329948,3.206154723404255,4.705850027027028,5.043283,3.707464,4.862452,3.707464,3.10997,2.454976,NaN,1.216655,4.217130395000003,4.527890629999999,4.709606259999996,5.166119350000003,4.875788380457572,5.178310913684913,5.269466769230767,5.581051530723617,4.957882007737917,4.217130395000003,4.527890629999999,4.709606259999996,5.166119350000003,5.2757776666666665,56596740,45224571,61.85961088089198,NaN,1.5,2.75,NaN,NaN,0.1544769946100131,1.2514599640978352,185.36281449693345,-0.002145566181412484,0.18362314596971352,0.185768712151126,39.46231009787155,1.6206071061143021,52.39972532482681,17.439716373521847,30.160558301651342,5051653320
1271770200,5.431612,5.487446,5.377446,5.475779,3.1988320851063827,4.703935594594595,5.043283,3.707464,4.862452,3.707464,3.10997,2.454976,NaN,1.216655,4.231376090000003,4.540615509999999,4.743255939999995,5.188660800000003,4.899317424361197,5.2066412076196835,5.309145923076921,5.581922475511001,5.0363693706428405,4.231376090000003,4.540615509999999,4.743255939999995,5.188660800000003,5.446890333333333,36076932,44849888.4,66.66465295085592,NaN,1.5,2.75,NaN,NaN,0.1546927807092979,0.8043929045763245,189.86281449693345,-0.0004613580345235735,0.18519201460797152,0.1856533726424951,41.88892051521298,6.240895625942452,53.58633259220922,16.62999525291143,29.783672154879348,5087730252
1271856600,5.486612,5.524945,5.36828,5.460779,3.19150944680851,4.702021162162163,5.043283,3.707464,4.862452,3.707464,3.10997,2.454976,NaN,1.216655,4.245588450000003,4.55307789,4.778322239999995,5.210702200000003,4.92133552536664,5.230844806893999,5.339337923076921,5.584255684869558,5.094420161284284,4.245588450000003,4.55307789,4.778322239999995,5.210702200000003,5.451334666666667,44741244,44735416.8,65.74713411155315,NaN,1.5,2.75,NaN,NaN,0.15483365351577658,1.0001302592088512,191.83236289164756,-0.0020313751635983035,0.18311415368799722,0.18514552885159552,39.89757372302754,4.965586386560004,31.6419488083047,35.10553195380016,33.252519237895136,5042989008
1271943000,5.339947,5.535777,5.249948,5.512453,3.184186808510638,4.700106729729731,5.545778,3.707464,4.862452,3.707464,3.10997,2.454976,NaN,1.216655,4.260834170000004,4.56551118,4.811605419999995,5.239285700000003,4.944516602803242,5.257664634808856,5.362992076923074,5.610804045295451,5.115180108550698,4.260834170000004,4.56551118,4.811605419999995,5.239285700000003,5.432726,59306512,45070726.6,67.41113702067501,NaN,1.5,2.75,NaN,NaN,0.1641904639789354,1.3158543576708168,195.1396686841225,-0.0012991659263084654,0.18352157144370995,0.18482073737001842,39.90035989189306,4.00956764104101,39.16065575172796,27.87532734036429,32.964016907907755,5102295520
1272029400,5.508279,5.636777,5.465779,5.623277,3.176864170212766,4.6981922972972985,5.545778,3.707464,4.862452,3.707464,3.10997,2.454976,NaN,1.216655,4.276634010000004,4.58111103,4.847588399999995,5.2749520000000025,4.971134657595272,5.292484860065156,5.392094307692306,5.665189741641555,5.118998873743056,4.276634010000004,4.58111103,4.847588399999995,5.2749520000000025,5.5752776666666675,49660756,44734802.6,70.69881161356112,NaN,1.5,2.75,NaN,NaN,0.16467671655186858,1.1101145665947345,198.44685782295326,0.004615426454499666,0.190590020438143,0.18597459398364333,40.0636839778621,5.371666518008058,79.53675220436547,3.5942041760279553,16.869043619606582,5151956276
1272288600,5.639943,5.674944,5.550778,5.567027,3.169541531914893,5.674944,5.545778,3.707464,4.862452,3.707464,3.10997,2.454976,NaN,1.216655,4.292115105000004,4.59577337,4.8798997399999955,5.307572450000002,4.994502984748398,5.318631730535141,5.42385669230769,5.673928288858493,5.173785095756887,4.292115105000004,4.59577337,4.8798997399999955,5.307572450000002,5.597583,42440212,43688106.6,67.00398842111477,NaN,1.5,2.75,NaN,NaN,0.1617830939410208,0.9714362855908248,196.9239826027956,0.002795391629050792,0.1894688335199568,0.186673441890906,41.078228458310946,4.154952331613392,54.19784608279037,16.35568340973158,29.446470507478036,5109516064
1272375000,5.474945,5.562435,5.144949,5.171615,3.162218893617021,5.686622152777778,5.545778,3.707464,4.862452,3.707464,3.10997,2.454976,NaN,1.216655,4.305698300000004,4.605014939999999,4.904282839999995,5.316239050000002,5.001448553973951,5.304630137150841,5.421484999999998,5.6803415724209785,5.162628427579017,4.305698300000004,4.605014939999999,4.904282839999995,5.316239050000002,5.292999666666667,91018328,46521916.4,48.00971526349543,NaN,1.5,2.75,NaN,NaN,0.18037558723094788,1.9564612776785781,191.67857644938044,-0.025428046210334593,0.15488838412798778,0.18031643033832237,60.77305436392423,-6.395176784565271,22.199287479681367,46.14567107484989,31.655041445468736,5018497736
1272461400,5.258282,5.32328,5.145782,5.280781,3.1548962553191484,5.698300305555556,5.545778,3.707464,4.862452,3.707464,3.10997,2.454976,NaN,1.216655,4.318960675000005,4.615164839999999,4.927082619999995,5.329738950000002,5.0124027675436,5.302358790755523,5.420010615384613,5.68182086390299,5.158200366866236,4.318960675000005,4.615164839999999,4.927082619999995,5.329738950000002,5.2499476666666665,89235100,49075025.4,52.05103744911914,NaN,1.5,2.75,NaN,NaN,0.18017004528588015,1.8183403731870509,194.0146943420628,-0.03646216145670894,0.13473872851743618,0.17120088997414512,58.457762272707214,-4.77835571492404,51.029557180322726,18.545181015051657,30.425261804625627,5107732836
1272547800,5.38328,5.516612,5.374946,5.479944,3.1475736170212762,5.7099784583333335,5.545778,3.707464,4.862452,3.707464,3.10997,2.454976,NaN,1.216655,4.332956360000005,4.628348029999999,4.952639019999995,5.355738650000002,5.030737717836008,5.319271667826426,5.431036153846152,5.689925104978421,5.172147202713882,4.332956360000005,4.628348029999999,4.952639019999995,5.355738650000002,5.4571673333333335,42994364,49148673.2,58.40377791042149,NaN,1.5,2.75,NaN,NaN,0.18414582776546015,0.8747817835294076,198.27740846657514,-0.030317412827980172,0.1333041239391699,0.16362153676715008,63.1011263531254,3.6651490665217383,47.95499343985998,20.805100768787753,31.239905791352275,5150727200
1272634200,5.487446,5.504112,5.201615,5.209615,3.1402509787234036,5.721656611111111,5.623277,3.707464,4.862452,3.707464,3.10997,2.454976,NaN,1.216655,4.344433745000005,4.6380995999999985,4.971265499999995,5.362805250000003,5.037752513214988,5.30882817565248,5.420625999999998,5.702397045807378,5.138854954192618,4.344433745000005,4.6380995999999985,4.971265499999995,5.362805250000003,5.305114,66908588,50003752,48.92812520953032,NaN,1.5,2.75,NaN,NaN,0.19259948292507012,1.3380713511258115,193.54058463620103,-0.04362018611373361,0.10909630412498306,0.15271649023871667,63.831996169425636,-2.257676810355365,23.589706878816646,44.401571542970835,32.00872157821253,5083818612
1272893400,5.275781,5.44578,5.254947,5.406613,3.1329283404255315,5.733334763888889,5.623277,3.707464,4.862452,3.707464,3.10997,2.454976,NaN,1.216655,4.356483620000005,4.650032819999998,4.993165279999995,5.372888450000002,5.052217630343812,5.31814101606653,5.4115235384615366,5.6867969942548235,5.13625008266825,4.356483620000005,4.650032819999998,4.993165279999995,5.372888450000002,5.369113333333334,40947252,50662973.2,54.696504026239545,NaN,1.5,2.75,NaN,NaN,0.19571130557327937,0.8082283650893193,198.60309708142668,-0.038491799410420385,0.1046017409756912,0.14309354038611158,67.47519625289884,-1.263126214553218,37.113422388275126,29.696832771240548,33.189744840484316,5124765864
1272979800,5.22078,5.225782,4.940783,5.021616,3.1256057021276593,5.745012916666667,5.623277,3.707464,4.862452,3.707464,3.10997,2.454976,NaN,1.216655,4.366616850000005,4.659449379999999,5.007515139999994,5.361721850000002,5.051017566408761,5.289900538345909,5.371203384615383,5.703625558681423,5.038781210549343,4.366616850000005,4.659449379999999,5.007515139999994,5.361721850000002,5.062727,67262880,52256683.4,44.19160349228473,NaN,1.5,2.75,NaN,NaN,0.21500549803233088,1.2871632033195586,192.53503078552743,-0.05913378785872486,0.06917630556270549,0.12831009342143035,77.54065311870993,-8.0421309853411,43.276635039193295,24.302008933240103,32.421356027566596,5057502984
1273066200,4.880785,5.051608,4.808285,4.915785,3.1182830638297867,5.756691069444445,5.623277,3.707464,4.862452,3.707464,3.10997,2.454976,NaN,1.216655,4.375736760000006,4.667382639999999,5.022864999999995,5.349805300000002,5.045714328510378,5.254270487074869,5.342710153846151,5.753624786908203,4.9317955207840996,4.375736760000006,4.667382639999999,5.022864999999995,5.349805300000002,4.925225999999999,65966300,52358028.6,41.81423361926715,NaN,1.5,2.75,NaN,NaN,0.21702817674430724,1.259908017239595,187.04181327695457,-0.07689556125181611,0.03219064185666021,0.10908620310847632,77.75311671111062,-10.824001583324161,12.101099488343529,60.78489929325517,27.114001218401288,4991536684
1273152600,4.845784,4.942451,3.466633,4.421631,3.1109604255319145,5.768369222222222,5.623277,3.707464,4.862452,3.707464,3.10997,2.454976,NaN,1.216655,4.382182570000006,4.669624369999999,5.026281819999995,5.310764500000002,5.021240472490363,5.174971488305834,5.272839615384613,5.913398158461868,4.632281072307358,4.382182570000006,4.669624369999999,5.026281819999995,5.310764500000002,4.276905,129265388,56610456.6,32.91125166880647,NaN,1.5,2.75,NaN,NaN,0.30694173554828535,2.2834189258243853,173.96256763102122,-0.11652757626433402,-0.03657326722194121,0.07995430904239281,93.48110480019817,-21.369141160928056,1.6474149777779834,86.42366338698285,11.928921635239167,4862271296
1273239000,4.374956,4.522455,4.02246,4.202457,3.1036377872340424,5.780047375,5.623277,3.707464,4.862452,3.707464,3.10997,2.454976,NaN,1.216655,4.387499180000005,4.669066019999999,5.025438479999995,5.255889950000002,4.989131316706427,5.0823510608481355,5.174891769230767,6.018572342257587,4.331211196203946,4.387499180000005,4.669066019999999,5.025438479999995,5.255889950000002,4.249123999999999,100555520,59860890.2,29.87314066714741,NaN,1.5,2.75,NaN,NaN,0.32073125443769357,1.679819990381633,168.86563488629568,-0.14997568819717091,-0.10751530120407082,0.042460386993100084,90.642603308942,-24.511646880821672,1.5137129123297166,87.01276918358143,11.473517904088858,4761715776
1273498200,4.737453,4.822452,4.63162,4.768286,3.0963151489361698,5.7917255277777775,5.623277,3.707464,4.862452,3.707464,3.10997,2.454976,NaN,1.216655,4.3945824450000055,4.673265989999999,5.035805039999996,5.227473650000002,4.980470716051273,5.052440102672122,5.121623076923074,5.97377844404033,4.269467709805817,4.3945824450000055,4.673265989999999,5.035805039999996,5.227473650000002,4.740786,79031528,62207901.2,44.195362105997,NaN,1.5,2.75,NaN,NaN,0.34210723626357264,1.2704419611571784,179.99260769157942,-0.12735556170365012,-0.11673406513646256,0.010621496567187555,127.37250169638209,-7.79889840987777,3.7135970869854638,79.20008872125776,17.086314191756777,4840747304
1273584600,4.638287,4.921617,4.610787,4.739119,3.0889925106382976,5.803403680555555,5.623277,3.707464,4.862452,3.707464,3.10997,2.454976,NaN,1.216655,4.401311545000006,4.677715939999999,5.042871639999996,5.197182250000002,4.971005942872791,5.022599997655729,5.062135846153844,5.904770239637974,4.219501452669714,4.401311545000006,4.677715939999999,5.042871639999996,5.197182250000002,4.7571743333333325,73053308,64279167.4,43.699914397683045,NaN,1.5,2.75,NaN,NaN,0.33987314795903173,1.136500532830486,182.15878120547615,-0.1084597196098988,-0.12495315294518594,-0.016493433335287147,121.87415470497315,-10.25723278431733,3.6806063782938017,79.29857153790249,17.0208220838037,4767693996
1273671000,4.801619,4.965784,4.774952,4.945785,3.081669872340425,5.815081833333333,5.623277,3.707464,4.862452,3.707464,3.10997,2.454976,NaN,1.216655,4.408919810000006,4.683940889999999,5.0531882199999965,5.1682242500000015,4.970016886289544,5.015284283593279,5.010021076923075,5.788769012669034,4.231273141177116,4.408919810000006,4.683940889999999,5.0531882199999965,5.1682242500000015,4.895506999999999,45466172,65035406,48.13646272622422,NaN,1.5,2.75,NaN,NaN,0.3317868516762438,0.6990987647559239,188.25281557541211,-0.0775912253417489,-0.11348246501247328,-0.03589123967072437,124.42135271219921,-9.747526617060316,11.349424142422329,62.183163566056606,26.46741229152107,4813160168
1273757400,4.914951,4.984951,4.752452,4.772452,3.074347234042553,5.826759986111111,5.623277,3.707464,4.862452,3.707464,3.10997,2.454976,NaN,1.216655,4.415761405000006,4.689940819999999,5.059804819999996,5.1295579500000015,4.9622692436899545,4.992157399441538,4.9488999230769215,5.665424710622372,4.232375135531471,4.415761405000006,4.689940819999999,5.059804819999996,5.1295579500000015,4.836618333333334,50699100,66105114.6,44.937962110919045,NaN,1.5,2.75,NaN,NaN,0.3246948622707978,0.7669467076303956,184.86452404714606,-0.06491048445221291,-0.11702934523599051,-0.0521188607837776,122.08308358921722,-8.391464628384247,17.023563506153838,53.03919060404596,29.937245889800188,4762461068
1273843800,4.658286,4.687453,4.379123,4.506622,3.0670245957446802,5.838438138888889,5.623277,4.202457,4.862452,3.707464,3.10997,2.454976,NaN,1.216655,4.4215696800000055,4.692640799999999,5.060371479999996,5.090579200000001,4.944400724329564,4.945915932828059,4.897746615384613,5.637926722469385,4.157566508299841,4.4215696800000055,4.692640799999999,5.060371479999996,5.090579200000001,4.524399333333333,85414980,65832060.2,40.493999840970986,NaN,1.5,2.75,NaN,NaN,0.3295973006800265,1.297467825562597,177.96461856575183,-0.0700492187424495,-0.13968038421183948,-0.06963116546938998,122.88033795320257,-16.646114674751086,17.91814072380508,51.74509652856848,30.33676274762643,4677046088
1274103000,4.542454,4.58662,4.249958,4.514954,3.059701957446808,5.850116291666667,5.623277,4.202457,4.862452,3.707464,3.10997,2.454976,NaN,1.216655,4.4268779550000055,4.694140779999999,5.057321519999997,5.049829500000001,4.9275596763166405,4.904871939225386,4.8388368461538445,5.569540737619031,4.108132954688658,4.4268779550000055,4.694140779999999,5.057321519999997,5.049829500000001,4.450510666666666,70022992,66503372.8,40.69197032225408,NaN,1.5,2.75,NaN,NaN,0.3301019220600246,1.0529239202737097,175.1336306191821,-0.06843143922532455,-0.15517046450104566,-0.08673902527572111,119.07707253731876,-10.089620552427734,15.999003422092404,54.501440606676645,29.499555971230965,4747069080
1274189400,4.625786,4.66662,4.280791,4.331623,3.052379319148936,5.8617944444444445,5.623277,4.202457,4.862452,3.707464,3.10997,2.454976,NaN,1.216655,4.431219575000005,4.693282459999998,5.050488239999996,4.992621700000001,4.904189610578733,4.850276802156302,4.750504461538459,5.425344646845318,4.075664276231601,4.431219575000005,4.693282459999998,5.050488239999996,4.992621700000001,4.426344666666666,87262436,69062648,37.718488485837604,NaN,1.5,2.75,NaN,NaN,0.3340824276271657,1.2635257773492843,169.87973223076023,-0.07473913023274334,-0.1801629380666503,-0.10542380783390695,114.90393908639801,-11.883391970966999,15.298140281299679,55.573383757096565,29.128475961603765,4659806644
1274275800,4.254957,4.372456,4.083293,4.247041,3.0450566808510633,5.873472597222222,5.623277,4.202457,4.862452,3.707464,3.10997,2.454976,NaN,1.216655,4.434275795000006,4.691186649999999,5.0414466599999965,4.9319348000000005,4.878419076830547,4.792825773379511,4.676460307692305,5.344753228101582,4.008167387283028,4.434275795000006,4.691186649999999,5.0414466599999965,4.9319348000000005,4.234263333333334,104282912,72039731.4,36.39704256820967,NaN,1.5,2.75,NaN,NaN,0.3308738970823681,1.447574969720112,164.2367598531119,-0.07921141695719133,-0.20443807903039612,-0.1252266620732048,114.87477440585211,-3.9485429697774275,3.6002030698748966,79.49892364262611,16.900873287499003,4555523732
1274362200,3.984127,4.028293,3.753295,3.760796,3.037734042553191,5.88515075,5.623277,4.202457,4.862452,3.707464,3.10997,2.454976,NaN,1.216655,4.434721625000005,4.683528389999999,5.021363539999997,4.844351950000001,4.834590720876408,4.694537223533843,4.549858999999997,5.240111066589275,3.859606933410719,4.434721625000005,4.683528389999999,5.021363539999997,4.844351950000001,3.847461333333333,162857984,77217305,29.909672749137798,NaN,1.5,2.75,NaN,NaN,0.34250761871934177,2.109086609536554,154.0250019241361,-0.10775151863449037,-0.25991606036631776,-0.1521645417318274,119.66570871643646,-10.509589985096811,2.396570262793758,83.47366752851244,14.129762208693787,4392665748
1274448600,3.58663,3.955627,3.559964,3.911628,3.030411404255319,5.896828902777778,5.623277,4.202457,4.862452,3.707464,3.10997,2.454976,NaN,1.216655,4.436100780000005,4.6772367799999985,5.003230379999997,4.7587695000000005,4.7983961043714505,4.619974440340144,4.464475307692305,5.174505641519891,3.7544449738647185,4.436100780000005,4.6772367799999985,5.003230379999997,4.7587695000000005,3.8090729999999997,135951180,81531826.2,33.848485845566586,NaN,1.5,2.75,NaN,NaN,0.34630443166796016,1.6674614851200278,158.59008680834143,-0.10897838784414657,-0.2883875265370106,-0.17940913869286404,121.28326166091318,-17.965742826667693,17.416447448340342,52.403232126988385,30.180320424671272,4528616928
1274707800,3.869961,3.957461,3.765796,3.774962,3.0230887659574464,5.908507055555556,5.623277,4.202457,4.862452,3.707464,3.10997,2.454976,NaN,1.216655,4.437054940000005,4.6697701899999995,4.9821122599999965,4.669166250000001,4.758261433611786,4.5394970650696544,4.37671969230769,5.123013000765465,3.6304263838499145,4.437054940000005,4.6697701899999995,4.9821122599999965,4.669166250000001,3.8327396666666664,76280824,83223856.8,32.08888719896186,NaN,1.5,2.75,NaN,NaN,0.3352587579773916,0.9165740081394546,155.59898890511815,-0.11112060449934516,-0.3183098943170455,-0.20718928981770032,86.8521370168821,-20.34464633616501,6.087990352431252,72.9786704692803,20.93333917828843,4452336104
1274794200,3.499965,3.789045,3.422467,3.781629,3.015766127659574,5.920185208333334,5.623277,4.202457,4.862452,3.707464,3.10997,2.454976,NaN,1.216655,4.437322435000005,4.662511929999999,4.961312479999997,4.5996669500000005,4.719962122489755,4.46731915411064,4.327488769230767,5.137181502896362,3.5177960355651723,4.437322435000005,4.662511929999999,4.961312479999997,4.5996669500000005,3.664380333333334,80966212,82721251,32.27385043439364,16.065544955543373,1.5,2.75,NaN,NaN,0.33749584669329213,0.9787836985202267,152.18970915628597,-0.10432380112025524,-0.3375940412180194,-0.23327024009776415,87.53930515210754,-23.538346288809556,17.720524037856162,52.10274765988331,30.176728302260543,4533302316
1274880600,3.864961,3.96996,3.692463,3.726296,3.0084434893617016,5.931863361111111,5.623277,4.202457,4.862452,3.707464,3.10997,2.454976,NaN,1.216655,4.437466600000005,4.656016999999999,4.936822719999997,4.5219427,4.6809948235685885,4.396745520385817,4.290860999999998,5.160709198396441,3.4210128016035544,4.437466600000005,4.656016999999999,4.936822719999997,4.5219427,3.7962396666666667,85833760,82551184,31.506863124813222,10.673702233357316,1.5,2.75,NaN,NaN,0.33321021478662843,1.0397641298518505,155.2474861265701,-0.0959994129369916,-0.35326950626900366,-0.25727009333201206,77.53023947710572,-21.920723351434447,20.107831795948385,48.78669134245786,31.10547686159375,4447468556
1274967000,3.942461,4.113292,3.898294,4.099959,3.0011208510638294,5.9435415138888885,5.623277,4.202457,4.862452,3.707464,3.10997,2.454976,NaN,1.216655,4.4401415750000055,4.651017049999999,4.917956239999997,4.45294345,4.658209104997272,4.36848013749193,4.2394512307692285,5.068392546862753,3.4105099146757043,4.4401415750000055,4.651017049999999,4.917956239999997,4.45294345,4.037181666666667,58873200,83345125.8,41.60009200507819,3.496647404015342,1.5,2.75,NaN,NaN,0.3370520565875835,0.7063784406694122,163.74835113445917,-0.05955761778878316,-0.331717115567991,-0.27215949777920784,104.7061070037106,-9.023676713955597,50.99436225037527,18.501139719929622,30.50449802969511,4506341756
1275053400,4.088292,4.094959,3.893377,3.96496,2.993798212765957,5.955219666666666,5.623277,4.202457,5.623277,3.707464,4.862452,2.454976,3.10997,1.216655,4.4415332200000055,4.6442337799999995,4.896973099999997,4.3907107000000005,4.631022865585614,4.330049648206984,4.179900538461536,4.966869972863041,3.3929311040600307,4.4415332200000055,4.6442337799999995,4.896973099999997,4.3907107000000005,3.984432,73217472,83660570,39.344295218050796,4.169354472447075,1.5,2.75,NaN,NaN,0.32773276683132757,0.8751729996580229,159.83006819719307,-0.03972859245313426,-0.3218202383456257,-0.2820916458924914,102.06425057058478,-12.181608051820689,17.18105949604753,52.883340343059274,29.93560016089318,4433124284
1275399000,3.839129,4.013293,3.727463,3.738296,2.9864755744680846,5.966897819444444,5.623277,4.202457,5.623277,3.707464,4.862452,2.454976,3.10997,1.216655,4.441420720000005,4.63505887,4.873123339999997,4.307294850000001,4.596013968895981,4.273692157901557,4.087016769230766,4.768434369657386,3.405599168804147,4.441420720000005,4.63505887,4.873123339999997,4.307294850000001,3.826350666666667,72614788,85243946.8,35.83109837046155,7.078522085531387,1.5,2.75,NaN,NaN,0.32473971205766133,0.8518468551247325,154.56807954363595,-0.03711089632254627,-0.3284802662956743,-0.291369369973128,104.77874760899253,-13.697567863131198,18.062381540644186,51.53394499129057,30.40367346806525,4360509496
1275485400,3.803295,4.03496,3.749963,4.031626,2.9791529361702125,5.978575972222222,5.623277,4.202457,5.623277,3.707464,4.862452,2.454976,3.10997,1.216655,4.443245700000005,4.6282706000000005,4.853256859999997,4.257795350000001,4.5738811073706485,4.250638238101409,4.030030153846151,4.584758594814881,3.475301712877421,4.443245700000005,4.6282706000000005,4.853256859999997,4.257795350000001,3.9388496666666666,53243500,84542977.8,42.93285051761371,3.5628268708759596,1.5,2.75,NaN,NaN,0.3227343040535427,0.6297802772686344,160.28731702946874,-0.012148766336853467,-0.3065553278941948,-0.29440656155734135,116.39047127012196,-5.0721196239923305,14.016673411679296,57.654376667783716,28.328949920536978,4413752996
1275571800,4.08246,4.119959,3.964128,4.085792,2.97183029787234,5.990254125,5.623277,3.726296,5.623277,3.707464,4.862452,2.454976,3.10997,1.216655,4.446696085000005,4.621520660000001,4.8345736799999965,4.216295700000002,4.554740358061996,4.234938596377465,3.9976586153846125,4.482013387331177,3.5133038434380484,4.446696085000005,4.621520660000001,4.8345736799999965,4.216295700000002,4.056626333333333,49183424,83703834,44.16178131368276,0.6445499548330135,1.5,2.75,NaN,NaN,0.3108126394782897,0.5875886640987078,163.0549502809009,0.010274667550423444,-0.28156322711931203,-0.2918378946697355,116.63255006944969,8.641681176006346,37.056033641704026,29.818391135105834,33.12557522319015,4462936420
1275658200,3.854128,3.937461,3.616463,3.66913,2.9645076595744677,6.001932277777778,5.623277,3.726296,5.623277,3.707464,4.862452,2.454976,3.10997,1.216655,4.447604405000004,4.61042076,4.809140619999996,4.178670650000001,4.52001054009878,4.181052063389135,3.932595230769228,4.343130673089023,3.5220597884494325,4.447604405000004,4.61042076,4.809140619999996,4.178670650000001,3.7410180000000004,79123028,81196716,37.47620741624177,8.676328693481219,1.5,2.75,NaN,NaN,0.32213523665841187,0.974460937558115,156.57420958249304,-0.0001391386170520037,-0.29201181794105047,-0.29187267932399846,111.63359639330895,-6.19941364567387,12.870794343581288,59.542075755370796,27.587129901047923,4383813392
1275917400,3.694963,3.735796,3.501632,3.509132,2.9571850212765955,6.0136104305555556,5.623277,3.726296,5.623277,3.707464,4.862452,2.454976,3.10997,1.216655,4.447254410000005,4.599120880000001,4.781124239999996,4.144004400000001,4.4803682444086315,4.117059676399694,3.8693266923076894,4.26771306420959,3.4709403204057887,4.447254410000005,4.599120880000001,4.781124239999996,4.144004400000001,3.582186666666667,57623736,79050126.8,35.26824678772435,10.59849134296343,1.5,2.75,NaN,NaN,0.31585157689709675,0.7289518478039937,152.5511280291082,-0.014208767769342545,-0.30963363903567664,-0.2954248712663341,110.52198242926715,-7.0419251902403195,16.27223425521461,54.06906161390696,29.65870413087842,4326189656
1276003800,3.518298,3.627464,3.416633,3.608214,3.416633,6.025288583333333,5.623277,3.726296,5.623277,3.707464,4.862452,2.454976,3.10997,1.216655,4.4468831650000045,4.587620150000001,4.754996159999997,4.086000800000001,4.4461661171769205,4.068598183409247,3.8201861538461506,4.175338327673172,3.4650339800191285,4.4468831650000045,4.587620150000001,4.754996159999997,4.086000800000001,3.550770333333333,94952028,79846151.8,37.71550900051555,9.814766832449594,1.5,2.75,NaN,NaN,0.30835010711873273,1.1891872790292695,155.1968793401728,-0.013265977736566903,-0.31200734343704273,-0.2987413657004758,111.32080894835869,-4.585722184804493,48.56686516435273,20.15196858815016,31.281166247497104,4421141684
1276090200,3.675797,3.788296,3.518298,3.55663,3.4148671547619047,6.036966736111111,5.623277,3.726296,5.623277,3.707464,4.862452,2.454976,3.10997,1.216655,4.445220675000004,4.57522026,4.726163099999997,4.02687635,4.411282347875865,4.019839308798842,3.8044810769230732,4.185839248759924,3.4231229050862217,4.445220675000004,4.57522026,4.726163099999997,4.02687635,3.621074666666667,72435868,79815279.8,36.93265884192642,6.497944417053403,1.5,2.75,NaN,NaN,0.30561067089596605,0.9075438710671537,155.8934053733198,-0.012548033098945754,-0.31442640707415803,-0.3018783739752123,111.37334510519418,-4.5532077966967694,23.577699842053207,44.15868956193252,32.263610596014274,4348705816
1276176600,3.741628,3.883295,3.724963,3.875794,3.4131013095238094,6.048644888888889,5.623277,3.726296,5.623277,3.707464,4.862452,2.454976,3.10997,1.216655,4.445187340000005,4.5676286600000005,4.703463319999997,3.9733768000000005,4.39028280482191,4.006120707960857,3.801724615384612,4.180454059840099,3.4229951709291244,4.445187340000005,4.5676286600000005,4.703463319999997,3.9733768000000005,3.828017333333333,56519112,80367926.8,44.595460539993276,0.7105187802925008,1.5,2.75,NaN,NaN,0.3071145515462542,0.7032545724446883,161.82194153190116,0.01168021768743005,-0.28727810186592473,-0.2989583195533548,122.8868304025616,-5.467493699327241,24.519395890354865,43.009815613179974,32.47078849646517,4405224928
1276263000,3.770796,3.943295,3.759129,3.929961,3.411335464285714,6.060323041666667,5.623277,3.726296,5.623277,3.707464,4.862452,2.454976,3.10997,1.216655,4.445304005000005,4.55891208,4.682863539999997,3.931252250000001,4.372230969338697,3.9988674024407755,3.8136476153846113,4.197974100789555,3.429321129979668,4.445304005000005,4.55891208,4.682863539999997,3.931252250000001,3.877461666666667,41643632,79915153.4,45.799096510034055,0.2869428734569815,1.5,2.75,NaN,NaN,0.2983325121500932,0.5210980674911649,165.0748836852542,0.03243607691855427,-0.25841322340516193,-0.2908493003237162,108.76244313599646,-0.8827075178564223,49.410645128322805,19.529079154977147,31.06027571670006,4446868560
1276522200,4.03246,4.098292,3.911628,3.921627,3.4095696190476192,6.072001194444445,5.623277,3.509132,5.623277,3.707464,4.862452,2.454976,3.10997,1.216655,4.445354000000005,4.551528820000001,4.659930419999998,3.9020025000000005,4.354560225443062,3.991511173636892,3.8244166923076883,4.212379402861866,3.436453981753511,4.445354000000005,4.551528820000001,4.659930419999998,3.9020025000000005,3.9771823333333325,48015576,78045183.2,45.63482976945519,2.6284272589928226,1.5,2.75,NaN,NaN,0.2903561898536579,0.6152279235088015,167.91800403679287,0.04586485576921501,-0.23351823061219745,-0.27938308638141246,107.15782812796682,4.904132792052847,49.54869523623665,19.435218137504496,31.016086626258854,4398852984
1276608600,4.005794,4.202375,3.986627,4.185791,3.407803773809524,6.083679347222223,5.623277,3.509132,5.623277,3.707464,4.862452,2.454976,3.10997,1.216655,4.446576480000005,4.5493071700000005,4.639547259999997,3.88554435,4.347941824445295,4.010014014242902,3.859762461538458,4.287240387664108,3.4322845354128084,4.446576480000005,4.5493071700000005,4.639547259999997,3.88554435,4.124931,42601456,76674106.4,51.5648746051433,5.658665558327929,1.5,2.75,NaN,NaN,0.28966989057839665,0.5556172481196338,173.73347238690428,0.07128285428036141,-0.1902795185309607,-0.2615623728113221,106.33396159710584,3.8238914026251414,40.570049167364324,26.597684504652733,32.832266327982936,4441454440
1276695000,4.128291,4.235791,4.097467,4.179124,3.4060379285714286,6.0953575,5.623277,3.509132,5.623277,3.707464,4.862452,2.454976,3.10997,1.216655,4.447805630000005,4.54994049,4.6182307799999975,3.8779194000000006,4.341321517604303,4.02611972717215,3.8658520769230735,4.308818235402277,3.4228859184438707,4.447805630000005,4.54994049,4.6182307799999975,3.8779194000000006,4.170794,50459148,74833942,51.41245281601927,5.4836872758250195,1.5,2.75,NaN,NaN,0.2788594698227969,0.6742815713222752,171.33716939244863,0.08543674016836622,-0.15476644760086433,-0.24020318776923055,98.20659620817048,2.2843062006093358,44.44916146961544,23.350692183053734,32.200146347330836,4390995292
1276781400,4.22329,4.224958,4.072459,4.190791,3.4042720833333333,6.107035652777777,5.623277,3.509132,5.623277,3.707464,4.862452,2.454976,3.10997,1.216655,4.449618110000005,4.55008215,4.598964279999997,3.875106900000001,4.335418360051193,4.041802705536707,3.8832236923076886,4.357014194892232,3.409433189723146,4.449618110000005,4.55008215,4.598964279999997,3.875106900000001,4.162736,63764040,72807998.4,51.68161800873907,4.135909889618486,1.5,2.75,NaN,NaN,0.2698337219783114,0.8757834496381375,170.53160364701702,0.092763833835388,-0.12424839547499555,-0.21701222931038355,98.01013739626235,14.21756656210055,47.332789609001075,21.08909522798792,31.578115163011013,4454759332
1276867800,4.213291,4.247458,4.162458,4.202457,3.402506238095238,6.118713805555555,5.623277,3.509132,5.623277,3.707464,4.862452,2.454976,3.10997,1.216655,4.452747240000004,4.55089046,4.578964479999997,3.8971899500000005,4.330204189068794,4.057103114533211,3.9189283846153815,4.413167449833225,3.4246893193975376,4.452747240000004,4.55089046,4.578964479999997,3.8971899500000005,4.204124333333333,36192612,66474729.8,51.968148410656404,4.3850584478378725,1.5,2.75,NaN,NaN,0.25663131326557487,0.544456699694626,172.32903771556286,0.09521643667859864,-0.09799168346213527,-0.1932081201407339,68.8274053108727,19.75773496123827,46.663387851102534,21.602922638243506,31.733689510653956,4490951944
1277127000,4.359123,4.369956,4.091627,4.153292,3.400740392857143,4.369956,5.623277,3.509132,5.623277,3.707464,4.862452,2.454976,3.10997,1.216655,4.455838455000005,4.55061546,4.556031359999997,3.9092731500000006,4.323266456164135,4.0662639607681434,3.928287307692304,4.435154522325264,3.421420093059344,4.455838455000005,4.55061546,4.556031359999997,3.9092731500000006,4.204958333333334,56308352,62492588.4,50.606138460709964,3.9980385524985382,1.5,2.75,NaN,NaN,0.25818114803231956,0.9010404824262328,169.77085402445147,0.09038612378706135,-0.08022546540690723,-0.17061158919396857,60.80899734085405,15.106587358732066,44.67714038420917,23.18753023344236,32.13532938234849,4434643592
1277213400,4.155792,4.212458,3.928294,3.943794,3.398974547619048,4.33649476923077,5.623277,3.509132,5.623277,3.707464,4.862452,2.454976,3.10997,1.216655,4.457424275000005,4.5497288000000005,4.528174999999997,3.9177147500000005,4.308385183373384,4.054600154980701,3.9173643846153814,4.416241094928916,3.4184876743018466,4.457424275000005,4.5497288000000005,4.528174999999997,3.9177147500000005,4.028182,62656332,61811363.8,45.173226481453305,0.3941011433053493,1.5,2.75,NaN,NaN,0.260037066030011,1.013670110931932,164.70708161203243,0.07080614763777593,-0.08210390464674866,-0.1529100522845246,71.69798734082278,10.885697978142225,19.432348368090842,49.57782187719626,30.989829754712897,4371987260
1277299800,3.954127,3.995793,3.823295,3.904961,3.3972087023809525,4.303033538461539,5.623277,3.509132,5.623277,3.707464,4.862452,2.454976,3.10997,1.216655,4.458032605000005,4.549928800000001,4.499375279999997,3.9238813500000007,4.292564627162664,4.040348806887301,3.9355052307692273,4.413677639218895,3.457332822319559,4.458032605000005,4.549928800000001,4.499375279999997,3.9238813500000007,3.9080163333333338,60928832,60809494.8,44.22544669417322,2.563658264022541,1.5,2.75,NaN,NaN,0.2537842755992959,1.0019624764256387,163.4217124381981,0.05373784307348117,-0.08573774844267312,-0.1394755915161543,71.20871450818625,0.7525425757922162,18.478100587650843,50.901720732570766,30.6201786797784,4311058428
1277386200,3.854128,3.866627,3.684131,3.709129,3.395442857142857,4.269572307692308,5.623277,3.509132,5.623277,3.707464,4.862452,2.454976,3.10997,1.216655,4.457124280000005,4.546328830000001,4.463058959999997,3.9230230000000006,4.26968479864648,4.008804063374225,3.9508896153846114,4.383941044140375,3.5178381866288477,4.457124280000005,4.546328830000001,4.463058959999997,3.9230230000000006,3.7532956666666664,64457384,59740676,39.70165739686215,5.9545231686285085,1.5,2.75,NaN,NaN,0.2514303987707748,1.0789530403037286,159.1924851285866,0.028996765512668082,-0.1032296346253192,-0.13222640013798728,59.911924028223005,-5.619190623011274,2.259028123670732,83.98841830532488,13.752553571004386,4246601044
1277472600,3.736629,3.814129,3.64413,3.759962,3.393677011904762,4.236111076923077,5.623277,3.509132,5.623277,3.707464,4.862452,2.454976,3.10997,1.216655,4.456020120000004,4.541678870000001,4.427342639999996,3.9060231500000007,4.249695669287795,3.985104819243346,3.962562538461535,4.365146285710852,3.5599787912122185,4.456020120000004,4.541678870000001,4.427342639999996,3.9060231500000007,3.7394069999999995,73137824,60453907.2,41.37790526589716,5.2302459731767845,1.5,2.75,NaN,NaN,0.24561387028714798,1.2098113651783948,163.72737403475668,0.01641900520392056,-0.11170264363308657,-0.12812164883700713,59.88236625285529,-4.122396138133488,6.352997229891427,72.25565795932039,21.39134481078818,4319738868
1277731800,3.774128,3.804128,3.679129,3.71413,3.3919111666666666,4.202649846153847,5.623277,3.509132,5.623277,3.707464,4.862452,2.454976,3.10997,1.216655,4.454070140000004,4.5372039200000005,4.395901299999997,3.8934816500000005,4.228693094021607,3.9592976936011226,3.9746779230769196,4.334920903617265,3.6144349425365743,4.454070140000004,4.5372039200000005,4.395901299999997,3.8934816500000005,3.7324623333333333,38548968,58720482,40.290373603781674,4.628144923208423,1.5,2.75,NaN,NaN,0.23699852240949454,0.6564824859577958,161.79970469306213,0.005917966778284767,-0.12072419036415116,-0.12664215714243593,60.0221835049193,-11.268145017273918,7.427758568436639,69.82565936558153,22.746582065981837,4281189900
1277818200,3.564964,3.568298,3.301634,3.3683,3.3901453214285713,4.169188615384615,5.623277,3.509132,5.623277,3.707464,4.862452,2.454976,3.10997,1.216655,4.450390180000005,4.5331373,4.356668339999997,3.87498185,4.194952188373701,3.9030121989724442,3.9356399230769195,4.419176055184136,3.452103790969703,4.450390180000005,4.5331373,4.356668339999997,3.87498185,3.412744,91288152,59654150.2,33.199718667635224,13.382158261239582,1.5,2.75,NaN,NaN,0.24953405652310207,1.530290041748009,154.51349244739643,-0.021889600570730694,-0.1540041578558493,-0.13211455728511862,62.6317265612675,-19.401769366020243,6.65301814030204,71.5544620136963,21.79251984600168,4189901748
1277904600,3.342467,3.440798,3.243301,3.258302,3.3883794761904764,4.135727384615385,5.623277,3.509132,5.623277,3.707464,4.862452,2.454976,3.10997,1.216655,4.445790230000004,4.52778737,4.312318799999997,3.8363156500000004,4.158220808437478,3.841611227641735,3.8839738461538427,4.487534001140311,3.2804136911673742,4.445790230000004,4.52778737,4.312318799999997,3.8363156500000004,3.3141336666666668,69877308,60485840.6,31.312141829583382,13.26735853655434,1.5,2.75,NaN,NaN,0.24581712391430904,1.155267204800986,151.60715308134877,-0.04398670821451875,-0.18709794255326706,-0.1431112343387483,61.53324819842217,-22.250906809716827,6.775804129704606,71.27455517973247,21.949640690562912,4120024440
1277991000,3.269134,3.299134,3.069136,3.229134,3.069136,4.102266153846154,5.623277,3.509132,5.623277,3.707464,4.862452,2.454976,3.10997,1.216655,4.440748610000004,4.52300407,4.2676858999999965,3.7934827500000003,4.121786031636008,3.783280063104427,3.8307051538461505,4.526723514525211,3.13468679316709,4.440748610000004,4.52300407,4.2676858999999965,3.7934827500000003,3.199134666666667,100256872,63039513,30.811882706082798,14.659998556869406,1.5,2.75,NaN,NaN,0.24468718649185842,1.5903814485368883,149.00678680678192,-0.05608760707663324,-0.21322074318453987,-0.15713313610790663,59.94928215568674,-23.16080807013611,5.8519394276794925,73.44181553050657,20.706245041813926,4019767568
1278077400,3.259134,3.289967,3.119969,3.176635,3.048695,4.068804923076923,5.623277,3.509132,5.623277,3.707464,4.862452,2.454976,3.10997,1.216655,4.434461170000005,4.51628748,4.220969539999997,3.7688580000000007,4.0847212852973405,3.725504342808767,3.7530777692307655,4.496835118385883,3.0093204200756474,4.434461170000005,4.51628748,4.220969539999997,3.7688580000000007,3.1955236666666664,71824844,62674603.8,29.886365682164907,12.914970083999327,1.5,2.75,NaN,NaN,0.2393522445995828,1.1459959799538455,146.51063592376838,-0.06264982173164707,-0.2354454132724655,-0.17279559154081842,57.540692798812884,-23.515250071509545,0,99.99999999999999,0,3947942724
1278423000,3.309967,3.378308,3.135802,3.2233,3.028254,4.035343692307692,5.623277,3.509132,5.623277,3.707464,4.862452,2.454976,3.10997,1.216655,4.428544555000005,4.5102792,4.172969999999997,3.7545664000000007,4.050940058422935,3.6776753577793606,3.6795528461538423,4.429258622250385,2.9298470700572987,4.428544555000005,4.5102792,4.172969999999997,3.7545664000000007,3.2458033333333334,66010920,63093963,31.846032508630714,10.781229639258106,1.5,2.75,NaN,NaN,0.23957751284246975,1.0462319509078863,145.65387309007897,-0.058925287860735726,-0.24645220136673807,-0.18752691350600234,62.056335222198456,-18.269057663762354,3.2469975540293796,80.59184195985513,16.161160486115477,4013953644
1278509400,3.246635,3.543298,3.239968,3.533297,3.0078129999999996,4.001882461538462,5.623277,3.509132,5.623277,3.707464,4.862452,2.454976,3.10997,1.216655,4.424131675000004,4.50609757,4.132295399999997,3.750820550000001,4.030640330641643,3.66392503799085,3.6289763846153806,4.320343712652105,2.9376090565786566,4.424131675000004,4.50609757,4.132295399999997,3.750820550000001,3.4388543333333335,54299316,61061327.4,43.20286227509642,3.0206196681080786,1.5,2.75,NaN,NaN,0.2453218333537219,0.8892586897807925,152.00422135430222,-0.03200892982239634,-0.22753807578399776,-0.19552914596160142,88.63074116336075,-9.517739101619707,15.608693502638896,55.09433276967789,29.296973727683202,4068252960
1278595800,3.624964,3.66663,3.517466,3.63413,2.9873719999999997,3.968421230769231,5.623277,3.509132,5.623277,3.707464,4.862452,2.454976,3.10997,1.216655,4.4203817100000045,4.502914270000001,4.101545699999997,3.754695550000001,4.015090905910598,3.6610874153250546,3.585258923076919,4.19284285768119,2.977674988472648,4.4203817100000045,4.502914270000001,4.101545699999997,3.754695550000001,3.606075333333333,55131500,60196109,46.33531440942587,1.316512966338951,1.5,2.75,NaN,NaN,0.2384534166855989,0.9158648443539764,156.2019218742503,-0.005242788670704102,-0.20208263179998154,-0.19683984312927744,91.43865788317369,-2.0220110974840733,37.31240526575634,29.527000232254583,33.16059450198908,4123384460
1278682200,3.63663,3.724963,3.61663,3.720795,2.9669309999999998,3.9349600000000002,5.623277,3.509132,5.623277,3.707464,4.862452,2.454976,3.10997,1.216655,4.416698405000004,4.4987143000000005,4.070345979999997,3.746945600000001,4.003549889992535,3.6667738519607638,3.551989923076919,4.072665218657549,3.031314627496289,4.416698405000004,4.4987143000000005,4.070345979999997,3.746945600000001,3.6874626666666668,47358976,59738102.2,48.94176517558036,3.0455261912208105,1.5,2.75,NaN,NaN,0.22915910120805613,0.7927767079282944,160.44075920723253,0.019133854813418116,-0.1729225246125048,-0.1920563794259229,88.23693809833603,-1.0416860595931543,73.22550216994111,5.9395229175149,20.834974912544,4170743436
1278941400,3.68913,3.759129,3.63663,3.723295,2.94649,3.9014987692307694,5.623277,3.176635,5.623277,3.707464,4.862452,2.454976,3.10997,1.216655,4.413681765000004,4.493926010000001,4.035212999999998,3.7366123,3.9925595021496907,3.672156818440691,3.5350284615384577,4.01642993816501,3.0536269849119058,4.413681765000004,4.493926010000001,4.035212999999998,3.7366123,3.7063513333333336,40843452,59698093.2,49.018687588457816,2.954515926558783,1.5,2.75,NaN,NaN,0.22154052255033788,0.684166776703682,157.62533641401174,0.03532011991912451,-0.14790622952701726,-0.18322634944614177,87.83592197038845,0.24676034495291946,100,0,0,4211586888
1279027800,3.841629,3.946627,3.823295,3.901628,2.926049,3.8680375384615386,5.623277,3.176635,5.623277,3.707464,4.862452,2.454976,3.10997,1.216655,4.412290115000004,4.490159380000001,4.009053259999997,3.7356123500000002,3.9889935608889187,3.6940112166844346,3.5347720769230735,4.015388115765827,3.05415603808032,4.412290115000004,4.490159380000001,4.009053259999997,3.7356123500000002,3.8905166666666666,53218096,59958219.2,54.306957019179976,6.834135147353046,1.5,2.75,NaN,NaN,0.22166848522531374,0.8875863344520412,163.09564192871952,0.0566650533520911,-0.11239503275602791,-0.169060086108119,91.51034293802113,15.833744025175907,100,0,0,4264804984
1279114200,3.869127,3.945127,3.818296,3.896627,2.905608,3.834576307692308,5.623277,3.176635,5.623277,3.707464,4.862452,2.454976,3.10997,1.216655,4.411169290000003,4.486009410000001,3.978853539999997,3.7211541500000003,3.9853713428148434,3.713307957952584,3.549194999999997,4.060169229088524,3.0382207709114692,4.411169290000003,4.486009410000001,3.978853539999997,3.7211541500000003,3.8866833333333335,37107128,59683502.8,54.13736340874499,5.289497190451404,1.5,2.75,NaN,NaN,0.2148943791377913,0.6217317392436961,161.1966788943082,0.06829530477408538,-0.08369095514051228,-0.15198625991459766,64.82114478396869,19.590725476030155,81.675330283751,2.918698938299866,15.405970777949133,4227697856
1279200600,3.894128,3.938293,3.738296,3.904961,2.8851669999999996,3.801115076923077,5.623277,3.176635,5.623277,3.707464,4.862452,2.454976,3.10997,1.216655,4.409031805000003,4.482017790000001,3.956520439999997,3.707446,3.982217996037791,3.7315606286237664,3.560348769230766,4.095019649207284,3.0256778892542484,4.409031805000003,4.482017790000001,3.956520439999997,3.707446,3.860516666666667,60341892,60177640,54.392967123224985,3.787224656719236,1.5,2.75,NaN,NaN,0.21383028062794907,1.0027294523347874,160.0974367311188,0.07392225445135725,-0.0595834418504011,-0.13350569630175835,58.13457479034489,20.929047849980826,82.4713482034799,2.683802494113016,14.844849302407068,4288039748
1279287000,3.838295,3.845794,3.55413,3.574963,2.8647259999999997,3.7676538461538467,5.623277,3.176635,5.623277,3.707464,4.862452,2.454976,3.10997,1.216655,4.405356835000003,4.476284500000001,3.929703999999997,3.6766546,3.966247211879446,3.716646568754836,3.5496436153846123,4.077093851263156,3.022193379506069,4.405356835000003,4.476284500000001,3.929703999999997,3.6766546,3.658295666666667,60516604,60015268.2,43.94833663479071,2.701688746621274,1.5,2.75,NaN,NaN,0.2236160462973813,1.0083534709589117,154.90128430841216,0.05373143529255513,-0.06634140218606444,-0.12007283747861956,83.74983029225963,12.539306530337914,52.00489475258581,17.711831708258504,30.28327353915567,4227523144
1279546200,3.614964,3.670797,3.526632,3.64163,2.8442849999999997,3.7341926153846154,5.623277,3.176635,5.623277,3.707464,4.862452,2.454976,3.10997,1.216655,4.402294365000002,4.470192900000002,3.914103979999997,3.6486132500000004,3.9535171251390757,3.7095021336353278,3.570668999999997,4.08924435957185,3.0520936404281436,4.402294365000002,4.470192900000002,3.914103979999997,3.6486132500000004,3.6130196666666663,38924872,60151881.2,46.19608900119869,1.9938352810678628,1.5,2.75,NaN,NaN,0.21794097156185405,0.6471098031095326,158.1073831477248,0.04360874371310239,-0.06556190783724158,-0.10917065155034397,82.080604961157,12.978314150094628,49.26479394966987,19.648379650568035,31.08682639976209,4266448016
1279632600,3.491631,3.77663,3.483299,3.766629,2.823844,3.700731384615385,5.623277,3.176635,5.623277,3.707464,4.862452,2.454976,3.10997,1.216655,4.401473120000002,4.465412950000002,3.9053874199999967,3.6292801,3.9461881790551905,3.71494278757482,3.609771076923074,4.1043390621412295,3.1152030917049185,4.401473120000002,4.465412950000002,3.9053874199999967,3.6292801,3.6755193333333334,49593444,59816135.8,50.2264065388282,1.086231194985074,1.5,2.75,NaN,NaN,0.22332597359315015,0.8290980909535784,162.8146686272093,0.04395042648563911,-0.05423261844329508,-0.09818304492893419,82.89027495846562,6.603803756095224,48.00406476624722,20.585892025280817,31.410043208471976,4316041460
1279719000,3.826628,3.830795,3.574131,3.618297,2.803403,3.6672701538461543,5.623277,3.176635,5.623277,3.707464,4.862452,2.454976,3.10997,1.216655,4.400160630000002,4.459096340000001,3.882387639999997,3.6130052499999996,3.933329701445183,3.705738426853409,3.639706692307689,4.082939613243699,3.1964737713716787,4.400160630000002,4.459096340000001,3.882387639999997,3.6130052499999996,3.6744076666666667,62902144,59828426.4,45.83839446786215,1.2206558227880577,1.5,2.75,NaN,NaN,0.22570726119363946,1.051375538100397,158.93409862662799,0.03328954701667873,-0.056571111158085774,-0.0898606581747645,72.43881752774602,-0.4356751134384231,40.75717802972846,26.44157307224439,32.80124889802716,4253139316
1279805400,3.74913,3.905794,3.747463,3.859962,2.7829619999999995,3.6338089230769235,5.623277,3.176635,5.623277,3.707464,4.862452,2.454976,3.10997,1.216655,4.399218975000002,4.4538380700000015,3.8648044999999973,3.6107552999999997,3.9304525366826266,3.720426386200703,3.6922703076923047,4.058808790463536,3.325731824921073,4.399218975000002,4.4538380700000015,3.8648044999999973,3.6107552999999997,3.8377396666666668,40259260,58794947.8,53.03709700989122,4.161861873594417,1.5,2.75,NaN,NaN,0.23012081396552236,0.6847401265997892,165.50372570889073,0.04110415943229437,-0.03848045888439655,-0.07958461831669092,79.82541365509873,3.740249059676764,35.461896645119374,31.266921727762885,33.27118162711774,4293398576
1279891800,3.834962,3.981627,3.804128,3.970294,2.7625209999999996,3.6003476923076927,5.623277,3.176635,5.623277,3.707464,4.862452,2.454976,3.10997,1.216655,4.397941485000002,4.4492414500000015,3.845294679999997,3.623813549999999,3.932014947008798,3.7442233018006363,3.749731384615382,4.027679878564047,3.4717828906667165,4.397941485000002,4.4492414500000015,3.845294679999997,3.623813549999999,3.918683,42507724,57697464.8,55.91779933528409,5.058003164094556,1.5,2.75,NaN,NaN,0.22636211296798506,0.7367346927173827,170.29688322501295,0.0516141473995156,-0.015066934067296422,-0.06668108146681202,80.23829356226574,6.633882085625776,67.38405570971798,8.584479588169497,24.03146470211253,4335906300
1280151000,3.987461,4.110459,3.954961,4.100793,2.7420799999999996,3.566886461538462,5.623277,3.176635,5.623277,3.707464,4.862452,2.454976,3.10997,1.216655,4.397158165000002,4.445833160000002,3.831861499999998,3.6408550999999987,3.9386336941849236,3.778182320676766,3.7933849230769208,4.098574470068458,3.488195376085384,4.397158165000002,4.445833160000002,3.831861499999998,3.6408550999999987,4.055404333333333,37897744,55935460.8,59.11246049377219,6.763663600597958,1.5,2.75,NaN,NaN,0.22130039061312898,0.6775262679162554,174.9178851225007,0.06443196535202672,0.013858875223221379,-0.05057309012880534,81.44397246364258,5.104664001796181,69.79541236903093,7.4570955950679885,22.74749203590108,4373804044
1280237400,4.166625,4.179124,4.03996,4.084125,2.7216389999999997,3.533425230769231,5.623277,3.176635,5.623277,3.707464,4.862452,2.454976,3.10997,1.216655,4.395758175000002,4.441891520000001,3.823411559999998,3.659354849999999,3.944339235589436,3.8073197187075505,3.827999923076921,4.154424954430887,3.5015748917229543,4.395758175000002,4.441891520000001,3.823411559999998,3.659354849999999,4.101069666666667,39231464,55969585.6,58.52902371100952,6.413963006595348,1.5,2.75,NaN,NaN,0.21543350556933408,0.7009425490547138,172.8313428783596,0.06848564761837221,0.035033969394159925,-0.033451678224212286,78.13052574236211,4.811802618007834,42.18280873741663,25.26580244819964,32.55138881438371,4334572580
1280323800,4.059959,4.097459,3.959126,4.00246,2.7011979999999998,3.4999640000000003,5.623277,3.176635,5.623277,3.707464,4.862452,2.454976,3.10997,1.216655,4.393579035000003,4.435241600000001,3.8131616799999986,3.691062849999999,3.9466184812525955,3.8259045074020697,3.849666461538459,4.182088318595112,3.5172446044818058,4.393579035000003,4.435241600000001,3.8131616799999986,3.691062849999999,4.019681666666667,37122380,53261297,55.63184433418316,3.928367148936774,1.5,2.75,NaN,NaN,0.2099263266000959,0.6969860309635344,169.40756978099725,0.0625295893640573,0.04471030848085933,-0.017819280883197963,79.38987564753914,2.496798303491379,50.145390109849586,19.04284203060585,30.81176785954458,4297450200
1280410200,4.078293,4.104126,3.842462,3.941627,2.680757,3.4665027692307695,5.623277,3.176635,5.623277,3.707464,4.862452,2.454976,3.10997,1.216655,4.390799895000003,4.427925000000001,3.8053617599999985,3.7252290999999986,3.9464227368897484,3.8369256971733012,3.866461230769228,4.193668107082297,3.5392543544561583,4.390799895000003,4.427925000000001,3.8053617599999985,3.7252290999999986,3.9627383333333333,51770112,52355937.2,53.50711510397869,2.257368326289556,1.5,2.75,NaN,NaN,0.21362187470008906,0.9888107207829716,170.37193485709653,0.05179877807795573,0.0469291917142467,-0.004869586363709029,80.06076992513601,10.256441814922283,20.82461678233639,47.73748496478119,31.437898252882416,4245680088
1280496600,3.817462,4.004127,3.797463,3.949544,2.6603159999999995,3.4330415384615387,5.623277,3.176635,5.623277,3.707464,4.862452,2.454976,3.10997,1.216655,4.388222840000003,4.420429240000001,3.7994118199999987,3.7612495999999984,3.9465451393646602,3.847651249823463,3.8701470769230744,4.19992487557727,3.5403692782688787,4.388222840000003,4.420429240000001,3.7994118199999987,3.7612495999999984,3.917044666666667,37368264,49211506.8,53.754660129758996,1.5924323203089448,1.5,2.75,NaN,NaN,0.21312488365008272,0.759339968025527,172.87480677073734,0.04290717544771966,0.04876438294594054,0.005857207498220886,56.62647351709274,8.455389482182424,19.08678714274293,50.08461283005929,30.82860002719778,4283048352
1280755800,4.134125,4.244123,4.083293,4.202457,2.6398749999999995,3.399580307692308,5.623277,3.176635,5.623277,3.707464,4.862452,2.454976,3.10997,1.216655,4.385777025000002,4.414804290000001,3.8082450399999987,3.8125406999999982,3.956580898605262,3.8814422736498,3.8936724615384586,4.268241945222669,3.5191029778542484,4.385777025000002,4.414804290000001,3.8082450399999987,3.8125406999999982,4.176624333333333,36307272,47435628.2,60.914155328668464,6.497105116928731,1.5,2.75,NaN,NaN,0.21894303481793398,0.7654008891148193,178.533086459146,0.05117174390673873,0.0698218873816443,0.018650143474905567,64.04442272175338,11.570770574962385,19.09070129131076,50.111337229754774,30.797961478934468,4319355624
1280842200,4.175792,4.209124,4.101626,4.143292,2.6194339999999996,3.366119076923077,5.623277,3.176635,5.623277,3.707464,4.862452,2.454976,3.10997,1.216655,4.382818720000002,4.4080543500000005,3.8128783199999985,3.8585402999999987,3.963902902581526,3.9063803428260093,3.9120056153846128,4.309612144057632,3.514399086711594,4.382818720000002,4.4080543500000005,3.8128783199999985,3.8585402999999987,4.151347333333334,31253148,45697739.6,58.6275329720278,4.666730623569187,1.5,2.75,NaN,NaN,0.2109826751880815,0.683910151214569,175.87904123648005,0.04972350605483111,0.08080452604344446,0.031081019988613345,64.62692290696607,14.509450163985976,20.67702281058856,47.96493349363121,31.35804369578025,4288102476
1280928600,4.179958,4.248291,4.141625,4.232457,2.5989929999999997,3.3326578461538467,5.623277,3.176635,5.623277,3.707464,4.862452,2.454976,3.10997,1.216655,4.380814565000001,4.4020702400000005,3.822028219999999,3.8934982999999983,3.974434435813623,3.9374352625568654,3.9625820769230744,4.342716967214534,3.5824471866316157,4.380814565000001,4.4020702400000005,3.822028219999999,3.8934982999999983,4.2074576666666665,31304208,44547984.2,61.0033745306226,5.279695110714436,1.5,2.75,NaN,NaN,0.20353148410321853,0.7027076210554999,180.14333608162335,0.05161613254260296,0.09560118566686704,0.04398505312426408,56.45654051890633,9.65022453588922,44.20296746459243,23.621643687315085,32.17538884809248,4319406684
1281015000,4.154958,4.225792,4.134125,4.22079,2.5785519999999997,3.2991966153846155,5.623277,3.176635,5.623277,3.707464,4.862452,2.454976,3.10997,1.216655,4.378164590000002,4.396061960000001,3.830811439999999,3.9228312999999977,3.9840954383307357,3.96442142802764,4.007132846153843,4.361226406369737,3.6530392859379495,4.378164590000002,4.396061960000001,3.830811439999999,3.9228312999999977,4.193569,25336368,43058227.6,60.51369808092281,4.09217270925228,1.5,2.75,NaN,NaN,0.19601723523870293,0.5884210617159727,177.9274587475747,0.048951027182284224,0.10517383710211936,0.05622280991983514,47.64498473755639,6.309255687362197,56.03936510000347,15.04659577763945,28.914039122357085,4294070316
1281101400,4.093292,4.194125,4.00821,4.168292,2.5581109999999994,3.265735384615385,5.623277,3.176635,5.623277,3.707464,4.862452,2.454976,3.10997,1.216655,4.375656290000002,4.388237040000001,3.839651359999999,3.945206149999998,3.9913188329060008,3.9838376729773888,4.038029999999997,4.372331678522211,3.703728321477784,4.375656290000002,4.388237040000001,3.839651359999999,3.945206149999998,4.123542333333333,38065964,42593577,58.24798702693676,1.750406978540953,1.5,2.75,NaN,NaN,0.19720028986450985,0.8937019776479445,176.3295231862167,0.04085162470032597,0.1072873407952426,0.06643571609491664,47.35354999042441,1.6459987129318585,24.778337063421322,42.79644196728303,32.42522096929565,4256004352
1281360600,4.234124,4.259124,4.163293,4.239124,2.5376699999999994,4.259124,5.623277,3.176635,5.623277,3.176635,4.862452,3.707464,3.10997,2.454976,4.3741354700000015,4.380195450000001,3.842434659999999,3.9709975999999982,4.001036682595961,4.008150656503352,4.085785923076921,4.332504123549833,3.8390677226040095,4.3741354700000015,4.380195450000001,3.842434659999999,3.9709975999999982,4.220513666666666,20139764,41558392.6,60.40222201486235,3.784076938683259,1.5,2.75,NaN,NaN,0.18995962630275912,0.4846136421551588,180.53434845673098,0.037548217486592136,0.11337098795315681,0.07582277046656467,44.83878227812016,3.7951580815964276,16.808262702926225,53.28100755170114,29.910729745372645,4276144116
1281447000,4.132459,4.227458,4.052459,4.155792,2.5172289999999995,4.255864235294117,5.623277,3.176635,5.623277,3.176635,4.862452,3.707464,3.10997,2.454976,4.3715563300000015,4.371612200000001,3.846251299999999,3.9837057999999983,4.00710551857259,4.022211736836366,4.108542076923074,4.319765278245512,3.8973188756006354,4.3715563300000015,4.371612200000001,3.846251299999999,3.9837057999999983,4.145236333333334,42093216,41002148.6,56.69597093348577,1.7692949043975392,1.5,2.75,NaN,NaN,0.18972429585256206,1.0266100055059066,175.9949585631373,0.02750005095021682,0.1101978341543357,0.08269778320411889,46.66327902844711,3.8309439694587777,14.440062953089104,56.908179342106514,28.65175770480439,4234050900
1281533400,3.963294,3.963294,3.794129,3.809962,2.4967879999999996,4.252604470588235,5.623277,3.176635,5.623277,3.176635,4.862452,3.707464,3.10997,2.454976,4.3680688650000015,4.360403980000001,3.8476846199999994,3.9793725499999986,3.9993744001971945,4.0019974761852835,4.096208846153844,4.352249499495452,3.8401681928122353,4.3680688650000015,4.360403980000001,3.8476846199999994,3.9793725499999986,3.8557950000000005,47680496,41530817,44.49424409850007,5.943043238090447,1.5,2.75,NaN,NaN,0.20200563186309337,1.1480750788023264,169.52441573209893,-0.00306354586385707,0.07886835087429755,0.08193189673815462,68.60197132785534,-3.340371881966506,1.6850317092983018,86.26461540711088,12.050352883590806,4186370404
1281619800,3.638297,3.784078,3.633298,3.745796,2.4763469999999996,4.249344705882353,5.623277,3.176635,5.623277,3.176635,4.862452,3.707464,3.10997,2.454976,4.365002230000003,4.347612440000001,3.84196802,3.9714142999999984,3.989430149209069,3.977597335596209,4.068901384615382,4.385680236809234,3.7521225324215295,4.365002230000003,4.347612440000001,3.84196802,3.9714142999999984,3.721057333333333,37217892,40374617,42.65975780169354,7.595804951901099,1.5,2.75,NaN,NaN,0.20019551530144386,0.921814119004522,167.16207681456606,-0.02690150177486343,0.04830501951957533,0.07520652129443876,68.70083272025107,-5.158772759589462,1.5336916325440837,86.92585450132037,11.540453866135554,4149152512
1281706200,3.704964,3.77663,3.698296,3.70413,2.4559059999999997,4.246084941176471,5.623277,3.176635,5.623277,3.176635,4.862452,3.707464,3.10997,2.454976,4.362056430000003,4.334454230000001,3.83433478,3.9778726499999992,3.9782419080636156,3.951552827444189,4.039670999999997,4.410886358791172,3.6684556412088205,4.362056430000003,4.334454230000001,3.83433478,3.9778726499999992,3.726352,34147036,39056138.6,41.464267218409475,6.375702443090278,1.5,2.75,NaN,NaN,0.19149112135134075,0.8743065040229041,165.25368081041967,-0.04377711982587827,0.02048512151209092,0.06426224133796919,68.6190625428132,-11.85799164631547,1.6836022269967639,86.27073046208174,12.045667310921505,4115005476
1281965400,3.633298,3.742454,3.595797,3.705796,2.4354649999999998,4.242825176470588,4.239124,3.176635,5.623277,3.176635,4.862452,3.707464,3.10997,2.454976,4.360418950000002,4.322104360000001,3.8350680999999995,3.981080949999999,3.9675577548062186,3.9281474153066473,4.016850692307689,4.428664926679215,3.6050364579361633,4.360418950000002,4.322104360000001,3.8350680999999995,3.981080949999999,3.6813489999999995,35453380,38882564,41.534818181987276,6.597583281630964,1.5,2.75,NaN,NaN,0.18828868411195926,0.9118066390889242,167.85914843417964,-0.05253910768544666,-0.0014116432688391356,0.051127464416607524,53.621788895196275,-10.559139930277661,3.5447146541329726,79.65218836910454,16.803096976762504,4150458856
1282051800,3.804128,3.928294,3.772462,3.845794,2.4150239999999994,4.239565411764706,4.239124,3.176635,5.623277,3.176635,4.862452,3.707464,3.10997,2.454976,4.3582106350000025,4.311462790000002,3.84180134,3.9850391999999992,3.9627827055981317,3.9203042328964903,4.00947892307692,4.429759401270279,3.589198444883562,4.3582106350000025,4.311462790000002,3.84180134,3.9850391999999992,3.84885,44110484,38608416,47.28459461630674,1.7046298374799307,1.5,2.75,NaN,NaN,0.19073220667539076,1.142509550249355,172.5007326246763,-0.046808539120848626,-0.007383209484453257,0.03942532963639537,60.65105964259554,-9.135662807678848,21.275369587655657,47.076913519970375,31.64771689237396,4194569340
1282138200,3.843295,3.934119,3.77663,3.873295,2.3945829999999995,4.236305647058823,4.239124,3.176635,5.623277,3.176635,4.862452,3.707464,3.10997,2.454976,4.357956475000002,4.301049560000001,3.8471029600000004,3.9977890999999994,3.9592733838099696,3.9158271630968247,4.003613615384612,4.429171205518952,3.578056025250272,4.357956475000002,4.301049560000001,3.8471029600000004,3.9977890999999994,3.861348,41848436,37555730.6,48.35897930279213,1.2182256490443986,1.5,2.75,NaN,NaN,0.18835769191286286,1.114302273752065,174.48954059500855,-0.03936733242797444,-0.00978383589857268,0.02958349652940176,58.71310789619062,-8.232937435882853,52.5097485359698,17.326875988652354,30.163375475377855,4236417776
1282224600,3.811629,3.843295,3.627464,3.67413,2.3741419999999995,4.233045882352941,4.239124,3.176635,5.623277,3.176635,4.862452,3.707464,3.10997,2.454976,4.356302325000002,4.287808030000001,3.84945296,3.9884975,3.9480912903272256,3.892808385659032,3.962973076923073,4.405386691482996,3.52055946236315,4.356302325000002,4.287808030000001,3.84945296,3.9884975,3.7149629999999996,55255728,38305554,41.726400757123685,5.344712428908657,1.5,2.75,NaN,NaN,0.19246292820480124,1.4424991216678396,169.78373797343028,-0.04561957972081532,-0.027440978121617388,0.01817860159919793,63.61116029310913,-11.855263498814386,45.07402215502904,22.840183794984828,32.08579404998612,4181162048
1282311000,3.638297,3.655797,3.55663,3.63913,2.3537009999999996,4.229786117647059,4.239124,3.176635,5.623277,3.176635,4.862452,3.707464,3.10997,2.454976,4.354244010000002,4.274091500000001,3.8447196799999994,3.9719393,3.9359751612947855,3.8686485394057906,3.924191384615381,4.384602251133229,3.4637805180975323,4.354244010000002,4.274091500000001,3.8447196799999994,3.9719393,3.6171856666666664,42709396,38315637.6,40.67073365032815,6.159690088995196,1.5,2.75,NaN,NaN,0.1871084333330297,1.1146727204664864,167.82475690215705,-0.049546262520471715,-0.04375422655139172,0.0057920359690799995,63.65641220260379,-14.153726100015005,42.12275282498882,25.25874135076203,32.618505824249155,4138452652
1282570200,3.69163,3.745796,3.589132,3.594131,2.3332599999999992,4.2265263529411765,4.239124,3.176635,5.623277,3.176635,4.862452,3.707464,3.10997,2.454976,4.351885705000002,4.260433310000002,3.8380030799999996,3.9466062,3.9225695079106764,3.8425040118433342,3.875089384615381,4.329638400043633,3.4205403691871292,4.351885705000002,4.260433310000002,3.8380030799999996,3.9466062,3.643019666666666,46253476,38733424.2,39.29426986381783,4.861817695238665,1.5,2.75,NaN,NaN,0.18493383095209898,1.1941489025388052,164.8045000886539,-0.05233467021462793,-0.05962630179920492,-0.007291631584576984,60.69088046741097,-13.515137427474714,19.40641805673061,49.57989778771207,31.0136841555573,4092199176
1282656600,3.469965,3.518298,3.372466,3.435799,2.3128189999999993,4.223266588235294,4.239124,3.176635,5.623277,3.176635,4.862452,3.707464,3.10997,2.454976,4.347544085000002,4.244108470000001,3.82828652,3.9141899,3.9034804683847675,3.803770201191588,3.814705461538458,4.2779928501712865,3.35141807290563,4.347544085000002,4.244108470000001,3.82828652,3.9141899,3.442187666666667,53073480,39425525,34.82784616466442,9.05032392757382,1.5,2.75,NaN,NaN,0.18755748588409188,1.3461705329225166,160.55334857916537,-0.061376822179569884,-0.08401265930903934,-0.022635837129469455,62.8774193862886,-9.820649129833846,4.026009389324695,78.22997752113534,17.74401308953998,4039125696
1282743000,3.3708,3.510657,3.304133,3.471632,3.304133,4.2200068235294115,4.239124,3.176635,5.623277,3.176635,4.862452,3.707464,3.10997,2.454976,4.343210795000002,4.226775300000001,3.8140033399999997,3.8876485,3.886545234330463,3.7721379915542936,3.761116230769227,4.209328715007643,3.3129037465308118,4.343210795000002,4.226775300000001,3.8140033399999997,3.8876485,3.4288073333333333,51903468,40164579.4,36.584653833414194,8.183933174733795,1.5,2.75,NaN,NaN,0.18891223689237102,1.292269675802954,163.106857569411,-0.061333648462671794,-0.0993028977078092,-0.03796924924513741,47.36104320458659,-7.31924536200049,4.833607281462388,76.00274515147838,19.16364756705923,4091029164
1282829400,3.524965,3.538299,3.3708,3.404133,3.3103171315789477,4.216747058823529,4.239124,3.176635,5.623277,3.176635,4.862452,3.707464,3.10997,2.454976,4.337052525000002,4.208367150000001,3.7985035199999997,3.8607738000000005,3.8676271074939743,3.7370898971205513,3.69688615384615,4.088420007096589,3.3053523005957115,4.337052525000002,4.208367150000001,3.7985035199999997,3.8607738000000005,3.437744,48914228,40021785.2,34.68778390265321,7.338921434257317,1.5,2.75,NaN,NaN,0.18738271997148734,1.2221900586283692,160.28011453360529,-0.06205284690422376,-0.1155353078754171,-0.053482460971193344,47.54197193974653,-8.098986806618566,5.290456700169363,74.81763595623964,19.891907343590994,4042114936
1282915800,3.464965,3.576464,3.314134,3.564964,3.316501263157895,4.213487294117646,4.239124,3.176635,5.623277,3.176635,4.862452,3.707464,3.10997,2.454976,4.331702575000001,4.192475630000001,3.78598698,3.8415448000000003,3.8557579660236225,3.7206969545376416,3.6514378461538426,3.944000902125184,3.3588747901825013,4.331702575000001,4.192475630000001,3.78598698,3.8415448000000003,3.4851873333333336,61573128,41232028.4,42.35686454997015,4.7346318984856275,1.5,2.75,NaN,NaN,0.1927360971163811,1.4933324987717558,165.48385812533047,-0.048499265704781996,-0.11410654310217083,-0.06560727739738884,57.208241234566884,-3.800317124849832,25.010604493057453,42.42186504534548,32.56753046159708,4103688064
1283175000,3.536631,3.573298,3.409966,3.410798,3.322685394736842,4.210227529411765,4.239124,3.176635,5.623277,3.176635,4.862452,3.707464,3.10997,2.454976,4.325223050000002,4.17455914,3.7701538,3.8019618500000005,3.8383085555913237,3.6911827683911995,3.6207329230769196,3.9238952501848816,3.3175705959689576,4.325223050000002,4.17455914,3.7701538,3.8019618500000005,3.464687333333334,47651360,41799232.8,37.7776842600837,4.670560775991775,1.5,2.75,NaN,NaN,0.19063580446521103,1.1400056127345954,160.6339996984727,-0.04670211687140105,-0.12398492348664014,-0.07728280661523909,61.550018298464984,-11.310954252879897,27.213209776457006,39.95834336935987,32.82844685418313,4056036704
1283261400,3.369132,3.474965,3.329133,3.427466,3.3288695263157897,4.206967764705882,4.239124,3.176635,5.623277,3.176635,4.862452,3.707464,3.10997,2.454976,4.319539775000002,4.15583432,3.75563728,3.7661705500000004,3.8221970828230365,3.666066885687276,3.5962459999999967,3.906390108935976,3.2861018910640176,4.319539775000002,4.15583432,3.75563728,3.7661705500000004,3.410521333333333,49653820,42719266.4,38.551178471280565,5.490061154864369,1.5,2.75,NaN,NaN,0.18743553271769595,1.162328480434767,162.388328602331,-0.041359211244773264,-0.12898182067120567,-0.08762260942643241,55.337925456781704,-11.51032906091584,54.24707312980016,16.221288414485084,29.53163845571477,4105690524
1283347800,3.550798,3.728297,3.543298,3.71413,3.335053657894737,4.203708,4.239124,3.176635,5.623277,3.176635,4.862452,3.707464,3.10997,2.454976,4.314914825000002,4.139609500000001,3.7510440000000007,3.7402542000000003,3.8179591580064467,3.6706443251456307,3.5970152307692276,3.9082734390353195,3.2857570225031356,4.314914825000002,4.139609500000001,3.7510440000000007,3.7402542000000003,3.661908333333333,45654552,43436783.6,50.05145078433841,2.39781117795301,1.5,2.75,NaN,NaN,0.19553520895214624,1.051057380777153,168.73110159454578,-0.01674919792589416,-0.1085591068338001,-0.09180990890790594,76.27876809354542,1.0886931055787366,53.61282531448129,16.64643805657776,29.740736628940947,4151345076
1283434200,3.738296,3.826628,3.718296,3.822462,3.3412377894736847,4.200448235294117,4.239124,3.176635,5.623277,3.176635,4.862452,3.707464,3.10997,2.454976,4.309781545000002,4.1243846500000005,3.749394020000001,3.7203378000000007,3.8181357400454097,3.685103151322237,3.6059895384615355,3.9354699817299923,3.2765090951930786,4.309781545000002,4.1243846500000005,3.749394020000001,3.7203378000000007,3.7891286666666666,31718020,43755866.2,53.58658856008867,4.15800631607808,1.5,2.75,NaN,NaN,0.18960397974127866,0.7248861182412153,172.45562747353438,0.007304410850445531,-0.08267939534484903,-0.08998380619529456,71.48494518455541,5.037797495555246,78.34793427388598,4.00881638385792,17.643249342256095,4183063096
1283520600,3.940793,3.989127,3.878294,3.971627,3.3474219210526317,4.197188470588235,4.239124,3.176635,5.623277,3.176635,4.862452,3.707464,3.10997,2.454976,4.305327420000001,4.108851470000001,3.7546439800000013,3.710504550000001,3.824155005141668,3.7123911369105955,3.615668999999997,3.978469223024269,3.252868776975725,4.305327420000001,4.108851470000001,3.7546439800000013,3.710504550000001,3.9463493333333335,37805920,43742864,57.99497417645112,6.692655202576844,1.5,2.75,NaN,NaN,0.1879654811883302,0.8642762851559057,176.9154754420686,0.032337564556917095,-0.049561850499148186,-0.08189941505606528,73.41461249453452,10.503123008037266,76.09276145992649,4.827247446099468,19.079991093974037,4220869016
1283866200,3.914128,3.932461,3.828295,3.841629,3.353606052631579,4.193928705882353,4.239124,3.176635,5.623277,3.176635,4.862452,3.707464,3.10997,2.454976,4.300306645000002,4.091809980000001,3.7562773200000015,3.690629800000001,3.824840259841995,3.7246995048238722,3.6132331538461506,3.9694472805282706,3.2570190271640307,4.300306645000002,4.091809980000001,3.7562773200000015,3.690629800000001,3.867461666666667,34041160,44437933.8,53.24823142900457,4.1187283126588925,1.5,2.75,NaN,NaN,0.18477737538916375,0.7660383165699752,172.9411258669237,0.038783164430865325,-0.033420459517483625,-0.07220362394834895,76.5152595601047,11.81180854875388,79.54200155724872,3.581470436310107,16.87652800644118,4186827856
1283952600,3.859128,3.96246,3.854961,3.914961,3.3597901842105267,4.190668941176471,4.239124,3.176635,5.623277,3.176635,4.862452,3.707464,3.10997,2.454976,4.296669180000001,4.078097620000001,3.7602939400000013,3.6785882500000007,3.828374406514858,3.742819647221599,3.631758615384612,4.022126252757414,3.24139097801181,4.296669180000001,4.078097620000001,3.7602939400000013,3.6785882500000007,3.9107939999999997,32116364,43939091.2,55.46270603619622,4.649962829126422,1.5,2.75,NaN,NaN,0.1802097771470806,0.7309291822585533,176.24415477990644,0.04612820757438487,-0.01454336448036786,-0.06067157205475273,69.16620806223595,12.770045903482854,78.05295577270839,4.08740509332388,17.859639133967747,4218944220
1284039000,4.048293,4.054125,3.934961,3.965794,3.365974315789474,4.187409176470588,4.239124,3.176635,5.623277,3.176635,4.862452,3.707464,3.10997,2.454976,4.2961733550000005,4.064456080000001,3.7722438200000012,3.6863798500000007,3.833763410180942,3.764055299867161,3.6568866153846122,4.086044749364322,3.227728481404902,4.2961733550000005,4.064456080000001,3.7722438200000012,3.6863798500000007,3.9849599999999996,25674772,42838805,56.98375113503534,5.393181735679665,1.5,2.75,NaN,NaN,0.17727793592228913,0.5993344585592432,179.1662193819407,0.052110995901396,0.004467172821992271,-0.04764382307940373,69.14563008473705,16.499384718517167,75.3332289203726,5.08899333554759,19.577777744079814,4244618992
1284125400,3.987461,4.03996,3.964128,4.026627,3.372158447368421,4.184149411764706,4.239124,3.176635,5.623277,3.176635,4.862452,3.707464,3.10997,2.454976,4.295290035000001,4.049964560000001,3.787610320000001,3.700421400000001,3.8413266882130617,3.7890621284512407,3.690155538461535,4.159838015975287,3.220473060947784,4.295290035000001,4.049964560000001,3.787610320000001,3.700421400000001,4.010238333333334,25531500,42254485.4,58.7972714243561,5.3193606967874905,1.5,2.75,NaN,NaN,0.1700317976421256,0.6042317107475649,181.88234870334017,0.05744572678803629,0.02416333540564164,-0.03328239138239465,65.89387511259235,12.95000454422543,74.47741910395722,5.424634044364756,20.09794685167803,4270150492
1284384600,4.143292,4.186626,4.104126,4.165793,3.3783425789473687,4.180889647058823,4.239124,3.176635,5.623277,3.176635,4.862452,3.707464,3.10997,2.454976,4.295046295000001,4.037014700000001,3.8063435000000014,3.7235045500000004,3.8540508573027457,3.824941259074932,3.7463089230769198,4.253942167057991,3.2386756790958486,4.295046295000001,4.037014700000001,3.8063435000000014,3.7235045500000004,4.152181666666667,37714972,42432882.2,62.67411752112704,7.047061901524032,1.5,2.75,NaN,NaN,0.1693151692391166,0.8888147597949403,186.24770527848602,0.06696271104611241,0.05042099742524586,-0.01654171362086655,64.2613128687593,22.135435754330793,73.37761724170657,5.904925938671975,20.717456819621464,4307865464
1284471000,4.139958,4.229957,4.094126,4.159958,3.384526710526316,4.1776298823529405,4.239124,3.176635,4.239124,3.176635,5.623277,3.707464,4.862452,2.454976,4.294500465,4.023489750000001,3.8260099600000013,3.7462126500000004,3.866047215839893,3.85684761535351,3.799257076923074,4.324529157221077,3.273984996625071,4.294500465,4.023489750000001,3.8260099600000013,3.7462126500000004,4.161347,37859128,42553169.6,62.40896730907953,6.8954139148465305,1.5,2.75,NaN,NaN,0.16692344286489397,0.8896899656565183,184.6767533669824,0.06919590801795011,0.06995317140157109,0.0007572633836209798,53.510039939669205,21.371240444106512,68.64631712047446,8.012123841485309,23.341559038040216,4270006336
1284557400,4.123292,4.221458,4.085792,4.206625,3.3907108421052636,4.174370117647059,4.239124,3.176635,4.239124,3.176635,5.623277,3.707464,4.862452,2.454976,4.29521713,4.0093232300000015,3.8456764600000013,3.7642542000000008,3.8794032073755838,3.890159747224604,3.860987230769228,4.374496304488568,3.347478157049888,4.29521713,4.0093232300000015,3.8456764600000013,3.7642542000000008,4.171291666666666,28318540,41763572.4,63.730561994219684,5.874630512692993,1.5,2.75,NaN,NaN,0.16469076837454444,0.6780679518689834,186.00172716127253,0.06993954386822474,0.0881816932189019,0.018242149350677167,52.98675435929789,13.260036670768118,68.2758911584849,8.189437507617585,23.53467133389752,4298324876
1284643800,4.164958,4.211624,4.131625,4.203291,3.3968949736842107,4.171110352941176,4.239124,3.176635,4.239124,3.176635,5.623277,3.707464,4.862452,2.454976,4.29572962,3.9956858700000013,3.8590763400000014,3.780754000000001,3.8921046894392863,3.9199817712984513,3.910089307692305,4.423058502866611,3.3971201125179995,4.29572962,3.9956858700000013,3.8590763400000014,3.780754000000001,4.18218,27739692,41058135.2,63.55864095611415,4.914524164533104,1.5,2.75,NaN,NaN,0.15864135634779128,0.6756198708216051,183.73950545268085,0.06636021566868908,0.10119241893653852,0.03483220326784944,37.758416386438114,9.962924418869314,42.63071378739464,24.925539685926775,32.443746526678574,4270585184
1284730200,4.267458,4.277457,4.172459,4.208291,3.403079105263158,4.167850588235294,4.239124,3.176635,4.239124,3.176635,5.623277,3.707464,4.862452,2.454976,4.295533785,3.9860526300000014,3.8705595600000016,3.8074620500000007,3.90450415259853,3.947439793079551,3.9714349230769206,4.4172380099630555,3.5256318361907852,4.295533785,3.9860526300000014,3.8705595600000016,3.8074620500000007,4.219402333333334,29963576,39793527.6,63.71672094540809,4.869345352737108,1.5,2.75,NaN,NaN,0.15480968803723477,0.752976119664244,186.19836230323037,0.06063957970669802,0.11063167790122197,0.04999209819452395,36.684001598383794,5.9588677385867355,44.72389216476072,23.209627515428775,32.0664803198105,4300548760
1284989400,4.254957,4.429122,4.224124,4.401623,3.4092632368421056,4.164590823529411,4.239124,3.176635,4.239124,3.176635,5.623277,3.707464,4.862452,2.454976,4.296212945,3.9772610500000014,3.884176120000001,3.845586700000001,3.923999009359372,3.9906953365957842,4.046370076923075,4.423430473019355,3.669309680826794,4.296212945,3.9772610500000014,3.884176120000001,3.845586700000001,4.351623,24888836,38902499.6,69.26798398396764,7.251107385961399,1.5,2.75,NaN,NaN,0.1595254960345751,0.6397747254266407,192.22444938277013,0.06575739710708652,0.1321888445783821,0.06643144747129558,38.71734225285657,14.57699324947827,43.209549215720955,24.37545500723442,32.41499577704462,4325437596
1285075800,4.418289,4.472455,4.324123,4.375789,3.415447368421053,4.161331058823529,4.239124,3.176635,4.239124,3.176635,5.623277,3.707464,4.862452,2.454976,4.297283765,3.9662195000000016,3.897226000000001,3.884669600000001,3.941716263894299,4.027370923586662,4.097266923076921,4.459535104370165,3.7349987417836767,4.297283765,3.9662195000000016,3.897226000000001,3.884669600000001,4.390789000000001,50539164,39116784,67.77576587521432,6.361983943033915,1.5,2.75,NaN,NaN,0.15872596060353403,1.2920071343288344,189.26382341476116,0.0632637261367358,0.14551110514221532,0.08224737900547953,29.5717267688132,11.770947398965156,35.9584532718276,30.801274054264255,33.24027267390813,4274898432
1285162200,4.345789,4.416623,4.261708,4.299124,3.4216315,4.158071294117646,4.239124,3.176635,4.239124,3.176635,5.623277,3.707464,4.862452,2.454976,4.297607095,3.9571145900000015,3.9051759200000014,3.927835850000001,3.9557322535455026,4.053252168959361,4.1339332307692285,4.4732879861626,3.7945784753758574,4.297607095,3.9571145900000015,3.9051759200000014,3.927835850000001,4.325818333333333,29385304,37932375.2,63.410120028876904,4.32171887714762,1.5,2.75,NaN,NaN,0.1584537491318531,0.7746760872490789,186.1163376456644,0.05274193756918394,0.14817480096695945,0.09543286339777551,34.01265338527941,8.405126438740897,15.202501473821705,55.72606478352975,29.071433742648544,4245513128
1285248600,4.186626,4.329958,4.162458,4.195457,3.4278156315789476,4.154811529411765,4.239124,3.176635,4.239124,3.176635,5.623277,3.707464,4.862452,2.454976,4.297517925,3.9450030300000014,3.9111525200000017,3.9640271000000014,3.9651332239946986,4.066795486201326,4.15115092307692,4.478312792253878,3.8239890538999624,4.297517925,3.9450030300000014,3.9111525200000017,3.9640271000000014,4.229291,34356244,37055014,57.972324693973334,1.938989587886892,1.5,2.75,NaN,NaN,0.15909990990814935,0.9271685607783066,182.17341149029875,0.03589643586261011,0.14030340822603815,0.10440697236342804,38.95790647110479,4.192839316877372,14.00686323277055,57.61845578935424,28.374680977875197,4211156884
1285335000,4.336622,4.463281,4.326708,4.446622,3.433999763157895,4.151551764705882,4.239124,3.176635,4.239124,3.176635,5.623277,3.707464,4.862452,2.454976,4.2993512350000005,3.9392530900000016,3.921985740000001,4.016151550000002,3.9840151367792203,4.102969439896438,4.197688846153843,4.507133811723188,3.8882438805844988,4.2993512350000005,3.9392530900000016,3.921985740000001,4.016151550000002,4.412203666666667,25626196,35890612.4,65.6567146191951,5.743845968904745,1.5,2.75,NaN,NaN,0.16686591634328155,0.7140083238033575,187.38192101112824,0.038533156355826007,0.15257341780821054,0.11404026145238454,49.22817468476781,6.7413095177796825,12.972411117165766,59.32041769383392,27.707171189000317,4236783080
1285594200,4.464955,4.477455,4.385798,4.399956,3.4401838947368426,4.148292,4.239124,3.176635,4.239124,3.176635,5.623277,3.707464,4.862452,2.454976,4.30073872,3.9340948000000013,3.9384856000000013,4.057901150000001,4.000326543180035,4.131253874192016,4.234996153846152,4.514606165589262,3.955386142103041,4.30073872,3.9340948000000013,3.9384856000000013,4.057901150000001,4.421069666666667,22155124,33919712.2,63.339456059633214,4.888072568888719,1.5,2.75,NaN,NaN,0.16149385089018997,0.653163678670599,185.15225095225662,0.03414803155500776,0.15672530089614423,0.12257726934113647,47.88308096605139,5.769240939451813,3.2795178159098133,80.51500188625411,16.205480297836083,4214627956
1285680600,4.419122,4.486622,4.272457,4.454956,3.44636802631579,4.145032235294117,4.239124,3.176635,4.239124,3.176635,5.623277,3.707464,4.862452,2.454976,4.30202621,3.9344280500000015,3.9547521200000015,4.110109050000001,4.018155149329838,4.16208264807849,4.272623999999998,4.527784364339458,4.017463635660538,4.30202621,3.9344280500000015,3.9547521200000015,4.110109050000001,4.404678333333333,49813804,34027834.4,64.91129998965681,3.9853809721086035,1.5,2.75,NaN,NaN,0.16525607582660493,1.4639134367011026,188.6163525673944,0.03200188198610776,0.16257962182377117,0.1305777398376634,47.81458605908614,5.903331055180823,31.75023567119909,35.00324748136297,33.24651684743794,4264441760
1285767000,4.41579,4.479113,4.375789,4.424957,3.452552157894737,4.141772470588235,4.239124,3.176635,4.239124,3.176635,5.623277,3.707464,4.862452,2.454976,4.302859535,3.9366530500000017,3.967918680000002,4.159983600000002,4.034108163081609,4.187118300642443,4.303264769230767,4.526584353093692,4.0799451853678415,4.302859535,3.9366530500000017,3.967918680000002,4.159983600000002,4.426619666666666,36462508,33368268.8,63.316679210491884,3.5349839734099144,1.5,2.75,NaN,NaN,0.16083235612470453,1.09272998903677,190.28473656235454,0.025874207053962817,0.16292049865511693,0.1370462916011541,48.325448901434505,5.273629639251718,28.8265334147136,38.11606333866886,33.05740324661752,4227979252
1285853400,4.501622,4.580788,4.331623,4.395789,3.4587362894736846,4.138512705882353,4.239124,3.176635,4.239124,3.176635,5.623277,3.707464,4.862452,2.454976,4.303097035,3.9329280800000017,3.983468520000002,4.194066550000001,4.048291725313703,4.206991700581258,4.320956769230767,4.534120466137308,4.107793072324226,4.303097035,3.9329280800000017,3.983468520000002,4.194066550000001,4.436066666666666,49335300,33552306.2,61.728828371670886,3.2046960966601556,1.5,2.75,NaN,NaN,0.16714183068722568,1.4703996710664258,190.90791351520429,0.017566271931488242,0.1590041315155144,0.14143785958402616,48.69648687129345,4.455442838910135,23.830252637687156,43.90980518623218,32.25994217608065,4178643952
1285939800,4.487456,4.505789,4.369956,4.44579,3.464920421052632,4.1352529411764705,4.239124,3.176635,4.239124,3.176635,5.623277,3.707464,4.862452,2.454976,4.303855365,3.929994790000001,3.9951850800000015,4.225232950000001,4.06387989294846,4.2297343957639955,4.342943846153844,4.543753053034169,4.142134639273519,4.303855365,3.929994790000001,3.9951850800000015,4.225232950000001,4.440511666666667,38604648,33896637.6,63.42225067384267,2.943911081329882,1.5,2.75,NaN,NaN,0.16490548563813814,1.138893139064625,194.08655687124562,0.013339651187463497,0.15811242356835553,0.14477277238089203,48.79241489046349,1.0034253274303557,28.59253313879954,38.37351062406994,33.03395623713052,4217248600
1286199000,4.429122,4.472455,4.279125,4.345373,3.4711045526315796,4.131993176470588,4.239124,3.176635,4.239124,3.176635,5.623277,3.707464,4.862452,2.454976,4.3039657799999995,3.923990670000001,4.002686660000002,4.243920250000001,4.07491883832303,4.240747596167425,4.353616769230767,4.538421300757215,4.168812237704318,4.3039657799999995,3.923990670000001,4.002686660000002,4.243920250000001,4.365651000000001,28557896,33434236.4,57.882921242556165,1.0320752418323018,1.5,2.75,NaN,NaN,0.1669358080925569,0.8541512854769431,190.05838228761715,0.002262956551698808,0.14760146807051555,0.14533851151881674,44.031729233533724,-0.6950975012734795,27.15202046658061,40.012270899439145,32.83570863398027,4188690704
1286285400,4.466623,4.635787,4.447456,4.60512,3.4772886842105266,4.128733411764705,4.239124,3.176635,4.239124,3.176635,5.623277,3.707464,4.862452,2.454976,4.306129085,3.9223173500000015,4.012773200000002,4.282094800000001,4.095711040741735,4.275449729865765,4.3845266923076895,4.591506333111595,4.177547051503784,4.306129085,3.9223173500000015,4.012773200000002,4.282094800000001,4.562787666666666,31067660,33285561.4,66.12478735783733,5.3626352227421945,1.5,2.75,NaN,NaN,0.1757556789430885,0.933367463046605,195.14772492205475,0.010453094280246655,0.15840487936912506,0.1479517850888784,55.382506264668926,7.11763605795042,20.76016397574452,47.84368454625151,31.396151478003976,4219758364
1286371800,4.604121,4.636538,4.540789,4.596204,3.483472815789474,4.125473647058823,4.239124,3.176635,4.239124,3.176635,5.623277,3.707464,4.862452,2.454976,4.307926985,3.9232131700000012,4.023014780000001,4.316156950000002,4.115338215614608,4.305997755592835,4.414366153846151,4.6229548225801285,4.205777485112174,4.307926985,3.9232131700000012,4.023014780000001,4.316156950000002,4.591177,23880920,32873789.2,65.64988373930082,4.269095105589052,1.5,2.75,NaN,NaN,0.1700409161614393,0.7264425726742813,193.86544930065708,0.013120698990330387,0.1643526588267914,0.151231959836461,53.729250972183685,9.551927239392512,23.738391289054253,44.0481044509446,32.213504260001145,4195877444
1286458200,4.65662,4.65912,4.497455,4.580788,3.4896569473684216,4.12221388235294,4.239124,3.176635,4.239124,3.176635,5.623277,3.707464,4.862452,2.454976,4.309006145,3.9238715100000015,4.034581340000002,4.346906650000001,4.133591148335604,4.332168255060184,4.428148076923074,4.65446957120324,4.201826582642909,4.309006145,3.9238715100000015,4.034581340000002,4.346906650000001,4.579121,26495148,32914808,64.78353616163702,3.4407521152671614,1.5,2.75,NaN,NaN,0.16944263643562213,0.8049613414120478,192.37837764339872,0.011742327204916664,0.16590986884260683,0.15416754163769017,50.54343336279269,3.017256695082255,31.036119211813787,35.770842488166984,33.19303830001923,4169382296
1286544600,4.594121,4.699952,4.549121,4.66162,3.495841078947369,4.118954117647059,4.239124,3.176635,4.239124,3.176635,5.623277,3.707464,4.862452,2.454976,4.3102269699999995,3.927171480000002,4.048981200000001,4.378656300000001,4.154298162126365,4.363544611721119,4.4501350769230745,4.705509740291909,4.19476041355424,4.3102269699999995,3.927171480000002,4.048981200000001,4.378656300000001,4.636897666666666,27531644,33014815.2,67.22576876068138,4.538246248861377,1.5,2.75,NaN,NaN,0.16811323383307766,0.8339178587920735,195.97141395130183,0.01401583163055184,0.17168733117587998,0.15767149954532814,40.4085862108969,5.946968560594689,26.388246449855668,40.88860253891273,32.72315101123162,4196913940
1286803800,4.685786,4.714953,4.63412,4.679953,3.502025210526316,4.115694352941176,4.239124,3.176635,4.239124,3.176635,5.623277,3.707464,4.862452,2.454976,4.311343624999999,3.9315006000000015,4.063589380000002,4.404364300000001,4.174912077337096,4.393678743938155,4.479429615384612,4.745921603066781,4.212937627702444,4.311343624999999,3.9315006000000015,4.063589380000002,4.404364300000001,4.676342000000001,16541948,31956164,67.77166987331273,4.1449322838498714,1.5,2.75,NaN,NaN,0.16187893141642928,0.5176449839223506,197.45697665671824,0.014438595371555757,0.17571974375977284,0.16128114838821708,39.24674872740616,5.050487591796644,48.97408276794572,19.888228680781857,31.13768855127243,4213455888
1286890200,4.63412,4.762452,4.553288,4.726619,3.5082093421052636,4.112434588235294,4.239124,3.176635,4.239124,3.176635,5.623277,3.707464,4.862452,2.454976,4.312343609999999,3.941158830000002,4.074072620000001,4.432697350000001,4.196547642931719,4.425387339753569,4.5202882307692285,4.761801431608824,4.2787750299296325,4.312343609999999,3.941158830000002,4.074072620000001,4.432697350000001,4.680786333333333,29330644,31529739.8,69.17895019481762,4.037232896009041,1.5,2.75,NaN,NaN,0.16525643631525572,0.9302532842342073,199.24316706943358,0.01545442612181841,0.1805991810404901,0.1651447549186717,39.12731156317598,6.817286586061748,48.529253170807046,20.218492413845325,31.25225441534763,4242786532
1286976600,4.808285,4.907451,4.769953,4.828285,3.514393473684211,4.109174823529411,4.239124,3.176635,4.239124,3.176635,5.623277,3.707464,4.862452,2.454976,4.313781089999999,3.9503254000000014,4.087772480000001,4.46378035,4.221321656934397,4.4637585454913244,4.549646923076921,4.836699962830323,4.262593883323518,4.313781089999999,3.9503254000000014,4.087772480000001,4.46378035,4.835229666666667,19457112,31086668.4,72.0430757024884,6.049463764135789,1.5,2.75,NaN,NaN,0.1663689765784517,0.6258989142754198,203.32667046725265,0.020263476004087677,0.19047409992378128,0.1702106239196936,39.1119015198982,9.838870792023922,74.81651377990272,5.305584897112399,19.8779013229849,4262243644
1287063000,4.821618,4.844118,4.688286,4.783285,3.5205776052631585,4.105915058823529,4.239124,3.176635,4.239124,3.176635,5.623277,3.707464,4.862452,2.454976,4.31508941,3.960408630000001,4.098789040000001,4.49278005,4.243359435093833,4.4941896363969125,4.579133769230767,4.877165476418653,4.281102062042881,4.31508941,3.960408630000001,4.098789040000001,4.49278005,4.771896333333333,29529544,31176161,68.9872073355541,3.6608282788891167,1.5,2.75,NaN,NaN,0.1656163353942766,0.9471834585406459,200.85130160981097,0.017791877767850683,0.19245047112950697,0.1746585933616563,39.535006286427155,7.591339222050537,71.16145020990095,6.834921048919483,22.00362874117959,4232714100
1287149400,4.876618,4.882451,4.694953,4.804118,3.526761736842106,4.102655294117646,4.239124,3.176635,4.239124,3.176635,5.623277,3.707464,4.862452,2.454976,4.3165727249999994,3.970633520000001,4.110455600000001,4.5225714,4.265349967050938,4.5237066234067305,4.605992384615382,4.91706704691174,4.294917722319024,4.3165727249999994,3.970633520000001,4.110455600000001,4.5225714,4.793840666666667,27841308,31070047.6,69.62947879793906,3.4852116642604187,1.5,2.75,NaN,NaN,0.16717931143754253,0.8960819229642892,198.3852049667207,0.015047232577942132,0.19346763408408396,0.17842040150614183,39.552465524465326,10.55709141654812,71.4716159636956,6.698321926387385,21.830062109917005,4260555408
1287408600,4.809119,4.911618,4.781619,4.834117,3.532945868421053,4.0993955294117645,4.239124,3.176635,4.239124,3.176635,5.623277,3.707464,4.862452,2.454976,4.318864364999999,3.981711730000001,4.1237721,4.544196100000001,4.287654556578352,4.553269516415614,4.637466230769228,4.951684865440795,4.32324759609766,4.318864364999999,3.981711730000001,4.1237721,4.544196100000001,4.842451333333333,15811632,30616187.4,70.57449936000216,4.658222101259115,1.5,2.75,NaN,NaN,0.16452357490628947,0.5164467996429889,201.82545119593846,0.012825982703202732,0.19445287988514526,0.18162689718194253,34.53525807184372,4.97266086442915,72.64007268671185,6.260160147621633,21.099767165666528,4276367040
1287495000,4.730786,4.812452,4.585787,4.670787,3.5391300000000006,4.096135764705882,4.239124,3.176635,4.239124,3.176635,5.623277,3.707464,4.862452,2.454976,4.319218529999999,3.9874200100000015,4.13240536,4.558946000000001,4.3026793582811615,4.564461657709365,4.65861992307692,4.940246274242881,4.376993571910958,4.319218529999999,3.9874200100000015,4.13240536,4.558946000000001,4.689675333333334,37652620,29971860.2,59.68520855175677,0.7098151212241945,1.5,2.75,NaN,NaN,0.1705097481272688,1.25626570218688,196.77034941120118,-0.0013178096761812252,0.179979635086716,0.18129744476289722,28.301074229482428,1.622708652618544,34.84238332637902,32.078306231368394,33.07931044225258,4238714420
1287581400,4.704954,4.876618,4.687453,4.809119,3.545314131578948,4.0928759999999995,4.239124,3.176635,4.239124,3.176635,5.623277,3.707464,4.862452,2.454976,4.320047689999999,3.9958616000000013,4.1454719,4.58444575,4.322539736387783,4.58776235697514,4.686568307692304,4.949666705661153,4.423469909723455,4.320047689999999,3.9958616000000013,4.1454719,4.58444575,4.791063333333333,25962508,29800720.4,64.65884368702899,3.333370499493816,1.5,2.75,NaN,NaN,0.17303269468960675,0.8712040397520056,201.17640584903006,-0.002938612094027876,0.17762417964536237,0.18056279173939024,32.295105193515795,4.9845354118112395,38.16178161886516,28.950238404995318,32.88797997613951,4264676928
1287667800,4.876618,4.95765,4.726619,4.840785,3.5514982631578955,4.089616235294117,4.239124,3.176635,4.239124,3.176635,5.623277,3.707464,4.862452,2.454976,4.320972679999999,4.006886490000001,4.166088360000001,4.61671215,4.34286308005885,4.611859751548936,4.724676923076919,4.911518342982368,4.537835503171471,4.320972679999999,4.006886490000001,4.166088360000001,4.61671215,4.841684666666667,37838380,29974827.2,65.70196304172356,2.8700980216331344,1.5,2.75,NaN,NaN,0.17717543078320624,1.2623385531977311,200.80879853798317,-0.003425759111013782,0.17628059285062303,0.1797063519616368,31.908939905770364,3.843406369459549,71.09635922033179,6.934206531074203,21.969434248594013,4302515308
1287754200,4.859118,4.890534,4.825785,4.875784,3.5576823947368426,4.0863564705882345,4.239124,3.176635,4.239124,3.176635,5.623277,3.707464,4.862452,2.454976,4.321799334999998,4.015328070000001,4.18868812,4.63817025,4.363761939664385,4.636995394258561,4.745497230769227,4.934714859403403,4.556279602135051,4.321799334999998,4.015328070000001,4.18868812,4.63817025,4.864034333333333,15237488,29455391.8,66.86601931377281,2.800897486236962,1.5,2.75,NaN,NaN,0.16914497144154866,0.517307259175551,203.0253371634668,-0.002956303562214435,0.17601097250886877,0.1789672760710832,31.032914324705512,4.184465100397378,67.86506268333243,8.446002424815589,23.688934891851993,4317752796
1288013400,4.965784,5.049116,4.912451,4.923702,3.56386652631579,4.083096705882353,4.239124,3.176635,4.239124,3.176635,5.623277,3.707464,4.862452,2.454976,4.322613914999998,4.023707170000001,4.213079560000001,4.66435755,4.3857203734030366,4.664300785281555,4.770689384615381,4.9608948215085364,4.580483947722226,4.322613914999998,4.023707170000001,4.213079560000001,4.66435755,4.961756333333333,22070020,29451136.6,68.44508243910494,4.189010052875424,1.5,2.75,NaN,NaN,0.16944404491000942,0.7493775299660251,205.46242434684655,-0.001080679280582142,0.1776164269703555,0.17869710625093765,31.174986910461637,4.1696400746495375,68.264984388967,8.166837126421695,23.568178484611316,4339822816
1288099800,4.849118,4.944951,4.814952,4.922452,3.5700506578947375,4.07983694117647,4.239124,3.176635,4.239124,3.176635,5.623277,3.707464,4.862452,2.454976,4.323330574999998,4.036240390000001,4.23741268,4.687732349999999,4.406768672485271,4.688886615254741,4.796971230769227,4.968452242583998,4.625490218954456,4.323330574999998,4.036240390000001,4.23741268,4.687732349999999,4.894118333333333,16191892,27770041,68.3535693768027,2.8096789586622313,1.5,2.75,NaN,NaN,0.16662654170215158,0.5830705111310422,203.91873437687062,-0.0015573428112973797,0.17675042773681593,0.1783077705481133,31.143323915689592,1.9503198340611556,84.67122011932003,2.080555789254566,13.248224091425405,4323630924
1288186200,4.818286,4.903284,4.752452,4.88995,3.576234789473685,4.076577176470588,4.239124,3.176635,4.239124,3.176635,5.623277,3.707464,4.862452,2.454976,4.324584724999998,4.05004857,4.2582958,4.710982,4.425716959838789,4.708035509040004,4.8145350769230735,4.973264056834331,4.655806097011816,4.324584724999998,4.05004857,4.2582958,4.710982,4.848562,23555344,27124682.8,65.88682485260577,1.0922466270911182,1.5,2.75,NaN,NaN,0.16686750300914074,0.8684099339956152,200.8950185927968,-0.005474267411820749,0.17146493628333737,0.17693920369515811,29.578666239314035,2.2299528462134193,56.266681445478504,14.865448800122381,28.86786975439912,4300075580
1288272600,4.973283,4.981617,4.823285,4.894952,3.582418921052632,4.073317411764705,4.239124,3.176635,4.239124,3.176635,5.623277,3.707464,4.862452,2.454976,4.325268049999998,4.062915950000001,4.27872894,4.735940149999999,4.444118333962758,4.725837079607622,4.831073461538458,4.974313120197247,4.687833802879669,4.325268049999998,4.062915950000001,4.27872894,4.735940149999999,4.899951333333333,20334440,25674639.8,66.0896461614641,1.8497108770189186,1.5,2.75,NaN,NaN,0.16625782422277352,0.7920048794608601,201.33431627790378,-0.008936254715416397,0.16576888530088763,0.17470514001630402,28.804796630876666,1.8907528915817655,47.42216082253335,21.044911487685916,31.532927689780717,4320410020
1288359000,4.872451,4.934118,4.857451,4.913285,3.5886030526315795,4.070057647058823,4.239124,3.176635,4.239124,3.176635,5.623277,3.707464,4.862452,2.454976,4.325851379999998,4.076482500000001,4.30351204,4.7593149,4.462517026748532,4.7436892625021345,4.845432384615382,4.9811355438973255,4.709729225333438,4.325851379999998,4.076482500000001,4.30351204,4.7593149,4.901618,17665436,24627679.2,66.86718887545749,1.758056610961047,1.5,2.75,NaN,NaN,0.15985847963543254,0.7173000694275732,203.85519682042803,-0.011060492231312419,0.1608795247271635,0.1719400169584759,28.791205315876077,1.6376930885206156,48.930188529052224,19.912844682745,31.15696678820278,4338075456
1288618200,4.980784,5.064949,4.830793,4.913285,3.594787184210527,4.06679788235294,4.923702,3.176635,4.239124,3.176635,5.623277,3.707464,4.862452,2.454976,4.327243034999998,4.08685741,4.32899514,4.7877105,4.480194202170159,4.759841237501932,4.8519708461538436,4.99186537187474,4.712076320432947,4.327243034999998,4.08685741,4.32899514,4.7877105,4.936342333333333,21320048,24265786.8,66.86718887545749,2.022567127742182,1.5,2.75,NaN,NaN,0.1651654453757588,0.8786052632754525,204.62105481087957,-0.013379658187745641,0.15521544422379385,0.1685951024115395,28.698182408368478,5.191801724206227,32.73554183001666,33.95842545258592,33.30603271739742,4338075456
1288704600,5.023283,5.064949,4.979117,5.02995,3.6009713157894745,4.063538117647059,4.923702,3.176635,4.239124,3.176635,5.623277,3.707464,4.862452,2.454976,4.328384689999998,4.0978573,4.3577115200000005,4.808952,4.501753253065447,4.785565881549367,4.870945076923075,5.03350404579371,4.70838610805244,4.328384689999998,4.0978573,4.3577115200000005,4.808952,5.024672,15853068,23505057.2,71.66262363286856,3.426422423707632,1.5,2.75,NaN,NaN,0.1642010564203475,0.6744534959055535,208.88534965602287,-0.008223644305915878,0.15831554702914463,0.1665391913350605,20.06767888046138,4.5919221379217365,62.545864929757,11.115225112237274,26.338909958005726,4353928524
1288791000,5.059117,5.097449,4.902451,5.094116,3.6071554473684215,4.060278352941176,4.923702,3.176635,4.239124,3.176635,5.623277,3.707464,4.862452,2.454976,4.330555504999998,4.10958219,4.39087786,4.8338476,4.524983164709939,4.814951607116094,4.893252615384613,5.089174790537501,4.697330440231725,4.330555504999998,4.10958219,4.39087786,4.8338476,5.031338666666667,25884952,23605258.8,73.90009598268287,2.8996372653119664,1.5,2.75,NaN,NaN,0.1664008381046084,1.096575649490443,210.73441634466545,-0.0019842394712743516,0.16405889199596757,0.16604313146724192,15.158403889073359,5.233262786924007,100.00000000000001,0,0,4379813476
1288877400,5.244948,5.385779,5.239956,5.367446,3.613339578947369,4.057018588235294,4.923702,3.176635,4.239124,3.176635,5.623277,3.707464,4.862452,2.454976,4.335352954999998,4.12139874,4.42879414,4.8731805,4.558020922956608,4.867570120724085,4.9342779230769205,5.250133405857805,4.618422440296036,4.335352954999998,4.12139874,4.42879414,4.8731805,5.331060333333333,22271320,23394067.4,80.84008325699173,7.098413890350554,1.5,2.75,NaN,NaN,0.1753481353828507,0.9520071742633349,216.23826115464217,0.017960014230142984,0.18849314925492067,0.17053313502477768,30.705386575965328,10.083752684696446,100.00000000000001,0,0,4402084796
1288963800,5.392447,5.468279,5.37078,5.44328,3.6195237105263165,4.053758823529411,4.923702,3.176635,4.239124,3.176635,5.623277,3.707464,4.862452,2.454976,4.341990394999997,4.134040300000001,4.46957708,4.9122635,4.592736965193604,4.922399633036076,4.993700461538459,5.373168665242711,4.614232257834206,4.341990394999997,4.134040300000001,4.46957708,4.9122635,5.427446333333333,23648216,23199896,82.25025867063853,7.24848778670751,1.5,2.75,NaN,NaN,0.17002562571264707,1.0193242245568688,218.63390938315624,0.032804023120165615,0.2115381639249847,0.17873414080481909,30.70116814326489,10.552588276057326,100.00000000000001,0,0,4425733012
1289226600,5.393279,5.436613,5.338697,5.419112,3.625707842105264,4.050499058823529,4.923702,3.176635,4.239124,3.176635,5.623277,3.707464,4.862452,2.454976,4.348202829999998,4.14632351,4.50666004,4.9492214500000005,4.625143829303658,4.969705572746927,5.040622999999997,5.465347208573405,4.61589879142659,4.348202829999998,4.14632351,4.50666004,4.9492214500000005,5.398140666666667,12235248,22984561,80.22377073094349,5.986480238057043,1.5,2.75,NaN,NaN,0.165351152447458,0.5323246330438941,216.94234615979926,0.03721648887463386,0.2252547518981114,0.18803826302347754,31.966502143384684,10.089687009644793,87.17321619299973,1.5082622712891636,11.318521535711108,4413497764
1289313000,5.462445,5.479944,5.231614,5.292446,3.631891973684211,5.479944,4.923702,3.176635,4.239124,3.176635,5.623277,3.707464,4.862452,2.454976,4.354056929999998,4.1572234,4.544293,4.9775128,4.651312541879985,5.000442756294838,5.075366153846152,5.502901880777091,4.647830426915212,4.354056929999998,4.1572234,4.544293,4.9775128,5.334668000000001,22048504,22620454,70.42963306813866,4.107844635529922,1.5,2.75,NaN,NaN,0.17127821298692522,0.9747153615926542,212.85003777066152,0.028233349925957774,0.22332995043092474,0.19509660050496697,37.01053513838757,8.231086207425438,61.48535400842391,11.859566575208834,26.655079416367258,4391449260
1289399400,5.284114,5.369946,5.174949,5.36328,3.6380761052631585,5.498725846153846,4.923702,3.176635,4.239124,3.176635,5.623277,3.707464,4.862452,2.454976,4.359969369999998,4.1693232799999995,4.58300928,5.004262550000001,4.67923283435528,5.034998684266758,5.112865846153844,5.5492275484604345,4.676504143847254,4.359969369999998,4.1693232799999995,4.58300928,5.004262550000001,5.302725,14202932,22357745,72.4548635498697,3.5230900215298373,1.5,2.75,NaN,NaN,0.1729724120592877,0.635257804398431,215.47874702798737,0.023864655541449814,0.22492741993177923,0.2010627643903294,36.03343122492876,9.567570836241083,56.410845038533665,14.936480214205913,28.652674747260438,4405652192
1289485800,5.229114,5.33828,5.184116,5.319947,3.644260236842106,5.517507692307692,4.923702,3.176635,4.239124,3.176635,5.623277,3.707464,4.862452,2.454976,4.366406804999998,4.1830848099999995,4.61512562,5.03109565,4.704358880066837,5.062136619098495,5.143346230769229,5.5779492974561,4.708743164082358,4.366406804999998,4.1830848099999995,4.61512562,5.03109565,5.280781,15812640,21671899.8,69.32676553047013,2.3597155669186094,1.5,2.75,NaN,NaN,0.1734146683407671,0.7296379249593983,212.42187862315794,0.015276956189303553,0.22015895962695886,0.2048820034376553,37.15660845972236,8.276784269587452,27.86704423573607,39.417673026327265,32.71528273793666,4389839552
1289572200,5.209948,5.274113,5.046616,5.113282,3.6504443684210535,5.5362895384615385,5.44328,3.176635,4.239124,3.176635,5.623277,3.707464,4.862452,2.454976,4.3725484099999985,4.19516802,4.64094202,5.0465538500000005,4.7203950808485295,5.067007607755781,5.158025461538458,5.574297485133692,4.741753437943225,4.3725484099999985,4.19516802,4.64094202,5.0465538500000005,5.144670333333333,22515932,21405631,56.74424870986318,1.1593884643595838,1.5,2.75,NaN,NaN,0.18055154917356944,1.051869575813953,207.1221657515262,-0.005963238290343231,0.19742795557472625,0.2033911938650695,46.29728352515929,4.070535293596845,3.7769115139024785,79.15562333067753,17.067465155419985,4367323620
1289831400,5.162448,5.229073,5.093282,5.093282,3.656628500000001,5.555071384615385,5.44328,3.176635,4.239124,3.176635,5.623277,3.707464,4.862452,2.454976,4.377669189999999,4.209009549999999,4.6633751199999995,5.0595121,4.735018097285842,5.069509930826659,5.173666384615382,5.562872580649972,4.784460188580792,4.377669189999999,4.209009549999999,4.6633751199999995,5.0595121,5.1385456666666665,20830240,21656561.4,55.690837163747894,0.35751060839513543,1.5,2.75,NaN,NaN,0.177354367089743,0.9618442935266723,205.52529380925907,-0.02209420986113586,0.17577343153864966,0.19786764139978552,46.474708539431596,1.259098002962255,2.6478063529283298,82.56765752476845,14.7845361223032,4346493380
1289917800,5.004117,5.028283,4.784127,4.854118,4.784127,5.57385323076923,5.44328,3.176635,4.239124,3.176635,5.623277,3.707464,4.862452,2.454976,4.380814989999998,4.219951109999999,4.683624899999999,5.06867865,4.739688681706005,5.048996413605073,5.170525307692305,5.569221627073657,4.771828988310953,4.380814989999998,4.219951109999999,4.683624899999999,5.06867865,4.888842666666666,36379104,21592885.6,44.94564199575017,5.703100624727445,1.5,2.75,NaN,NaN,0.18676869801190427,1.6847726919833261,198.6163623916422,-0.04811338460930886,0.13772591063814943,0.1858392952474583,52.95486083023852,-4.711278659535824,2.081635085646565,84.64552342077948,13.272841493573958,4310114276
1290004200,4.869951,4.931617,4.824951,4.874951,4.809644137931034,5.592635076923076,5.44328,3.176635,4.239124,3.176635,5.623277,3.707464,4.862452,2.454976,4.384381619999998,4.23155932,4.702824699999999,5.07197025,4.7449930863449845,5.032420659928399,5.167576538461535,5.574325189400901,4.7608278875221695,4.384381619999998,4.23155932,4.702824699999999,5.07197025,4.877173,19304268,21259973.6,45.924393958521,4.149097421072264,1.5,2.75,NaN,NaN,0.18104707672533965,0.9080099704357111,201.3683313837156,-0.06226426413232472,0.10800896508205238,0.1702732292143771,52.22919184901908,-9.175593010157902,3.0484768924464216,81.2179594501271,15.733563657426465,4329418544
1290090600,5.013283,5.138282,5.013283,5.089949,4.835161275862069,5.611416923076923,5.44328,3.176635,4.239124,3.176635,5.623277,3.707464,4.862452,2.454976,4.390956554999999,4.24877581,4.7253077999999995,5.08442845,4.758520769233416,5.037899549459028,5.181166076923073,5.56413246522725,4.7981996886188965,4.390956554999999,4.24877581,4.7253077999999995,5.08442845,5.080504666666667,24555604,20595834.8,54.84602435156626,0.4771309689251483,1.5,2.75,NaN,NaN,0.1869244998163868,1.1922606798147362,207.20251820357805,-0.05570144409960345,0.10064642408987279,0.15634786818947624,48.76865599825937,-6.4911413706441685,16.183708191466383,54.201735691471235,29.61455611706238,4353974148
1290177000,5.079116,5.139948,4.99995,5.132865,4.860678413793103,5.630198769230769,5.44328,3.176635,4.239124,3.176635,5.623277,3.707464,4.862452,2.454976,4.397654405,4.2675214399999994,4.74743256,5.0972825,4.773200935145831,5.0469438780819775,5.189082615384612,5.563374783826932,4.8147904469422915,4.397654405,4.2675214399999994,4.74743256,5.0972825,5.090921000000001,13810228,20524471.8,56.39260466935348,0.4913662341887469,1.5,2.75,NaN,NaN,0.1835726069723592,0.6728664267014169,209.50514351685274,-0.047354628713777325,0.0971545822972546,0.14450921101103192,48.05497570504981,-5.282175382239753,33.92321427696963,32.74896592364378,33.327819799386596,4367784376
1290436200,5.066616,5.137448,4.954951,5.133283,4.886195551724137,5.648980615384615,5.44328,3.176635,4.239124,3.176635,5.623277,3.707464,4.862452,2.454976,4.4047835,4.28656293,4.76678236,5.10776155,4.7873218004342295,5.05516665159798,5.192095461538458,5.563903713942107,4.8202872091348095,4.4047835,4.28656293,4.76678236,5.10776155,5.075227333333333,21787524,20510347,56.40826577286731,0.3808286008257296,1.5,2.75,NaN,NaN,0.18349577790290494,1.0622698874865453,210.24054566978037,-0.04093138575656918,0.09334497881532045,0.13427636457188963,48.1739468190719,-3.007361813422383,64.50498869043898,10.2147338628643,25.28027744669672,4389571900
1290522600,4.957451,4.982449,4.855785,4.907451,4.911712689655172,5.667762461538461,5.44328,3.176635,4.239124,3.176635,5.623277,3.707464,4.862452,2.454976,4.410079285,4.3038710899999995,4.78173222,5.1070115000000005,4.7920327494368085,5.041098494302934,5.156711230769227,5.542330637685229,4.771091823853226,4.410079285,4.3038710899999995,4.78173222,5.1070115000000005,4.915228333333333,29402008,21170852.8,46.6586358205367,3.2590769057378273,1.5,2.75,NaN,NaN,0.1902102223384117,1.3887965816851742,205.07445192400263,-0.05039597327259013,0.07128139798115196,0.12167737125374209,52.48182319046025,-8.499071463731143,70.12857546404645,7.4142980514464085,22.45712648450712,4360169892
1290609000,5.006617,5.142449,5.003282,5.139115,4.937229827586207,5.686544307692308,5.44328,3.176635,4.239124,3.176635,5.623277,3.707464,4.862452,2.454976,4.41665422,4.323029239999999,4.80038202,5.11946975,4.805643818086345,5.050433399607417,5.13331392307692,5.481652347584742,4.784975498569098,4.41665422,4.323029239999999,4.80038202,5.11946975,5.094948666666666,14350868,20710629,55.21080683954665,0.8519811852129753,1.5,2.75,NaN,NaN,0.19340934931423945,0.6929228465248448,210.2638235106968,-0.04001140727065547,0.07166311216542276,0.11167451943607823,60.067258047760824,-3.399131607890072,68.74620024776537,8.064563644408137,23.189236107826495,4374520760
1290781800,5.014117,5.091617,4.979117,5.030775,4.962746965517241,5.705326153846153,5.44328,3.176635,4.239124,3.176635,5.623277,3.707464,4.862452,2.454976,4.422050795,4.33800402,4.8169317000000005,5.1262609,4.814472491886881,5.048561171073378,5.103441846153843,5.413075448832231,4.793808243475455,4.422050795,4.33800402,4.8169317000000005,5.1262609,5.033836333333333,6708784,20029346.2,51.08577584693544,1.7302572142520543,1.5,2.75,NaN,NaN,0.1910228243632224,0.33494772784944926,206.7617715670369,-0.039337219373190124,0.06250299521959057,0.1018402145927807,60.84636273687873,-1.613582039871841,49.648785317458994,19.616200571145,30.735014111396016,4367811976
1291041000,4.929951,5.044283,4.829118,5.006617,4.988264103448276,5.724107999999999,5.44328,3.176635,4.239124,3.176635,5.623277,3.707464,4.862452,2.454976,4.42732158,4.3517288899999995,4.832898220000001,5.1309275,4.822007570636415,5.044566488114008,5.081454999999997,5.374426591225547,4.7884834087744474,4.42732158,4.3517288899999995,4.832898220000001,5.1309275,4.960006000000001,23302480,20311198.4,50.18537249505385,2.0401123746222027,1.5,2.75,NaN,NaN,0.19274726548013507,1.1472725311963867,204.6038638635969,-0.03932269433839766,0.05268684666978363,0.09200954100818129,56.881607405967095,-1.7015551072962383,20.616162616145793,48.00115933007815,31.382678053776054,4344509496
1291127400,4.860785,5.00245,4.835785,4.912451,5.01378124137931,5.742889846153846,5.44328,3.176635,4.239124,3.176635,5.623277,3.707464,4.862452,2.454976,4.431179875,4.363645449999999,4.8431147800000005,5.130885800000001,4.825554371787928,5.031984060674579,5.046775846153844,5.302454611707384,4.791097080600304,4.431179875,4.363645449999999,4.8431147800000005,5.130885800000001,4.916895333333333,19273632,20208877.6,46.72810407400903,2.5214743529635517,1.5,2.75,NaN,NaN,0.1911818893744112,0.9537210517817178,201.6558290790482,-0.044100517266446745,0.036883894425122854,0.0809844116915696,57.70637316295042,1.2017219194094622,3.1444796059991327,80.94015447185424,15.91536592214661,4325235864
1291213800,5.122449,5.255782,5.122449,5.224114,5.0392983793103445,5.761671692307692,5.44328,3.176635,4.239124,3.176635,5.623277,3.707464,4.862452,2.454976,4.436289824999999,4.378653639999999,4.86008128,5.140594000000001,4.841184161129577,5.050282150134143,5.039404076923075,5.267154064010079,4.811654089836072,4.436289824999999,4.378653639999999,4.86008128,5.140594000000001,5.200781666666667,23068080,20569628.2,57.23006396761528,3.106489339884825,1.5,2.75,NaN,NaN,0.2020496829905247,1.1214631482741142,206.73489149252572,-0.025632056992604596,0.04894434045081386,0.07457639744341846,60.971671174982006,7.162389939919394,27.17818466146543,39.94972390241115,32.872091436123426,4348303944
1291300200,5.246615,5.437446,5.244948,5.428279,5.064815517241379,5.780453538461538,5.44328,3.176635,4.239124,3.176635,5.623277,3.707464,4.862452,2.454976,4.442039765,4.393920149999999,4.8826643800000005,5.157302150000001,4.864207488144104,5.086281850121367,5.063634615384614,5.370835825000159,4.7564334057690685,4.442039765,4.393920149999999,4.8826643800000005,5.157302150000001,5.370224333333333,21816168,20366189,62.45208648834878,5.509374944578053,1.5,2.75,NaN,NaN,0.20285556277691574,1.071195401358595,210.70777253577177,-0.00036327455075191306,0.07412230425497857,0.07448557880573048,63.42204486388749,6.647021414163482,33.84087784868099,32.881268141496726,33.27785400982229,4370120112
1291386600,5.374946,5.497445,5.364946,5.478279,5.090332655172413,5.799235384615384,5.44328,3.176635,4.239124,3.176635,5.623277,3.707464,4.862452,2.454976,4.447873039999999,4.409736669999998,4.90832082,5.162843800000001,4.888288723903159,5.1236149120145695,5.093249769230767,5.472057676003217,4.714441862458317,4.447873039999999,4.409736669999998,4.90832082,5.162843800000001,5.44689,15662556,20035750.8,63.62345875503126,5.055070531939703,1.5,2.75,NaN,NaN,0.19783009400713605,0.7817304255950318,213.22438401419535,0.018005564585325207,0.09699253453738699,0.07898696995206178,59.98154641726143,6.72945810965221,49.62718910330683,19.410299494669175,30.962511402024,4385782668
1291645800,5.451612,5.499987,5.426612,5.463279,5.115849793103448,5.818017230769231,5.44328,3.176635,4.239124,3.176635,5.623277,3.707464,4.862452,2.454976,4.45366882,4.4253198499999975,4.92865396,5.163843750000001,4.910837362181466,5.155963872775087,5.140108307692306,5.539166191551766,4.741050423832846,4.45366882,4.4253198499999975,4.92865396,5.163843750000001,5.463292666666667,10342840,19370482,62.988600131182,4.8665461319121,1.5,2.75,NaN,NaN,0.18894044443519772,0.5339485099028511,213.32291694201177,0.02689754155888728,0.11260889690067089,0.0857113553417836,60.24990277269599,6.428556539742704,61.40891498075003,11.808520080667503,26.782564938582475,4375439828
1291732200,5.627444,5.634361,5.461611,5.470778,5.141366931034482,5.836799076923077,5.44328,3.176635,4.239124,3.176635,5.623277,3.707464,4.862452,2.454976,4.4602812499999995,4.444277999999998,4.9500704,5.166427050000001,4.932795818566507,5.185946170606031,5.185941153846152,5.589494213189203,4.782388094503101,4.4602812499999995,4.444277999999998,4.9500704,5.166427050000001,5.52225,18010536,19659246.4,63.18637228467596,4.997461513126818,1.5,2.75,NaN,NaN,0.18778398411839786,0.9161356256260159,214.0963061332483,0.03075800148027369,0.12415885719212572,0.09340085571185203,60.20629884360362,11.479014258114857,87.65237489595364,1.385861270281376,10.96176383376497,4393450364
1291818600,5.491611,5.544887,5.411279,5.515778,5.166884068965517,5.855580923076923,5.44328,3.176635,4.239124,3.176635,5.623277,3.707464,4.862452,2.454976,4.466606189999999,4.463019479999997,4.97128684,5.17759365,4.955657864897232,5.217358725786409,5.218697230769228,5.6536714464656415,4.783723015072815,4.466606189999999,4.463019479999997,4.97128684,5.17759365,5.490648,14868916,19300267,64.41519181063613,3.8593451857747727,1.5,2.75,NaN,NaN,0.1839142709670837,0.77039949758208,211.30503244705972,0.0335855548056013,0.13538279921885366,0.10179724441325236,50.59669667025807,7.32933588759932,86.4524920426031,1.6540878330207995,11.89342012437611,4408319280
1291905000,5.605777,5.615777,5.499945,5.575778,5.192401206896552,5.8743627692307685,5.44328,3.176635,4.239124,3.176635,5.623277,3.707464,4.862452,2.454976,4.473261959999999,4.481110969999998,4.994303260000001,5.18821855,4.979976301567929,5.251493894759132,5.252767461538459,5.723432360406901,4.782102562670018,4.473261959999999,4.481110969999998,4.994303260000001,5.18821855,5.563833333333332,9678456,19074043.2,66.04274604798925,4.225316906266021,1.5,2.75,NaN,NaN,0.17905125161229196,0.5074150193808935,213.2275834949244,0.03649819395382489,0.14741998685553348,0.11092179290170859,45.627375144968646,10.833380542759306,83.83180737187635,2.314450643680847,13.85374198444279,4417997736
1291991400,5.624944,5.69161,5.573278,5.674944,5.217918344827586,5.893144615384615,5.44328,3.176635,4.239124,3.176635,5.623277,3.707464,4.862452,2.454976,4.480386889999999,4.501677439999997,5.01988636,5.205968400000001,5.007229936800559,5.291822476210643,5.29443369230769,5.809243656854958,4.779623727760422,4.480386889999999,4.501677439999997,5.01988636,5.205968400000001,5.646610666666667,9674724,18767147.4,68.59903566046486,5.176170374003176,1.5,2.75,NaN,NaN,0.17471416221141395,0.5155138281697517,216.41741107647172,0.04172777374463228,0.16308151008249894,0.12135373633786666,41.74279787944524,13.34887410001603,82.18824626404913,2.779473681131534,15.032280054819346,4427672460
1292250600,5.759109,5.766609,5.675777,5.681609,5.2434354827586205,5.911926461538461,5.44328,3.176635,4.239124,3.176635,5.623277,3.707464,4.862452,2.454976,4.486865989999999,4.519893909999997,5.04460274,5.23438475,5.033676174573086,5.32894500228582,5.353984307692305,5.854873594746,4.85309502063861,4.486865989999999,4.519893909999997,5.04460274,5.23438475,5.707998333333333,9388388,18110770.2,68.76920549121357,5.377882369018129,1.5,2.75,NaN,NaN,0.16878207919631297,0.518387009294613,214.67697256460403,0.0421371200716838,0.17402513642747142,0.13188801635578762,40.99434159080654,15.657316480103313,100,0,0,4437060848
1292337000,5.700776,5.770776,5.649944,5.695777,5.268952620689655,5.930708307692307,5.44328,3.176635,4.239124,3.176635,5.623277,3.707464,4.862452,2.454976,4.493195094999999,4.5371487399999975,5.071610820000001,5.264509500000001,5.059640912825121,5.363881383020503,5.396804461538459,5.9118727395435675,4.881736183533351,4.493195094999999,4.5371487399999975,5.071610820000001,5.264509500000001,5.705499,10983384,17618427.4,69.15190770166475,4.340058474720724,1.5,2.75,NaN,NaN,0.16535707353943346,0.623403198857578,212.66249011621096,0.039886563747734444,0.18174622104045568,0.14185965729272124,36.55234498013853,9.028574031883673,100,0,0,4448044232
1292423400,5.66661,5.740776,5.593077,5.61786,5.294469758620689,5.9494901538461535,5.44328,3.176635,4.239124,3.176635,5.623277,3.707464,4.862452,2.454976,4.499076284999998,4.552319409999997,5.091865620000001,5.3026966,5.081531857420215,5.388069822732836,5.4419648461538435,5.922536565204486,4.961393127103201,4.499076284999998,4.552319409999997,5.091865620000001,5.3026966,5.650571,14085992,16503771.8,64.47280215161035,2.984660435869566,1.5,2.75,NaN,NaN,0.1640957825723311,0.8535013796058426,209.24037916337878,0.030119250734732067,0.17950872071113633,0.14938946997640426,25.109811692238907,3.492469712776378,69.62985224994758,7.5668406411133375,22.803307108939084,4433958240
1292509800,5.62661,5.728277,5.564944,5.71411,5.319986896551724,5.968272,5.44328,3.176635,4.239124,3.176635,5.623277,3.707464,4.862452,2.454976,4.5052553899999985,4.568619259999997,5.114223740000001,5.3446545500000004,5.106338843403736,5.419121268186852,5.496387384615383,5.924843108330601,5.067931660900165,4.5052553899999985,4.568619259999997,5.114223740000001,5.3446545500000004,5.669110333333333,14615904,16269353.6,67.40667037946761,3.3172761549291447,1.5,2.75,NaN,NaN,0.16404129810287893,0.8983702954246443,212.93437017856184,0.02719888212987731,0.1833880726387509,0.1561891905088736,17.204656845352044,4.304837340339916,72.76310158870886,6.176445369624927,21.060453041666207,4448574144
1292596200,5.71411,5.768476,5.681609,5.751609,5.345504034482758,5.987053846153846,5.44328,3.176635,4.239124,3.176635,5.623277,3.707464,4.862452,2.454976,4.510676174999999,4.586110749999997,5.137640160000001,5.377737550000001,5.131643555427119,5.450786766454771,5.5609379999999975,5.847350668781895,5.2745253312181,4.510676174999999,4.586110749999997,5.137640160000001,5.377737550000001,5.733898,8480676,15465607.2,68.49815900945369,3.4237833481165576,1.5,2.75,NaN,NaN,0.15852884823838756,0.5483571314290202,215.0571817844101,0.024911792859546977,0.18732893158330732,0.16241713872376035,17.04476695997261,5.277599771126464,72.16522894264739,6.431818428080837,21.402952629271766,4457054820
1292855400,5.790776,5.826608,5.703276,5.781609,5.371021172413792,6.005835692307691,5.44328,3.176635,4.239124,3.176635,5.623277,3.707464,4.862452,2.454976,4.5162177849999985,4.604510569999997,5.160039940000001,5.410174750000001,5.157132396390761,5.482293645840031,5.603822230769229,5.837812528897038,5.36983193264142,4.5162177849999985,4.604510569999997,5.160039940000001,5.410174750000001,5.7704976666666665,9233444,15236768,69.38156378977312,3.5976202397366723,1.5,2.75,NaN,NaN,0.15601478764993135,0.6059975448861595,214.33170553430008,0.022606176130189004,0.1906748588864966,0.1680686827563076,16.343784934785873,5.681659902851117,72.07405804085892,6.465707641159795,21.4602343179813,4466288264
1292941800,5.833275,5.909898,5.823275,5.897441,5.396538310344827,6.024617538461538,5.44328,3.176635,4.239124,3.176635,5.623277,3.707464,4.862452,2.454976,4.522209389999999,4.6239895399999975,5.1843897000000005,5.448382650000001,5.186164106336221,5.521831489093361,5.639911615384613,5.897955756909083,5.381867473860144,4.522209389999999,4.6239895399999975,5.1843897000000005,5.448382650000001,5.876871333333334,10627772,14678780.4,72.57898149578214,4.418061401583354,1.5,2.75,NaN,NaN,0.1540343742463648,0.7240228214055168,217.84579676949906,0.025835884659891478,0.20036353858117195,0.17452765392128047,17.924101161391462,6.919477179828478,72.08581135625425,6.460631319850475,21.453557323895286,4476916036
1293028200,5.914108,5.961606,5.902441,5.94994,5.422055448275861,6.043399384615384,5.44328,3.176635,4.239124,3.176635,5.623277,3.707464,4.862452,2.454976,4.5281343299999985,4.641464369999998,5.20885612,5.500507100000001,5.216116102166174,5.562603728227327,5.676193230769228,5.964043034332079,5.388343427206378,4.5281343299999985,4.641464369999998,5.20885612,5.500507100000001,5.937995666666666,8202452,13618802.6,73.90887345463145,4.478824874260036,1.5,2.75,NaN,NaN,0.14761513322876732,0.6022887797786275,220.5074147973753,0.0282650718571692,0.20985899374274197,0.18159392188557277,17.937535254006942,6.710489549619804,100,0,0,4485118488
1293114600,5.931607,5.954107,5.885774,5.924942,5.447572586206896,6.06218123076923,5.44328,3.176635,4.239124,3.176635,5.623277,3.707464,4.862452,2.454976,4.533667609999998,4.659280869999998,5.23078926,5.539798450000001,5.243913196198873,5.59711213506282,5.7117057692307664,5.99963501324865,5.423776525212883,4.533667609999998,4.659280869999998,5.23078926,5.539798450000001,5.921607666666667,8336288,13318073.6,72.11538082793513,3.577891658008204,1.5,2.75,NaN,NaN,0.1419521237124268,0.625937973491902,219.32075424552986,0.025055066475959287,0.21291275498052187,0.18785768850456258,18.983802417179515,4.405294572069781,79.16877803643975,3.7354899979350726,17.095731965625166,4476782200
1293460200,5.863275,5.944857,5.846608,5.929941,5.473089724137931,6.0809630769230765,5.44328,3.176635,4.239124,3.176635,5.623277,3.707464,4.862452,2.454976,4.539162974999999,4.676255709999998,5.25372238,5.58475675,5.270816247328329,5.6288101221996945,5.747025999999997,6.020352090912553,5.473699909087442,4.539162974999999,4.676255709999998,5.25372238,5.58475675,5.907135333333333,5629400,13264104.4,72.26034697417103,3.223814097784508,1.5,2.75,NaN,NaN,0.138830472018682,0.4244086016090163,221.10177726917462,0.020336031119154774,0.21327772740350603,0.19294169628435126,17.645202175841703,4.370804115524325,77.0599145929359,4.452550318703526,18.487535088360573,4482411600
1293546600,5.971607,5.973273,5.905774,5.944941,5.498606862068965,6.099744923076923,5.44328,3.176635,4.239124,3.176635,5.623277,3.707464,4.862452,2.454976,4.544779589999999,4.693497219999998,5.276538840000001,5.6316729500000005,5.297252512138983,5.658917824847342,5.780038538461536,6.036838486694954,5.523238590228118,4.544779589999999,4.693497219999998,5.276538840000001,5.6316729500000005,5.941329333333333,5231992,12360580,72.71865811046513,2.9637962898068677,1.5,2.75,NaN,NaN,0.13373536687449042,0.4232804609492435,219.97117527485247,0.01551043516701972,0.2123297402431259,0.19681930507610618,17.57194400174906,4.374539241968223,74.42544622505585,5.458256817672327,20.11629695727181,4487643592
1293633000,5.97744,6.008274,5.963274,5.972358,5.524124,6.118526769230769,5.44328,3.176635,4.239124,3.176635,5.623277,3.707464,4.862452,2.454976,4.549887459999999,4.711537879999997,5.2993036600000005,5.6846683,5.323727237153141,5.688769270099976,5.81054469230769,6.057053528668436,5.564035855946945,4.549887459999999,4.711537879999997,5.2993036600000005,5.6846683,5.981302,5786024,11686199.6,73.5779472009244,3.2831542528529782,1.5,2.75,NaN,NaN,0.1287066263834554,0.49511596567287797,222.73692122293784,0.011628087324323438,0.21135441423151047,0.19972632690718703,17.524079471688964,6.310196409308874,70.14656062458883,7.287512452641677,22.565926922769506,4493429616
1293719400,5.960774,5.99619,5.924942,5.950774,5.549641137931034,6.137308615384615,5.44328,3.176635,4.239124,3.176635,5.623277,3.707464,4.862452,2.454976,4.554424914999999,4.728654379999997,5.3249034,5.721001299999999,5.34831730628439,5.713722101519026,5.8317623846153825,6.075398750301294,5.588126018929471,4.554424914999999,4.728654379999997,5.3249034,5.721001299999999,5.957301999999999,7772044,10921397.8,71.66425175118218,2.3040250943138703,1.5,2.75,NaN,NaN,0.1246024387846372,0.7116345491966238,223.0129474466748,0.005386836104198989,0.20645987203743577,0.20107303593323678,14.272963853589992,4.141747358731285,35.74095082963586,31.024201689289868,33.23484748107428,4485657572
1293805800,5.923274,5.966608,5.893474,5.958274,5.575158275862068,6.1560904615384615,5.44328,3.176635,4.239124,3.176635,5.623277,3.707464,4.862452,2.454976,4.559145699999998,4.746679199999997,5.3478865,5.7475010499999994,5.372237176626178,5.7370127585172135,5.853044307692306,6.0887017464217985,5.6173868689628135,4.559145699999998,4.746679199999997,5.3478865,5.7475010499999994,5.939452000000001,6045576,10132868.2,71.9373804776685,1.8641320910709185,1.5,2.75,NaN,NaN,0.12092612172859166,0.596630280851773,224.4368585870834,-0.00016195810586044912,0.2008705883009112,0.20103254640677165,12.491372372899356,3.5931684507761235,69.4980379579078,7.585686224195224,22.91627581789698,4491703148
1294065000,6.08244,6.206605,6.074938,6.127439,5.600675413793103,6.174872307692307,5.44328,3.176635,4.239124,3.176635,5.623277,3.707464,4.862452,2.454976,4.565128974999999,4.769853969999997,5.373619580000001,5.7799590499999995,5.401852934405543,5.774196210087003,5.886249076923075,6.14447563004436,5.628022523801791,4.565128974999999,4.769853969999997,5.373619580000001,5.7799590499999995,6.136327333333333,15344096,10116945.2,77.26130772209166,4.3680349874513045,1.5,2.75,NaN,NaN,0.13002647017654936,1.516672839149114,228.86018193878223,0.005331595040671516,0.20769704020761104,0.20236544516693952,18.551583272340906,5.981552886056448,77.4464082137346,4.3015945284099715,18.251997257855418,4507047244
1294151400,6.176605,6.179104,5.986607,6.097439,5.626192551724137,6.193654153846153,5.44328,3.176635,4.239124,3.176635,5.623277,3.707464,4.862452,2.454976,4.570491419999999,4.793370399999998,5.398052680000001,5.811667049999999,5.429130819330815,5.804981237697764,5.923139769230768,6.1529152998730465,5.693364238588489,4.570491419999999,4.793370399999998,5.398052680000001,5.811667049999999,6.087716666666666,13242576,10261932,74.55981290674971,2.8773507267021645,1.5,2.75,NaN,NaN,0.13448865087822437,1.290456416978791,225.7704389676102,0.004735899653077996,0.208285319733287,0.20354942008020901,19.648438762646542,3.391267500598987,42.347361580771114,25.070040223691862,32.582598195537024,4493804668
1294237800,6.04994,6.208271,6.030773,6.191605,5.651709689655172,6.212435999999999,5.44328,3.176635,4.239124,3.176635,5.623277,3.707464,4.862452,2.454976,4.576349689999998,4.818245149999997,5.4234107400000005,5.847708399999999,5.459031767592352,5.841802548393216,5.959870153846152,6.196793473328146,5.7229468343641585,4.576349689999998,4.818245149999997,5.4234107400000005,5.847708399999999,6.143549666666666,14183600,10070585.2,77.24888430823205,3.830378988664092,1.5,2.75,NaN,NaN,0.13756074724406547,1.4084186487990789,228.54087660006553,0.008267998561499845,0.21388441828208382,0.20561641972058398,18.57250860377881,4.061637596345514,52.10428464162687,17.607241235419494,30.288474122953637,4507988268
1294324200,6.208271,6.229104,6.11244,6.159938,5.677226827586207,6.231217846153846,5.44328,3.176635,4.239124,3.176635,5.623277,3.707464,4.862452,2.454976,4.582445464999998,4.842786569999998,5.44816046,5.879916399999999,5.486518286510299,5.8721011628319575,5.991280076923075,6.217459036126026,5.765101117720124,4.582445464999998,4.842786569999998,5.44816046,5.879916399999999,6.167160666666668,11326540,9893466.4,74.40077296624743,3.0082088025484057,1.5,2.75,NaN,NaN,0.13606812244091795,1.1448505045713806,225.90143221408832,0.00615294797237001,0.21330760468604648,0.20715465671367647,19.19462462578281,3.9662160405958518,46.21799131405612,21.939217921640086,31.84279076430378,4496661728
1294410600,6.191605,6.223988,5.984941,6.129939,5.702743965517241,6.249999692307692,5.44328,3.176635,4.239124,3.176635,5.623277,3.707464,4.862452,2.454976,4.588545404999999,4.865628019999997,5.47296024,5.907624449999999,5.511750471353032,5.896657147324152,6.018074692307691,6.219753006788769,5.816396377826612,4.588545404999999,4.865628019999997,5.47296024,5.907624449999999,6.1129560000000005,16960152,10257551.2,71.70371102869653,1.7935666311224876,1.5,2.75,NaN,NaN,0.14342375655228098,1.6534308890410414,224.02305475287545,0.0007016719786839265,0.2080317466870314,0.20733007470834747,19.29629269110938,3.372681110992502,23.023647787348846,44.84445002003342,32.131902192617744,4479701576
1294669800,6.043273,6.145772,5.991606,6.114939,5.7282611034482755,6.268781538461538,5.44328,3.176635,4.239124,3.176635,5.623277,3.707464,4.862452,2.454976,4.5945470099999985,4.888044459999997,5.49735998,5.9296242,5.535404923456835,5.917445895198043,6.034805307692305,6.2296482773874455,5.839962337997164,4.5945470099999985,4.888044459999997,5.49735998,5.9296242,6.084105666666666,9468860,10247258,70.33084402746613,1.6292035785650971,1.5,2.75,NaN,NaN,0.14419105965568949,0.9240384110559137,225.03922830874677,-0.005599318682528803,0.20033092635518646,0.20593024503771526,19.546350561741406,2.859540574078021,6.050557533839443,72.9574394967803,20.992002969380266,4470232716
1294756200,6.187438,6.226938,6.114939,6.183272,5.75377824137931,6.287563384615384,5.44328,3.176635,4.239124,3.176635,5.623277,3.707464,4.862452,2.454976,4.600471954999999,4.913135879999997,5.52275972,5.9547073500000005,5.560811475478136,5.942762667083944,6.052753923076921,6.255833707458045,5.849674138695796,4.600471954999999,4.913135879999997,5.52275972,5.9547073500000005,6.175049666666665,12769924,10416334.8,72.87841242479422,2.1444104865872298,1.5,2.75,NaN,NaN,0.14189162682314024,1.2259517618423708,227.33829644295122,-0.006771706334463334,0.1974656121196361,0.20423731845409943,20.0713373159697,3.531502967504624,23.849668406835054,43.84236913251347,32.30796246065149,4483002640
1294842600,6.301604,6.364103,6.262437,6.354936,5.779295379310344,6.30634523076923,5.44328,3.176635,4.239124,3.176635,5.623277,3.707464,4.862452,2.454976,4.607192719999999,4.9402939399999966,5.551592740000001,5.987665300000001,5.59195361369468,5.982017270218806,6.085830384615382,6.330647419033443,5.84101335019732,4.607192719999999,4.9402939399999966,5.551592740000001,5.987665300000001,6.327158666666667,9709332,10352632.2,77.99113025485164,3.8763229784870026,1.5,2.75,NaN,NaN,0.14467301062148738,0.9378611943733499,231.38180976678237,0.0019416506287144308,0.20666438173999246,0.20472273111127803,24.176927428952688,6.7917551565561105,19.266113365976235,49.789203775336055,30.944682858687703,4492711972
1294929000,6.342437,6.369936,6.274937,6.327436,5.804812517241379,6.325127076923076,5.44328,3.176635,4.239124,3.176635,5.623277,3.707464,4.862452,2.454976,4.614030149999999,4.967626989999997,5.577542460000001,6.0231441000000006,5.620796060216457,6.01491429210273,6.116406923076921,6.3746302838165505,5.858183562337292,4.614030149999999,4.967626989999997,5.577542460000001,6.0231441000000006,6.324103,8337512,10065208.2,75.53460721572822,3.2029343307085343,1.5,2.75,NaN,NaN,0.14112486700566682,0.8283496808342227,229.795034060245,0.0036798256166772347,0.20932251313212458,0.20564268751544734,24.286446833859877,6.195787572038468,21.246116084585168,47.13574230236066,31.61814161305416,4484374460
1295015400,6.294104,6.45826,6.282437,6.444102,5.830329655172413,6.343908923076922,5.44328,3.176635,4.239124,3.176635,5.623277,3.707464,4.862452,2.454976,4.620909244999999,4.997710019999997,5.604542180000001,6.0596437000000005,5.653082567658949,6.05578931190247,6.154803923076921,6.445968668327083,5.863639177826759,4.620909244999999,4.997710019999997,5.604542180000001,6.0596437000000005,6.394933,11207752,9894800.6,78.61236655090572,4.097373627504974,1.5,2.75,NaN,NaN,0.14360330507669064,1.1326910417982552,231.9270412238011,0.010146923924241935,0.21832634242074977,0.20817941849650784,24.986298962734768,5.167950264376359,56.67461968716,14.592453851038094,28.732926461801913,4495582212
1295361000,6.444936,6.509935,6.417435,6.502435,5.8558467931034475,6.362690769230769,5.44328,3.176635,4.239124,3.176635,5.623277,3.707464,4.862452,2.454976,4.627396674999999,5.0280180499999965,5.627241960000001,6.0971850000000005,5.686390506182128,6.098326996483187,6.195579076923075,6.519721416700821,5.87143673714533,4.627396674999999,5.0280180499999965,5.627241960000001,6.0971850000000005,6.476601666666667,11287732,10035153.4,79.96922605832977,4.18185695681534,1.5,2.75,NaN,NaN,0.13995306899978413,1.1248190785005838,233.49260195151396,0.015493201098798565,0.22754591987000605,0.2120527187712075,21.525618000603675,6.642067267913637,84.50557851307194,2.206894818680643,13.287526668247423,4506869944
1295447400,6.488268,6.496603,6.246605,6.29327,5.881363931034482,6.381472615384615,5.44328,3.176635,4.239124,3.176635,5.623277,3.707464,4.862452,2.454976,4.632638284999999,5.056909419999997,5.644241760000001,6.12276805,5.7101897020181225,6.116892996818121,6.221924923076922,6.51652372575814,5.927326120395704,4.632638284999999,5.056909419999997,5.644241760000001,6.12276805,6.345492666666666,13887832,10267872.8,64.23331559754604,1.8907192252336398,1.5,2.75,NaN,NaN,0.14822999264265674,1.352552010578082,229.05118433140768,0.0027502990421512663,0.21549059257389658,0.2127402935317453,30.6114772936102,1.6419813602450362,51.8592458069516,18.2266059123854,29.914148280663007,4492982112
1295533800,6.249938,6.297438,6.118205,6.253521,5.906881068965516,6.400254461538461,5.44328,3.176635,4.239124,3.176635,5.623277,3.707464,4.862452,2.454976,4.638135309999998,5.083794989999997,5.660929940000001,6.140572050000001,5.731496811742902,6.129905187597348,6.24463623076923,6.496914181654487,5.992358279883973,4.638135309999998,5.083794989999997,5.660929940000001,6.140572050000001,6.223054666666666,11592124,10316090.4,61.74672225232268,0.34282904019007987,1.5,2.75,NaN,NaN,0.15044449316818126,1.123693526377008,226.32434668234302,-0.00985708128303281,0.20041894192795429,0.2102760232109871,29.980818199694475,1.519219836303543,25.733743526796925,42.201600366964236,32.06465610623883,4481389988
1295620200,6.354936,6.405769,6.264104,6.294104,5.932398206896551,6.419036307692307,5.44328,3.176635,4.239124,3.176635,5.623277,3.707464,4.862452,2.454976,4.643593594999998,5.112628049999996,5.680963100000001,6.15778025,5.753559838733376,6.145543169730934,6.257456615384616,6.501410390656192,6.0135028401130395,4.643593594999998,5.112628049999996,5.680963100000001,6.15778025,6.321325666666667,7990816,10305508.6,63.30847684577543,1.300516773546203,1.5,2.75,NaN,NaN,0.15057331508473976,0.7753926865870551,227.58925774641037,-0.01656955265114618,0.18956408239705436,0.20613363504820054,29.8528728915127,2.678085377358562,45.277289565168,23.192596565177606,31.53011386965441,4489380804
1295879400,6.275771,6.421602,6.270771,6.400769,5.957915344827586,6.437818153846154,5.44328,3.176635,4.239124,3.176635,5.623277,3.707464,4.862452,2.454976,4.649097699999998,5.142361079999996,5.701712880000002,6.1815716,5.778940590155597,6.169850391661321,6.2807896923076925,6.516960344202116,6.044619040413269,4.649097699999998,5.142361079999996,5.701712880000002,6.1815716,6.3643806666666665,7190156,10248202,67.10931619718363,1.951216164922067,1.5,2.75,NaN,NaN,0.1505917211501155,0.7016017053528024,231.20210033624838,-0.014980366224815661,0.18740817726718095,0.20238854349199661,30.56622395172223,4.674290291366778,37.35194656134599,29.575071051675398,33.07298238697861,4496570960
1295965800,6.35577,6.411603,6.254937,6.404936,5.98343248275862,6.4566,6.502435,3.176635,4.239124,3.176635,5.623277,3.707464,4.862452,2.454976,4.654439319999998,5.169269139999996,5.723412660000003,6.20532135,5.803489429757338,6.192239497217386,6.297199769230771,6.535934570860148,6.0584649676013935,4.654439319999998,5.169269139999996,5.723412660000003,6.20532135,6.357158666666667,15697224,10751593.2,67.25203602830604,1.16004163300107,1.5,2.75,NaN,NaN,0.15102559821082157,1.4599905063372376,232.65123801086733,-0.014778208922379826,0.18391578233902184,0.19869399126140166,30.366437276620015,3.5848980927897163,42.51940325198514,25.02296602286506,32.457630725149805,4512268184
1296052200,6.459101,6.547435,6.420852,6.497435,6.008949620689655,6.475381846153845,6.502435,3.176635,4.239124,3.176635,5.623277,3.707464,4.862452,2.454976,4.660201759999998,5.196018869999997,5.751095720000002,6.232946050000001,5.8307029815315605,6.221305735577635,6.3231610769230775,6.569814358203579,6.076507795642576,4.660201759999998,5.196018869999997,5.751095720000002,6.232946050000001,6.488574,11452024,11062594.8,70.32976663382135,3.1052231558111623,1.5,2.75,NaN,NaN,0.15041655548147714,1.0352023378818864,236.0765370149437,-0.009785187615625024,0.18646250674187037,0.1962476943574954,30.672403527882253,2.2423357213982946,76.05339193128627,4.84514660318957,19.10146146552416,4523720208
1296138600,6.506602,6.583268,6.469935,6.551601,6.034466758620689,6.4941636923076915,6.502435,3.176635,4.239124,3.176635,5.623277,3.707464,4.862452,2.454976,4.665335039999999,5.221818609999997,5.7802621000000025,6.2619082000000015,5.858973492059735,6.252762427427385,6.355596615384616,6.602980575574239,6.108212655194994,4.665335039999999,5.221818609999997,5.7802621000000025,6.2619082000000015,6.5349346666666674,10397200,11293153.6,71.98987254320909,3.107725843740737,1.5,2.75,NaN,NaN,0.14776773008994307,0.9206640030115237,238.02959435913274,-0.0044751080781046115,0.19065380925986464,0.19512891733796925,27.349350819704533,3.5427462245370824,100,0,0,4534117408
1296225000,6.575768,6.602434,6.181604,6.211604,6.059983896551723,6.512945538461538,6.502435,3.176635,4.239124,3.176635,5.623277,3.707464,4.862452,2.454976,4.668664169999998,5.245518359999997,5.807411820000002,6.274949700000002,5.8728021394299414,6.248842577196205,6.363032384615385,6.585601429409667,6.140463339821103,4.668664169999998,5.245518359999997,5.807411820000002,6.274949700000002,6.331880666666667,21064108,11957756.8,52.233838091455596,1.5905834889114543,1.5,2.75,NaN,NaN,0.1672721779406614,1.761543435972874,232.1691965658868,-0.024389027874656688,0.1646426324946484,0.18903166036930508,42.41596537781049,-3.6079193035740222,62.184661120071134,11.363621965946097,26.451716913982764,4513053300
1296484200,6.264937,6.369936,6.217438,6.348269,6.085501034482758,6.531727384615384,6.502435,3.176635,4.239124,3.176635,5.623277,3.707464,4.862452,2.454976,4.673974529999998,5.2698514399999965,5.836878180000002,6.294449450000001,5.891447898667983,6.258311760320376,6.3757244615384625,6.573251628946844,6.178197294130081,4.673974529999998,5.2698514399999965,5.836878180000002,6.294449450000001,6.311881,15156304,12413293.2,57.30567652565374,0.3009796665346048,1.5,2.75,NaN,NaN,0.1666335938020427,1.2209736574980765,235.43202014357456,-0.0285938984032314,0.15328928736526581,0.1818831857684972,43.062946587481214,-2.370896441102449,64.62222373900869,9.98721641801191,25.39055984297939,4528209604
1296570600,6.466603,6.681599,6.459101,6.645767,6.111018172413792,6.55050923076923,6.502435,3.176635,4.239124,3.176635,5.623277,3.707464,4.862452,2.454976,4.680553624999998,5.296651169999997,5.8679945400000015,6.320365850000001,5.921029039896689,6.295212259337483,6.398096076923078,6.641652827050419,6.154539326795738,4.680553624999998,5.296651169999997,5.8679945400000015,6.320365850000001,6.595489000000001,17385940,12515385.4,65.81495361131965,4.130839031644168,1.5,2.75,NaN,NaN,0.17854047995903968,1.3891653708083171,240.62157762464315,-0.012403057320969912,0.16637936411728482,0.17878242143825473,50.80540435496646,5.601173952492115,65.8759688916329,9.336956531138988,24.787074577228104,4545595544
1296657000,6.603268,6.6716,6.584934,6.610767,6.1365353103448275,6.569291076923077,6.502435,3.176635,4.239124,3.176635,5.623277,3.707464,4.862452,2.454976,4.686228564999998,5.322492569999997,5.897552580000003,6.346032250000001,5.9480775873517215,6.3252650917815325,6.41989076923077,6.684088019153165,6.155693519308375,4.686228564999998,5.322492569999997,5.897552580000003,6.346032250000001,6.622433666666666,8741568,12290335,64.19394517965719,3.2340628467411876,1.5,2.75,NaN,NaN,0.17197801710482258,0.7112554702536587,239.26284518366964,-0.0054683064827896755,0.17194703833476765,0.17741534481755733,46.15304487037211,5.712717683365898,46.323876450261146,21.866811567105255,31.809311982633595,4536853976
1296743400,6.583268,6.687433,6.474102,6.6591,6.162052448275862,6.588072923076922,6.502435,3.176635,4.239124,3.176635,5.623277,3.707464,4.862452,2.454976,4.692220169999998,5.347425639999996,5.928068920000003,6.369407000000002,5.9759608192202816,6.357058892564243,6.436429076923077,6.729912021849602,6.142946131996553,4.692220169999998,5.347425639999996,5.928068920000003,6.369407000000002,6.6068783333333325,11728424,12167576.2,65.45913108269019,2.989234628272889,1.5,2.75,NaN,NaN,0.17493180159733526,0.9639079967298665,240.68000196163507,0.0006319559681118303,0.17820528977769712,0.1775733338095853,45.59723931664841,5.799014442722898,47.548574026323216,20.92558627787554,31.52583969580125,4548582400
1296829800,6.670767,6.72235,6.579935,6.710766,6.187569586206896,6.606854769230768,6.502435,3.176635,4.239124,3.176635,5.623277,3.707464,4.862452,2.454976,4.6982117349999974,5.372933719999997,5.964135220000003,6.396948400000001,6.004776708662623,6.390745283748601,6.452454538461538,6.7794431958433785,6.125465881079697,4.6982117349999974,5.372933719999997,5.964135220000003,6.396948400000001,6.671016999999999,10026340,12102566.2,66.80921620354489,3.103519883284688,1.5,2.75,NaN,NaN,0.1726091729118113,0.8284474411716087,239.99475367277088,0.006100655344734751,0.1851991529905037,0.17909849764576896,45.60482143935171,4.843121193719054,83.8881938793229,2.282385238676693,13.829420882000404,4558608740
1297089000,6.764932,6.910763,6.76215,6.847432,6.213086724137931,6.6256366153846145,6.502435,3.176635,4.239124,3.176635,5.623277,3.707464,4.862452,2.454976,4.704332509999998,5.399341789999998,5.998301560000003,6.432823050000001,6.037822014205266,6.434239256724925,6.495082384615385,6.869058890270312,6.121105878960458,4.704332509999998,5.399341789999998,5.998301560000003,6.432823050000001,6.840115000000001,9830940,11746105.6,70.1345640296721,4.650754413626355,1.5,2.75,NaN,NaN,0.17456544627525342,0.8369531430059679,243.50870103819292,0.016297421760824327,0.19947027484679936,0.18317285308597503,45.92345175724104,6.908671686961434,83.43622587746233,2.4099955811309135,14.153778541406766,4568439680
1297175400,6.869097,6.946597,6.807432,6.936931,6.238603862068965,6.644418461538461,6.502435,3.176635,4.239124,3.176635,5.623277,3.707464,4.862452,2.454976,4.711182029999997,5.426678189999997,6.036424680000003,6.473922650000001,6.073081190118785,6.482114660846361,6.547652384615384,6.961077596797737,6.1342271724330315,4.711182029999997,5.426678189999997,6.036424680000003,6.473922650000001,6.896986666666666,7791820,11662253.6,72.10553398881086,4.65694786080253,1.5,2.75,NaN,NaN,0.17203684296987815,0.6681230118336648,246.27757565916562,0.025875884784373027,0.2155177090664413,0.18964182428206827,45.87008606452444,6.764146159215138,79.84184763024155,3.4919546016136063,16.66619776814486,4576231500
1297261800,6.891598,6.946513,6.792431,6.896597,6.264120999999999,6.663200307692307,6.502435,3.176635,4.239124,3.176635,5.623277,3.707464,4.862452,2.454976,4.719806939999997,5.453561249999996,6.074224280000003,6.5095889000000025,6.105375927761186,6.521589169337184,6.593997999999999,7.018278013538228,6.16971798646177,4.719806939999997,5.453561249999996,6.074224280000003,6.5095889000000025,6.878513666666667,10887264,11568120.6,69.86771237421965,3.5166826773705155,1.5,2.75,NaN,NaN,0.17075435418631546,0.9411437152548358,243.7391749301889,0.026220073238633346,0.22241691583035994,0.1961968425917266,46.30409751499388,5.265827390892701,74.34651250049697,5.489381772847908,20.16410572665512,4565344236
1297348200,6.786599,6.926597,6.743266,6.908681,6.289638137931034,6.681982153846153,6.502435,3.176635,4.239124,3.176635,5.623277,3.707464,4.862452,2.454976,4.7279464399999975,5.478631829999997,6.114148880000004,6.537276150000002,6.136878087456825,6.558455057971738,6.633068153846153,7.0722589188477345,6.193877388844572,4.7279464399999975,5.478631829999997,6.114148880000004,6.537276150000002,6.859514666666667,9281120,11546710,70.16644726384811,3.0486914274013883,1.5,2.75,NaN,NaN,0.17165268603015008,0.8037891312763549,245.06116719620331,0.02404378781428282,0.22625157735958012,0.2022077895452973,46.33549530692876,11.222173853967497,73.07554330556249,6.008881832675989,20.91557486176153,4574625356
1297434600,6.829933,7.059929,6.824931,7.039096,6.315155275862068,6.7007639999999995,6.502435,3.176635,4.239124,3.176635,5.623277,3.707464,4.862452,2.454976,4.735742199999997,5.505264899999997,6.150448520000003,6.572859150000002,6.1722591820663615,6.6042303857839535,6.681849692307692,7.148842279304289,6.214857105311094,4.735742199999997,5.505264899999997,6.150448520000003,6.572859150000002,6.974652,15395180,11899593.4,73.24890365420404,4.278451403959446,1.5,2.75,NaN,NaN,0.1761773513137108,1.2937568102116834,249.01883796254262,0.027898609991819145,0.23708105203507124,0.2091824420432521,27.74910591643458,10.88213180632389,76.50841382129599,4.65501158770949,18.83657459099451,4590020536
1297693800,7.025763,7.107428,7.00993,7.092429,6.3406724137931025,6.719545846153846,6.502435,3.176635,4.239124,3.176635,5.623277,3.707464,4.862452,2.454976,4.745156269999997,5.533197949999996,6.183731520000004,6.605275500000003,6.20834427296572,6.650725491899768,6.72761846153846,7.228725296176538,6.226511626900383,4.745156269999997,5.533197949999996,6.183731520000004,6.605275500000003,7.069929,10835580,11880984.8,74.41319373782073,4.274667861494718,1.5,2.75,NaN,NaN,0.17055739764844574,0.9120102569275234,250.68352605365098,0.030348757686035455,0.24711838915079642,0.21676963146476097,27.209048827419767,6.720999998946696,77.48480661645225,4.308424928340274,18.206768455207488,4600856116
1297780200,7.030763,7.058263,6.970763,7.024264,6.366189551724137,6.738327692307692,6.502435,3.176635,4.239124,3.176635,5.623277,3.707464,4.862452,2.454976,4.753244524999997,5.561486019999997,6.214651220000004,6.631366950000003,6.24034112500628,6.686300587909313,6.763977153846152,7.27716694157166,6.250787366120645,4.753244524999997,5.561486019999997,6.214651220000004,6.631366950000003,7.017763333333334,7984768,11715836.6,70.20735758758974,2.898223230157416,1.5,2.75,NaN,NaN,0.16706515495927104,0.6815363061652806,248.41988129546985,0.023967152360159144,0.2467285719149599,0.22276141955480075,18.581894043592538,6.254902040867566,57.1192000577835,14.351041458735024,28.529758483481476,4592871348
1297866600,7.094929,7.184096,7.058263,7.155762,6.391706689655171,6.757109538461538,6.502435,3.176635,4.239124,3.176635,5.623277,3.707464,4.862452,2.454976,4.763915254999997,5.588577419999996,6.2485008800000035,6.6744915500000035,6.276239982849171,6.731011198584617,6.8366046923076915,7.278885357587372,6.394324027028011,4.763915254999997,5.588577419999996,6.2485008800000035,6.6744915500000035,7.132707,11973476,11620118.8,73.33802616919209,4.0095090764470935,1.5,2.75,NaN,NaN,0.16654850103360888,1.0304090866953959,252.24791553693714,0.02507190985960303,0.25410130687930454,0.2290293970197015,18.536480850857647,7.458395278641268,84.43139594408053,2.1482818575304026,13.420322198389066,4604844824
1297953000,7.104096,7.249928,7.084929,7.226594,6.417223827586206,6.7758913846153845,6.502435,3.176635,4.239124,3.176635,5.623277,3.707464,4.862452,2.454976,4.775469299999997,5.616843799999995,6.283617200000004,6.723145200000003,6.313508767835478,6.778209560624177,6.904168153846153,7.292464964085906,6.5158713436064,4.775469299999997,5.616843799999995,6.283617200000004,6.723145200000003,7.187150333333332,9909024,11535963.8,74.86988115274437,4.361142086025204,1.5,2.75,NaN,NaN,0.16643782238835111,0.8589680213802334,254.98381548299722,0.026882354982104117,0.26263234074733166,0.23574998576522754,18.56258780426785,7.686574081110873,84.75883298211387,2.063344284208824,13.17782273367729,4614753848
1298039400,7.237428,7.288261,7.180762,7.255762,6.44274096551724,7.288261,6.502435,3.176635,4.239124,3.176635,5.623277,3.707464,4.862452,2.454976,4.789639954999997,5.644851859999996,6.318416880000004,6.771228100000004,6.350459874979185,6.823690745326636,6.951090846153845,7.350413854174514,6.551767838133177,4.789639954999997,5.644851859999996,6.318416880000004,6.771228100000004,7.241595,7835680,11528207,75.49426956970996,3.8311370875333197,1.5,2.75,NaN,NaN,0.16222790650346894,0.6796963309211919,256.9061350454009,0.026320035440311335,0.2686500300656167,0.24232999462530538,18.715850228839177,5.963257466448727,82.18792900462276,2.771850088664323,15.040220906712932,4622589528
1298385000,7.031596,7.145762,6.753349,6.806598,6.468258103448275,7.3140941,6.502435,3.176635,4.239124,3.176635,5.623277,3.707464,4.862452,2.454976,4.802660659999997,5.668668269999996,6.343033280000003,6.791519550000004,6.368347644587844,6.822062864819338,6.966154769230768,7.325790991243345,6.606518547218192,4.802660659999997,5.668668269999996,6.343033280000003,6.791519550000004,6.901903000000001,21597284,12248563.4,53.46454226849923,1.9317166834258468,1.5,2.75,NaN,NaN,0.18652684175322112,1.763250374325531,250.48016403330664,-0.006286028759395573,0.23447245867606092,0.2407584874354565,43.74579750031735,-1.8788279716203065,35.82911812887242,30.912436000668595,33.25844587045897,4600992244
1298471400,6.800765,6.848264,6.529102,6.675767,6.49377524137931,7.3399272,6.502435,3.176635,4.239124,3.176635,5.623277,3.707464,4.862452,2.454976,4.812198064999997,5.691468049999995,6.363049740000004,6.805061100000005,6.3804033055844,6.808129925312734,6.967436846153845,7.3227786085922455,6.612095083715444,4.812198064999997,5.691468049999995,6.363049740000004,6.805061100000005,6.684377666666666,15831156,12255260,48.981076455578695,3.4000393952711385,1.5,2.75,NaN,NaN,0.1960007816279911,1.291784588821453,247.35907824938653,-0.03693763204872874,0.19458644737454556,0.2315240794232743,44.013493992234366,-3.2020139787782336,28.648519558007777,38.26400770350078,33.087472738491456,4585161088
1298557800,6.648267,6.736599,6.465769,6.659933,6.519292379310344,7.365760300000001,6.502435,3.176635,4.239124,3.176635,5.623277,3.707464,4.862452,2.454976,4.821802134999997,5.713609479999995,6.3826162200000045,6.813186000000004,6.391365254385011,6.794015932425807,6.963526615384613,7.330992017128077,6.59606121364115,4.821802134999997,5.713609479999995,6.3826162200000045,6.813186000000004,6.620766999999999,21319580,12748637.8,48.45151057733261,3.719848013106396,1.5,2.75,NaN,NaN,0.2013457257974203,1.6723025890656333,247.93321205750937,-0.05733438118864656,0.1598561029374661,0.21719048412611267,44.000927460608224,-3.6005136146827446,7.656263306070236,69.32094680660497,23.022789887324812,4563841508
1298644200,6.739933,6.892432,6.728267,6.879931,6.5448095172413785,7.3915934000000005,6.502435,3.176635,4.239124,3.176635,5.623277,3.707464,4.862452,2.454976,4.831472864999998,5.738955059999996,6.406299300000004,6.8296025000000045,6.410524695389521,6.802198319813825,6.966026538461536,7.330730503551551,6.6013225733715215,4.831472864999998,5.738955059999996,6.406299300000004,6.8296025000000045,6.833543333333334,13122308,12884893.2,55.629442425461185,0.599873181224688,1.5,2.75,NaN,NaN,0.20357095966903319,1.0184258259897723,253.39883332805272,-0.0550534311775768,0.14837369515414167,0.20342712633171847,48.624535544799194,-2.261156830365714,9.499043590901206,65.56175694473676,24.939199464362037,4576963816
1298903400,6.966598,7.039096,6.88743,7.012429,6.570326655172413,7.4174265,7.255762,3.176635,4.239124,3.176635,5.623277,3.707464,4.862452,2.454976,4.842672749999997,5.763028149999996,6.434190680000004,6.869643750000004,6.4341287857664025,6.822220289355365,6.971834076923074,7.336904090243985,6.606764063602164,4.842672749999997,5.763028149999996,6.434190680000004,6.869643750000004,6.979651666666666,15366560,12600015.8,59.30481746549814,1.2718271425059144,1.5,2.75,NaN,NaN,0.20039910540695938,1.2195667246702975,255.04002390001762,-0.044136677525607515,0.1482562794247091,0.1923929569503166,48.678724433973926,-1.127963353598606,15.363413592058667,55.52698819245007,29.10959821549128,4592330376
1298989800,7.083263,7.095762,6.652433,6.658892,6.595843793103447,7.4432596,7.255762,3.176635,4.239124,3.176635,5.623277,3.707464,4.862452,2.454976,4.853434099999998,5.783655029999995,6.453086320000003,6.885174900000005,6.442943029461838,6.806665214178664,6.953549076923074,7.353961580522097,6.553136573324051,4.853434099999998,5.783655029999995,6.453086320000003,6.885174900000005,6.802362333333332,23143524,12999376.8,47.90288046208159,2.328848041611406,1.5,2.75,NaN,NaN,0.21775124073503369,1.7803564244710561,250.2411269679398,-0.059296465537962056,0.11827237502786403,0.17756884056582609,56.39958014656349,-5.201569872658543,14.982605925327555,56.118194482794394,28.899199591878062,4569186852
1299076200,6.624101,6.795765,6.611601,6.693267,6.621360931034482,7.4690927,7.255762,3.176635,4.239124,3.176635,5.623277,3.707464,4.862452,2.454976,4.864325664999997,5.804779819999996,6.471919480000004,6.887549900000005,6.452759655757452,6.795865384256886,6.936978769230767,7.3606031316282925,6.513354406833241,4.864325664999997,5.804779819999996,6.471919480000004,6.887549900000005,6.7002109999999995,15448724,12902516,48.930988218375234,1.9979404300256232,1.5,2.75,NaN,NaN,0.21535215211110273,1.1973419757820878,253.04867980647668,-0.06511503729474294,0.0961750439473974,0.16129008124214034,56.716145140195884,-6.463252970123944,35.56341000870676,31.22482300837746,33.21176698291577,4584635576
1299162600,6.88743,7.071596,6.882431,7.039096,6.646878068965517,7.494925800000001,7.255762,3.176635,4.239124,3.176635,5.623277,3.707464,4.862452,2.454976,4.877863029999997,5.828554579999995,6.497069220000003,6.9089663500000045,6.475753237884611,6.819030204803849,6.936978769230767,7.3606031316282925,6.513354406833241,4.877863029999997,5.828554579999995,6.497069220000003,6.9089663500000045,6.997707666666668,19182332,13424554.2,57.92668897468716,2.5213871769317673,1.5,2.75,NaN,NaN,0.2269933555317383,1.4288989946496697,257.4379059481159,-0.044749019517659194,0.10535380684506634,0.15010282636272554,63.97398463977326,-2.594555609461395,69.00670295181997,7.828570807326081,23.164726240853952,4603817908
1299249000,7.040764,7.056595,6.763274,6.895764,6.672395206896551,7.520758900000001,7.255762,3.176635,4.239124,3.176635,5.623277,3.707464,4.862452,2.454976,4.891106644999997,5.8507126899999955,6.517035680000003,6.920799550000005,6.492224248163645,6.826338185298721,6.92185069230769,7.336132618262902,6.507568766352478,4.891106644999997,5.8507126899999955,6.517035680000003,6.920799550000005,6.905211,29042436,14290254.8,53.70434684587382,1.122348079252632,1.5,2.75,NaN,NaN,0.2317310444223284,2.0323245740866707,254.43790594811588,-0.04015374878910424,0.09991064037634523,0.14006438916544947,64.35407841393085,-4.961546423380481,34.167083625875165,32.58050461206891,33.25241176205594,4574775472
1299508200,6.958264,6.99993,6.611601,6.719099,6.697912344827586,7.546592,7.255762,3.176635,4.239124,3.176635,5.623277,3.707464,4.862452,2.454976,4.905898159999997,5.870637489999996,6.532418860000002,6.921216200000005,6.501121297255267,6.816124929555985,6.89837646153846,7.321279312928971,6.475473610147948,4.905898159999997,5.870637489999996,6.532418860000002,6.921216200000005,6.776876666666666,16850424,14631459,48.966651185949765,1.91684373004336,1.5,2.75,NaN,NaN,0.24291661267787634,1.1516571245560678,250.28823364541773,-0.047719884137616186,0.08041453399342924,0.12813441813104542,65.16140502033437,-1.2855026843072004,15.973177900843977,54.63817365079073,29.388648448365274,4557925048
1299594600,6.761599,6.958264,6.663268,6.894932,6.72342948275862,7.5724251,7.255762,3.176635,4.239124,3.176635,5.623277,3.707464,4.862452,2.454976,4.920814679999998,5.891303959999996,6.551818660000001,6.923591200000006,6.516564854225648,6.823630364836368,6.878312615384614,7.274363686871837,6.4822615438973905,4.920814679999998,5.891303959999996,6.551818660000001,6.923591200000006,6.838821333333333,17277856,15003804.8,53.37532612608727,1.122787829548961,1.5,2.75,NaN,NaN,0.24663656891517086,1.1515649683738887,254.65844707637265,-0.03990756176314311,0.07824996592711653,0.11815752769025964,56.643617650073004,3.2829935496550475,39.90166492634239,27.278253713763885,32.82008135989374,4575202904
1299681000,6.847432,6.926597,6.743266,6.864931,6.7489466206896545,7.5982582,7.255762,3.176635,4.239124,3.176635,5.623277,3.707464,4.862452,2.454976,4.936264524999998,5.9121204199999955,6.5705184600000015,6.919991200000007,6.530226271706995,6.8275637586614755,6.850492384615382,7.191802558515482,6.509182210715283,4.936264524999998,5.9121204199999955,6.5705184600000015,6.919991200000007,6.844931333333332,19610284,15594728,52.54130907735065,0.24024860480781016,1.5,2.75,NaN,NaN,0.24211474256408722,1.2574944558186587,253.55260279878874,-0.035910742474775575,0.07326909959679018,0.10917984207156575,55.27677441340458,3.078079013707806,18.454306904609258,51.02057210745544,30.52512098793529,4555592620
1299767400,6.646599,6.649099,6.464103,6.489102,6.774463758620689,7.624091300000001,7.255762,3.176635,4.239124,3.176635,5.623277,3.707464,4.862452,2.454976,4.949801889999998,5.928970259999995,6.581401680000002,6.899616450000008,6.528613555169466,6.7953293054556205,6.791518538461536,7.095212576381399,6.487824500541673,4.949801889999998,5.928970259999995,6.581401680000002,6.899616450000008,6.534101333333333,25142132,16307471.4,43.393826762381806,4.363594270529955,1.5,2.75,NaN,NaN,0.2534514038095096,1.5417553944016116,248.55260279878874,-0.05650301367036567,0.03855107498360866,0.09505408865397433,64.91784822296681,-5.680711042014813,3.4213225110064402,80.10939785421606,16.46927963477751,4530450488
1299853800,6.41327,6.681475,6.412436,6.610767,6.799980896551723,7.649924400000001,7.255762,3.176635,4.239124,3.176635,5.623277,3.707464,4.862452,2.454976,4.964224244999998,5.946736759999996,6.594169860000002,6.8847207500000085,6.531835258888311,6.777751943031276,6.776454615384613,7.094739184984294,6.458170045784931,4.964224244999998,5.946736759999996,6.594169860000002,6.8847207500000085,6.568225999999999,15386264,16612728.6,46.63299549317802,3.1342762073162187,1.5,2.75,NaN,NaN,0.2545648035374018,0.9261731995067927,251.50933546192167,-0.05955008288742521,0.020616485044692823,0.08016656793211803,62.620042976021054,-5.72785834979577,17.164358885274776,52.868347465039896,29.96729364968534,4545836752
1300109400,6.484936,6.564101,6.348269,6.497435,6.825498034482758,7.6757575000000005,7.255762,3.176635,4.239124,3.176635,5.623277,3.707464,4.862452,2.454976,4.976211624999998,5.965003239999995,6.605103080000001,6.857637700000008,6.530486229127985,6.7510550913140115,6.7627367692307665,7.111143731752518,6.414329806709015,4.976211624999998,5.965003239999995,6.605103080000001,6.857637700000008,6.4699349999999995,21364652,16911202.2,44.101403232898505,4.2776650404521215,1.5,2.75,NaN,NaN,0.2551314604275874,1.2633431820713492,247.7113096589551,-0.06630165986750326,-0.002710506902261045,0.06359115296524222,61.18308791030591,-2.424682664923827,14.179897895645121,57.32226010404777,28.497842000307113,4524472100
1300195800,5.991606,6.396602,5.95994,6.294104,6.851015172413792,7.7015906,7.255762,3.176635,4.239124,3.176635,5.623277,3.707464,4.862452,2.454976,4.9878573449999974,5.979853089999994,6.611819680000001,6.817721450000008,6.521216337789633,6.707535939760296,6.734596076923075,7.161845765616096,6.307346388230053,4.9878573449999974,5.979853089999994,6.611819680000001,6.817721450000008,6.216881999999999,28379560,17788401.2,39.914727357882285,7.2408046885823,1.5,2.75,NaN,NaN,0.27530028468275974,1.595396892667341,242.92243366000363,-0.08061363275509256,-0.03717588797862348,0.04343774477646908,56.85125372746314,-5.963649739357472,2.2227374054641613,84.10999631766704,13.6672662768688,4496092540
1300282200,6.229937,6.295687,5.819942,5.955774,5.819942,7.7274237,7.255762,3.176635,4.239124,3.176635,5.623277,3.707464,4.862452,2.454976,4.998944734999998,5.991002979999995,6.608386380000002,6.764296950000007,6.4990421284645485,6.63593956454503,6.663507076923076,7.2487109609868785,6.0783031928592735,4.998944734999998,5.991002979999995,6.608386380000002,6.764296950000007,6.023801,41444236,19461374.6,34.11184533467738,9.465224254663887,1.5,2.75,NaN,NaN,0.2896177643482769,2.1295636537410876,237.9450655252976,-0.10734564408233013,-0.09074431032644359,0.01660133375588654,62.88942136350792,-15.390072816168438,1.6346943930163313,86.4805238246509,11.884781782332748,4454648304
1300368600,6.199937,6.247438,6.065772,6.152438,5.832573890243903,7.753256800000001,7.255762,3.176635,4.239124,3.176635,5.623277,3.707464,4.862452,2.454976,5.009548794999997,6.003769519999995,6.609486360000002,6.714130750000007,6.485449809701233,6.589891796493122,6.5973539230769225,7.203872520751052,5.990835325402793,5.009548794999997,6.003769519999995,6.609486360000002,6.714130750000007,6.155215999999999,22214932,19973447.4,39.608000969714766,5.859937400295799,1.5,2.75,NaN,NaN,0.2897639240376857,1.112223220914783,242.53387178151968,-0.10607422900796093,-0.11599145250406462,-0.009917223496103692,57.00724316135771,-10.779458229718994,10.867654281722503,62.981378419583564,26.15096729869394,4476863236
1300455000,6.384936,6.394937,6.195772,6.236388,5.845205780487805,7.779089900000001,7.255762,3.176635,4.239124,3.176635,5.623277,3.707464,4.862452,2.454976,5.020301774999997,6.016896379999995,6.610382020000002,6.664620450000006,6.475682679909028,6.556224768255682,6.5648536153846155,7.199334283215238,5.930372947553993,5.020301774999997,6.016896379999995,6.610382020000002,6.664620450000006,6.275699000000001,23302132,20643102.8,41.83833061413989,3.6642550423116695,1.5,2.75,NaN,NaN,0.2863878580349938,1.1288095702357301,246.39068393665505,-0.0942688379957235,-0.12775327099075806,-0.03348443299503456,58.78154938893622,-7.184162638472809,13.935724211515266,57.71599976634353,28.348276022141214,4500165368
1300714200,6.453269,6.562434,6.439936,6.523268,5.8578376707317075,7.8049230000000005,7.255762,3.176635,4.239124,3.176635,5.623277,3.707464,4.862452,2.454976,5.034572464999997,6.032904539999995,6.617648620000001,6.627995750000006,6.477548770892987,6.5530860284218075,6.551776769230769,7.18212585403142,5.921427684430118,5.034572464999997,6.032904539999995,6.617648620000001,6.627995750000006,6.508546,16182052,21060421.4,48.79732600180297,0.6383081156997779,1.5,2.75,NaN,NaN,0.2892205824610657,0.7683631629517157,251.50177850350008,-0.06331443677806625,-0.11262747896761738,-0.049313042189551126,65.45585603692086,-5.390393987932005,30.14098844607408,36.6316731856324,33.22733836829352,4516347420
1300800600,6.521601,6.550768,6.437436,6.453269,5.87046956097561,7.8307561,7.255762,3.176635,4.239124,3.176635,5.623277,3.707464,4.862452,2.454976,5.049293149999998,6.048537729999995,6.624115220000001,6.610329300000006,6.476596623014831,6.543579644762588,6.506713153846154,7.071630891524207,5.941795416168101,5.049293149999998,6.048537729999995,6.624115220000001,6.610329300000006,6.480491,16480196,20804567,47.30989138946619,0.19813885898975298,1.5,2.75,NaN,NaN,0.2766571122852753,0.7921431866378185,249.38666994587797,-0.04461136544015289,-0.10507724898974224,-0.06046588354958935,62.891621431737015,-5.9965934107713625,36.328731553231165,30.425696318942887,33.245572127825945,4499867224
1300887000,6.395769,6.559102,6.307437,6.508269,5.883101451219512,7.8565892,7.255762,5.955774,4.239124,3.176635,5.623277,3.707464,4.862452,2.454976,5.063793424999997,6.064670899999995,6.631981820000001,6.6019544000000066,6.477838677014249,6.54021672621377,6.476905846153846,6.99556412722017,5.958247565087522,5.063793424999997,6.064670899999995,6.631981820000001,6.6019544000000066,6.458269333333334,12094536,20617736,48.63474188044901,0.6929546232300575,1.5,2.75,NaN,NaN,0.2748719614077556,0.5866083453585786,250.6212839927202,-0.026488813742722356,-0.0935769007279923,-0.06708808698526994,63.48831155276316,0.29537214856540056,78.03293284701212,4.093971192300125,17.87309596068776,4511961760
1300973400,6.613267,6.726599,6.504935,6.700766,5.895733341463415,7.882422300000001,7.255762,5.955774,4.239124,3.176635,5.623277,3.707464,4.862452,2.454976,5.079514104999998,6.082545709999996,6.642331700000001,6.603996050000006,6.486580924974475,6.55550713324103,6.475495615384616,6.991605571360033,5.9593856594091985,5.079514104999998,6.082545709999996,6.642331700000001,6.603996050000006,6.644099999999999,16792112,20391362.6,53.08135362478529,2.611696044911989,1.5,2.75,NaN,NaN,0.27107139273577313,0.8234914129769827,253.58869962851435,-0.000845023928893851,-0.06814436689638725,-0.0672993429674934,57.010163497839905,1.3614002732209396,76.9281483954452,4.489090398687345,18.58276120586744,4528753872
1301059800,6.758267,6.859098,6.708266,6.766183,5.908365231707317,7.908255400000001,7.255762,5.955774,4.239124,3.176635,5.623277,3.707464,4.862452,2.454976,5.093966049999997,6.1010746899999955,6.650556640000001,6.598308650000007,6.4975457122303775,6.575571501503789,6.465591846153846,6.953285951443278,5.977897740864415,5.093966049999997,6.1010746899999955,6.650556640000001,6.598308650000007,6.777849000000001,16101148,20540304.6,54.52217699586765,3.6681761889517994,1.5,2.75,NaN,NaN,0.2630185789689322,0.7838806830547196,256.63381494204964,0.020060619651818448,-0.042223568402720346,-0.062284188054538794,56.36099534451081,4.136216830179902,75.04661108385685,5.199779892097662,19.753609024045502,4544855020
1301319000,6.813257,6.863265,6.710766,6.717433,5.92099712195122,7.9340885000000005,7.255762,5.955774,7.255762,3.176635,4.239124,3.707464,5.623277,2.454976,5.107903409999997,6.117949519999996,6.65835658,6.583558850000007,6.506168743123304,6.5890821204081895,6.454245846153847,6.9100719603528376,5.998419731954856,5.107903409999997,6.117949519999996,6.65835658,6.583558850000007,6.763821333333333,9095860,20226769.6,53.210781795211254,2.9776286329976527,1.5,2.75,NaN,NaN,0.2551243233282942,0.4496941518530967,254.5521489425835,0.029568983150216402,-0.025322959116768295,-0.0548919422669847,55.36914838123242,6.725802433515554,54.984183738269294,15.708070170938669,29.307746090792026,4535759160
1301405400,6.698266,6.854931,6.6316,6.854098,5.933629012195122,7.9599216,7.255762,5.955774,7.255762,3.176635,4.239124,3.707464,5.623277,2.454976,5.122565764999997,6.135549339999996,6.666556500000001,6.593319150000006,6.519813027706704,6.6143217279883615,6.482322461538461,6.985755488760776,5.978889434316145,5.122565764999997,6.135549339999996,6.666556500000001,6.593319150000006,6.780209666666667,12364536,19687820.2,56.37837641433303,3.1978117550381193,1.5,2.75,NaN,NaN,0.25285337166198746,0.6280297094545795,257.9626590140198,0.043200666611577364,-0.0008911090025129909,-0.044091775614090355,51.18734562232301,15.083245267533652,85.12067568503174,1.9689628270864266,12.910361487881831,4548123696
1301491800,6.957431,7.058263,6.932431,7.007014,5.9462609024390245,7.9857547,7.255762,5.955774,7.255762,3.176635,4.239124,3.707464,5.623277,2.454976,5.136671879999997,6.151945019999997,6.676648080000002,6.609006500000007,6.538918948188794,6.65172099198947,6.512803,7.086702222208649,5.938903777791351,5.136671879999997,6.151945019999997,6.676648080000002,6.609006500000007,6.999236000000001,12421192,19536443.6,59.66847392759281,5.032907222223232,1.5,2.75,NaN,NaN,0.24937563082898842,0.6357959644200544,261.98873679836294,0.05964080956830614,0.03045923634629233,-0.029181573222013816,31.3737496085534,13.890038388034139,85.42446461657185,1.8932519685906155,12.682283414837526,4560544888
1301578200,6.983264,7.039096,6.958264,6.987431,5.958892792682927,8.011587800000001,7.255762,5.955774,7.255762,3.176635,4.239124,3.707464,5.623277,2.454976,5.150713414999997,6.167386529999998,6.690531300000003,6.606423250000006,6.5565076561029585,6.683693373704759,6.550495,7.177327738037582,5.923662261962417,5.150713414999997,6.167386529999998,6.690531300000003,6.606423250000006,6.9949303333333335,9028336,19028743.8,59.05419071838997,4.258057044438162,1.5,2.75,NaN,NaN,0.23733680005548924,0.4744578041982992,264.39012528560664,0.06583500440800419,0.053112182287991416,-0.012722822120012769,31.228280928144006,12.04291650872268,62.40858395583082,11.211982017063749,26.379434027105447,4551516552
1301664600,7.111596,7.166595,7.026597,7.074928,5.971524682926829,8.0374209,7.255762,5.955774,7.255762,3.176635,4.239124,3.707464,5.623277,2.454976,5.165134099999997,6.183944689999997,6.706959440000003,6.615381450000006,6.576837865667549,6.7209538143043055,6.610558384615384,7.276055852488987,5.945060916741781,5.165134099999997,6.183944689999997,6.706959440000003,6.615381450000006,7.0893733333333335,12233112,18188277.6,60.98675696169665,4.573803998423225,1.5,2.75,NaN,NaN,0.23318160005152572,0.6725822130623297,267.85868807659824,0.07196607168552635,0.07723476748689517,0.005268695801368822,31.22403780387799,8.456804166255319,59.82701357894172,12.692501657147655,27.480484763910624,4563749664
1301923800,7.127429,7.159095,7.03743,7.095762,5.984156573170732,8.063254,7.255762,5.955774,7.255762,3.176635,4.239124,3.707464,5.623277,2.454976,5.1796006249999955,6.201977849999997,6.722992600000002,6.634214600000007,6.597187831719801,6.75664983198961,6.6982497692307685,7.292088698715163,6.104410839746374,5.1796006249999955,6.201977849999997,6.722992600000002,6.634214600000007,7.097428999999999,9105268,17801019.8,61.453283655787146,4.009558378442506,1.5,2.75,NaN,NaN,0.2252161286192739,0.5115026050361452,269.1866032766867,0.07331786899457648,0.09691603204458943,0.023598163050012944,23.715643489344927,9.956085822549781,81.5777776772571,2.9437671361617292,15.478455186581163,4572854932
1302010200,7.054095,7.195695,7.04993,7.095762,5.996788463414634,8.0890871,7.255762,5.955774,7.255762,3.176635,4.239124,3.707464,5.623277,2.454976,5.1943129749999954,6.219302669999998,6.736892460000002,6.644256100000007,6.616739759887652,6.78894622894298,6.770813153846152,7.307970886019055,6.23365542167325,5.1943129749999954,6.219302669999998,6.736892460000002,6.644256100000007,7.113795666666668,9911532,17432703.6,61.453283655787146,3.856213859654669,1.5,2.75,NaN,NaN,0.2195410480036115,0.5685596581817636,270.8558320765595,0.07010656556645953,0.11123137000808736,0.04112480444162783,21.2001616468912,9.026870278410424,75.55277473522318,5.0115262192772425,19.43569904549959,4572854932
1302096600,7.194928,7.221712,7.073263,7.151596,6.009420353658537,8.1149202,7.255762,5.955774,7.255762,3.176635,4.239124,3.707464,5.623277,2.454976,5.2103519849999955,6.237619159999998,6.751825660000001,6.658589350000007,6.637714514401862,6.823484302376982,6.841213769230767,7.316026775165105,6.366400763296428,5.2103519849999955,6.237619159999998,6.751825660000001,6.658589350000007,7.148857,9066820,16905530.4,62.83461703605961,3.5365643435116403,1.5,2.75,NaN,NaN,0.21446304457478213,0.5363227172097481,272.8534034174973,0.06760694922793539,0.12563349097654708,0.05802654174861169,21.21463878680805,6.728036764751968,73.29549620340968,5.912190559232353,20.792313237357977,4581921752
1302183000,7.117429,7.198844,6.993263,7.094929,6.022052243902439,8.1407533,7.255762,5.955774,7.255762,3.176635,4.239124,3.707464,5.623277,2.454976,5.226301824999996,6.257435629999998,6.76377554,6.6888807000000075,6.65564449422924,6.849336178341079,6.88518769230769,7.3395165290892805,6.430858855526099,5.226301824999996,6.257435629999998,6.76377554,6.6888807000000075,7.095678666666668,11657876,16231317.6,60.46629560919562,2.4146107561666534,1.5,2.75,NaN,NaN,0.2138286128194406,0.718233496952829,269.96088433084174,0.058350797678463434,0.13096503884669097,0.07261424116822754,19.18626987784842,4.858662557604483,66.19899200076347,9.179245600097424,24.621762399139097,4570263876
1302269400,7.174095,7.198261,6.926597,7.010847,6.0346841341463415,8.1665864,7.255762,5.955774,7.255762,3.176635,4.239124,3.707464,5.623277,2.454976,5.242810414999996,6.276611279999997,6.77296046,6.708884700000008,6.6695740042594664,6.8647181613562145,6.928078307692304,7.310849333875268,6.54530728150934,5.242810414999996,6.276611279999997,6.77296046,6.708884700000008,7.045235000000002,9913740,15957691.4,57.0314025585166,1.5478372557314757,1.5,2.75,NaN,NaN,0.21795971190376623,0.6212515176224049,267.0363960715137,0.04346244898927251,0.12694230240481819,0.08347985341554567,21.418055084814284,4.367948292152676,28.989052198733344,37.90239024090192,33.108557560364716,4560350136
1302528600,7.045763,7.105762,6.88993,6.947431,6.047316024390244,8.1924195,7.255762,5.955774,7.255762,3.176635,4.239124,3.707464,5.623277,2.454976,5.258747759999995,6.297544409999998,6.7876769999999995,6.731384500000007,6.680470357033605,6.872595574560385,6.961859999999996,7.258232129071644,6.665487870928349,5.258747759999995,6.297544409999998,6.7876769999999995,6.731384500000007,6.981041000000001,10901976,15434557.6,54.51601751664098,0.6159419849890088,1.5,2.75,NaN,NaN,0.2178077324820687,0.7063355026126567,263.7708613811208,0.0270442162144741,0.1172851236836383,0.0902409074691642,21.782341589770745,1.3617109063803923,6.287327757096197,72.41490910957509,21.29776313332872,4549448160
1302615000,6.830765,6.868265,6.710766,6.784099,6.059947914634146,8.218252600000001,7.255762,5.955774,7.255762,3.176635,4.239124,3.707464,5.623277,2.454976,5.274097604999995,6.316635889999998,6.7963936,6.7558842500000065,6.684534225385228,6.864167329364157,6.968270230769226,7.244710870617059,6.691829590921394,5.274097604999995,6.316635889999998,6.7963936,6.7558842500000065,6.787710000000001,19233120,14977235.6,48.57378689380856,1.9824795182897703,1.5,2.75,NaN,NaN,0.21915468016192094,1.2841568707111746,260.05196521703596,0.004089707688253813,0.09535304207948148,0.09126333439122766,23.885505365134808,-3.181312325050293,2.8733589934997545,81.82220010591733,15.304440900582913,4530215040
1302701400,6.883265,6.899931,6.712433,6.791599,6.072579804878049,8.244085700000001,7.255762,5.955774,7.255762,3.176635,4.239124,3.707464,5.623277,2.454976,5.291214099999994,6.3336523899999975,6.7993102400000005,6.797675500000007,6.688732843997572,6.857256059900904,6.970225307692304,7.241227393193657,6.699223222190951,5.291214099999994,6.3336523899999975,6.7993102400000005,6.797675500000007,6.801320999999999,14033396,13606693.6,48.84949527662445,1.476510177694702,1.5,2.75,NaN,NaN,0.2168934887217837,1.03135974194348,261.1690093569962,-0.010865520708567875,0.07768143350551782,0.08854695421408569,19.0135962071641,-2.8026323265303117,5.616697584830248,74.03014597097642,20.35315644419334,4544248436
1302787800,6.6741,6.834932,6.612435,6.809099,6.085211695121951,8.269918800000001,7.255762,5.955774,7.255762,3.176635,4.239124,3.707464,5.623277,2.454976,5.308968084999995,6.350414729999996,6.803276880000001,6.830508550000007,6.693453085409432,6.852669673243676,6.977276538461535,7.225406964281524,6.729146112641545,5.308968084999995,6.350414729999996,6.803276880000001,6.830508550000007,6.7521553333333335,10769132,13034403.6,49.5294267301955,1.96072085491135,1.5,2.75,NaN,NaN,0.21729373952737063,0.8262082662531641,262.3808131647425,-0.01936003614944551,0.0643469090272788,0.0837069451767243,19.294224255392415,-3.757338590583538,19.736870971762187,49.169359571222245,31.09376945701557,4555017568
1302874200,6.842432,6.935764,6.782432,6.885764,6.097843585365854,8.2957519,7.255762,5.955774,7.255762,3.176635,4.239124,3.707464,5.623277,2.454976,5.327251234999995,6.3679395399999965,6.80781016,6.862977350000007,6.7009946899031805,6.855821513887135,6.9797123846153815,7.223542565470246,6.735882203760517,5.327251234999995,6.3679395399999965,6.80781016,6.862977350000007,6.867986666666667,14952184,12616906.2,52.50781384763319,0.3788111245292233,1.5,2.75,NaN,NaN,0.21272504384684415,1.1850911596695552,265.59148462332456,-0.019539907820125907,0.059282060401566916,0.07882196822169282,18.94956386824552,-2.9594848305227783,44.07439518517158,23.67998012714005,32.245624687688384,4569969752
1303133400,6.652433,6.6916,6.489935,6.647434,6.489935,8.321585,7.255762,5.955774,7.255762,3.176635,4.239124,3.707464,5.623277,2.454976,5.3446052299999955,6.385339369999996,6.80654352,6.8691856500000075,6.698894270691291,6.835975083993122,6.952052384615381,7.252278107103326,6.651826662127437,5.3446052299999955,6.385339369999996,6.80654352,6.8691856500000075,6.6096563333333345,21700176,12892812.4,43.84549540943865,3.640294007186675,1.5,2.75,NaN,NaN,0.22580389785778385,1.68312198508372,260.6031866287059,-0.034556602298669664,0.03562621534835575,0.07018281764702541,26.07976530881688,-6.318250245710046,33.57890714539302,33.09995272820583,33.32114012640115,4548269576
1303219800,6.686601,6.769924,6.632434,6.751599,6.519065130434782,8.3474181,7.255762,5.955774,7.255762,3.176635,4.239124,3.707464,5.623277,2.454976,5.362246724999994,6.401464209999997,6.80462686,6.884102150000007,6.700961122821044,6.827939266469968,6.933911461538458,7.251397755487192,6.616425167589725,5.362246724999994,6.401464209999997,6.80462686,6.884102150000007,6.717985666666666,17680748,12952840,47.89167460801115,1.7679498326152616,1.5,2.75,NaN,NaN,0.21949576229651355,1.3650093724619465,263.83862865513487,-0.03614953768173079,0.024995895544861924,0.061145433226592716,28.873009167616793,-5.59311515918964,66.97523315829419,8.78330076137279,24.241466080333026,4565950324
1303306200,6.998263,7.092429,6.998263,7.055763,6.548195260869565,8.3732512,7.255762,5.955774,7.255762,5.955774,4.239124,3.176635,5.623277,3.707464,5.3798590549999945,6.421714089999997,6.8070034999999995,6.911476850000007,6.714874921926102,6.849636764901399,6.932437230769228,7.247459040475896,6.61741542106256,5.3798590549999945,6.421714089999997,6.8070034999999995,6.911476850000007,7.048818333333333,16188148,13157520.6,57.517559188780176,2.554876132596887,1.5,2.75,NaN,NaN,0.2281624935610483,1.2303342318156811,268.4374259077013,-0.016399355565647956,0.04064623876953277,0.05704559433518073,40.04436107012085,-0.5520280752633299,68.27950865454702,8.147154607951753,23.573336737501243,4582138472
1303392600,7.144929,7.166595,7.083263,7.157845,6.577325391304348,8.3990843,7.255762,5.955774,7.255762,5.955774,4.239124,3.176635,5.623277,3.707464,5.397477629999995,6.443226369999996,6.81222846,6.934330800000008,6.732246297536843,6.878989930148885,6.937212846153843,7.263668452548291,6.610757239759394,5.397477629999995,6.443226369999996,6.81222846,6.934330800000008,7.135901,9054436,12770636.8,60.176444518416524,3.3111960868381085,1.5,2.75,NaN,NaN,0.21978174402097345,0.7090042682914606,271.1832741445277,0.002833918240830187,0.06058799213621846,0.05775407389538827,40.737702546390665,2.096722407435221,67.7041876914363,8.42503616141727,23.870776147146437,4591192908
1303738200,7.151596,7.174095,7.070763,7.142429,6.6064555217391305,8.4249174,7.255762,5.955774,7.255762,5.955774,4.239124,3.176635,5.623277,3.707464,5.414585799999995,6.465526149999996,6.81690342,6.953143100000007,6.748331893711869,6.904079365372801,6.940802615384612,7.275085506375083,6.606519724394142,5.414585799999995,6.465526149999996,6.81690342,6.953143100000007,7.129095666666667,8298092,12380484,59.57009138253325,2.7020841029468707,1.5,2.75,NaN,NaN,0.21146390516233246,0.6702558639872238,269.62326506808483,0.013230057002449995,0.07429164514845077,0.061061588146000774,39.99506397208374,2.806764111799023,47.213312721228924,21.17991627645065,31.60677100232042,4582894816
1303824600,7.211594,7.369092,7.186596,7.32326,6.635585652173913,8.450750500000002,7.255762,5.955774,7.255762,5.955774,4.239124,3.176635,5.623277,3.707464,5.432585624999994,6.486517609999996,6.8225867000000004,6.983434450000007,6.770878093958463,6.944001330575391,6.954007538461536,7.3313441180919074,6.576670958831164,5.432585624999994,6.486517609999996,6.8225867000000004,6.983434450000007,7.292982666666668,9566564,12404019.2,64.13522114506448,4.498210216544908,1.5,2.75,NaN,NaN,0.21254955479359444,0.7712471131937623,273.33755078237056,0.030036139044171545,0.0986067619512152,0.06857062290704366,41.339498782579554,7.947422347462795,84.54230521584448,2.109573479062303,13.348121305093217,4592461380
1303911000,7.371594,7.494925,7.274093,7.463259,6.664715782608695,8.476583600000001,7.255762,5.955774,7.255762,5.955774,4.239124,3.176635,5.623277,3.707464,5.450393779999995,6.506867409999996,6.8300033,7.013892500000007,6.798030286352248,6.993454441949163,6.982340615384613,7.443705372498541,6.520975858270686,5.450393779999995,6.506867409999996,6.8300033,7.013892500000007,7.410758999999999,9611640,12266374.4,67.22111690277191,4.690846594192544,1.5,2.75,NaN,NaN,0.21314115802262346,0.7835762782521949,276.1202406378626,0.047304585475691024,0.12770135475165745,0.08039676927596642,37.447265604356595,9.889570924313997,82.35568715268157,2.7106229703087,14.933689877009746,4602073020
1303997400,7.434093,7.569091,7.425759,7.535757,6.693845913043479,8.502416700000001,7.255762,5.955774,7.255762,5.955774,4.239124,3.176635,5.623277,3.707464,5.468589429999995,6.527442189999996,6.84023316,7.0403296500000065,6.826960745710983,7.045102304620672,7.022718307692306,7.570735461669967,6.474701153714644,5.468589429999995,6.527442189999996,6.84023316,7.0403296500000065,7.510202333333333,12946496,12292639.6,68.72197025016905,5.100730323589395,1.5,2.75,NaN,NaN,0.20815478959243608,1.0531908866831172,278.6044248442312,0.0595420196081651,0.1548242937861728,0.09528227417800769,37.062799040038676,10.671867158929551,81.44118164455531,2.982170105536881,15.576648249907816,4615019516
1304083800,7.546591,7.616391,7.517508,7.600758,6.722976043478261,8.528249800000001,7.255762,5.955774,7.255762,5.955774,4.239124,3.176635,5.623277,3.707464,5.487068414999995,6.548816979999997,6.8491330800000005,7.070996000000008,6.857305736075259,7.098021894656799,7.072974230769229,7.698502256127328,6.44744620541113,5.487068414999995,6.548816979999997,6.8491330800000005,7.070996000000008,7.578219,8979328,12290189.2,70.04623325291078,5.159802971049367,1.5,2.75,NaN,NaN,0.2003496617644049,0.7306094197475821,281.59273540372794,0.0673704568474369,0.17949534523730382,0.11212488838986692,36.75842025924957,10.383655321326724,81.6375084665556,2.9228822643806938,15.439609269063695,4623998844
1304343000,7.705756,7.720673,7.510758,7.55409,6.7521061739130435,7.720673,7.255762,5.955774,7.255762,5.955774,4.239124,3.176635,5.623277,3.707464,5.506964049999996,6.569650099999997,6.855683,7.094954100000008,6.884630609170347,7.141456952308532,7.132204307692306,7.782433644143985,6.481974971240627,5.506964049999996,6.569650099999997,6.855683,7.094954100000008,7.595173666666668,10254916,12191279.4,67.8259193360202,4.57959860066891,1.5,2.75,NaN,NaN,0.20103290020980455,0.8411681550010247,279.46475469733224,0.06474503503489987,0.19305618218349174,0.12831114714859188,38.04765460071704,13.639187692574321,76.47384261389615,4.659930187942539,18.8662271981613,4613743928
1304429400,7.502425,7.544841,7.334092,7.44701,6.781236304347826,7.729497734693878,7.255762,5.955774,7.255762,5.955774,4.239124,3.176635,5.623277,3.707464,5.525990949999996,6.588962419999997,6.859507959999999,7.112516500000008,6.906684702928373,7.170557242564863,7.182620538461537,7.820921507621488,6.544319569301585,5.525990949999996,6.588962419999997,6.859507959999999,7.112516500000008,7.441980999999999,12188688,12345450.4,62.89929729639134,2.2089344766741634,1.5,2.75,NaN,NaN,0.20238755019481852,0.9873020104637089,276.4193467108842,0.051702046105339294,0.19293870478026598,0.14123665867492669,30.190134439146338,10.29994524260105,45.962458222242105,22.149729018188328,31.887812759569563,4601555240
1304515800,7.454092,7.454092,7.197428,7.29326,6.810366434782608,7.738322469387755,7.255762,5.955774,7.255762,5.955774,4.239124,3.176635,5.623277,3.707464,5.543624104999996,6.606137239999997,6.869241199999999,7.122391400000008,6.921844518499809,7.182243219463447,7.219863692307691,7.822124173046657,6.617603211568726,5.543624104999996,6.606137239999997,6.869241199999999,7.122391400000008,7.3149266666666675,13500048,12524876.2,56.54800251195526,0.48251613700263996,1.5,2.75,NaN,NaN,0.20626443946661718,1.0778587975184937,274.72005036558,0.029717053169153157,0.17838297513636814,0.14866592196721498,35.15063172178153,3.366000246890383,19.758261880166188,49.110279462694876,31.13145865713894,4588055192
1304602200,7.178262,7.326593,7.019931,7.118262,6.839496565217392,7.7471472040816325,7.255762,5.955774,7.255762,5.955774,4.239124,3.176635,5.623277,3.707464,5.5611239299999955,6.620570419999996,6.878091099999999,7.1207247000000065,6.92954716483315,7.1761497699907375,7.237748153846153,7.8124386202541265,6.66305768743818,5.5611239299999955,6.620570419999996,6.878091099999999,7.1207247000000065,7.154928666666666,18658312,13004450.8,50.31985995525425,1.4292702244532505,1.5,2.75,NaN,NaN,0.21343569379043026,1.4347635503377043,271.74659052649787,0.001856146119099733,0.15098610461608963,0.1491299584969899,30.929895609767975,-0.5530016366657893,2.5217222704895534,83.01809113668628,14.46018659282418,4569396880
1304688600,7.324093,7.435759,7.126563,7.203095,6.868626695652174,7.7559719387755095,7.600758,5.955774,7.255762,5.955774,4.239124,3.176635,5.623277,3.707464,5.577839594999996,6.635785279999997,6.888954339999999,7.126133000000006,6.940274530918125,7.178715982372572,7.280491307692307,7.745366482606298,6.815616132778316,5.577839594999996,6.635785279999997,6.888954339999999,7.126133000000006,7.255139,17884136,13315763.8,53.02108449546209,0.6174481399448675,1.5,2.75,NaN,NaN,0.22086864423397096,1.3430799966577958,275.0245316423789,-0.011649578401679378,0.13456798549489069,0.14621756389657006,30.560869842380757,0.8493749115322019,7.530873226131205,69.59020176859076,22.878925005278024,4587281016
1304947800,7.213261,7.366592,7.183262,7.307427,6.897756826086956,7.764796673469387,7.600758,5.955774,7.255762,5.955774,4.239124,3.176635,5.623277,3.707464,5.594525259999996,6.651901779999996,6.89750426,7.1409620000000045,6.954672666960551,7.1909741745275655,7.3232473076923075,7.673889572568884,6.972605042815731,5.594525259999996,6.651901779999996,6.89750426,7.1409620000000045,7.285760333333333,8986264,13269390,56.176945795535914,0.915189584932161,1.5,2.75,NaN,NaN,0.21818731250297302,0.6772175661428295,278.44448462909855,-0.014178827850253595,0.12849402908375307,0.14267285693400666,31.466846961474307,-0.21620152773492476,18.66955128800719,50.597217951028654,30.73323076096415,4596267280
1305034200,7.378259,7.537425,7.354926,7.501175,6.926886956521739,7.773621408163265,7.600758,5.955774,7.255762,5.955774,4.239124,3.176635,5.623277,3.707464,5.611527169999996,6.6707349299999965,6.90727918,7.168649200000004,6.976104131001314,7.220517110286845,7.357509769230769,7.683056405635687,7.031963132825851,5.611527169999996,6.6707349299999965,6.90727918,7.168649200000004,7.464508666666667,11850524,13316817.4,61.367061526077386,2.659412329975064,1.5,2.75,NaN,NaN,0.21903093303847496,0.8898916042807645,282.9225636245342,-0.003957011293074769,0.1377265928176632,0.14168360411073797,31.77960081539449,0.5080354306342586,40.49059510845678,26.657303900197032,32.8521009913462,4608117804
1305120600,7.470758,7.474925,7.158728,7.262427,6.956017086956521,7.782446142857142,7.600758,5.955774,7.255762,5.955774,4.239124,3.176635,5.623277,3.707464,5.627418679999995,6.686218099999996,6.9193498799999995,7.1925656000000044,6.987332478805184,7.2245085283547645,7.365554538461539,7.675775484745973,7.055333592177105,5.627418679999995,6.686218099999996,6.9193498799999995,7.1925656000000044,7.298693333333333,19492428,13329782.8,53.03215269379188,0.8942921138917312,1.5,2.75,NaN,NaN,0.2278463663928696,1.462321501592659,277.90223458116424,-0.013870783608695147,0.12434512459986902,0.13821590820856416,35.42322047358661,-3.6271074027466716,34.61179182112203,32.07212856075009,33.31607961812788,4588625376
1305207000,7.212428,7.404093,7.087029,7.364093,6.9851472173913045,7.79127087755102,7.600758,5.955774,7.255762,5.955774,4.239124,3.176635,5.623277,3.707464,5.644226844999995,6.702342939999997,6.9327664,7.221190300000005,7.002107401204981,7.237802287559073,7.382605615384615,7.665017145812262,7.100194084956969,5.644226844999995,6.702342939999997,6.9327664,7.221190300000005,7.285071666666667,14444916,13350358.8,55.786036737318916,0.9169124098516126,1.5,2.75,NaN,NaN,0.23421905450766456,1.0819870998523275,281.0405964259,-0.014129416079645601,0.12055413810900717,0.13468355418865277,36.04181438275363,-3.11370260702945,67.0475094979857,8.7426756933225,24.209814808691814,4603070292
1305293400,7.372426,7.395176,7.111596,7.178262,7.014277347826087,7.800095612244897,7.600758,5.955774,7.255762,5.955774,4.239124,3.176635,5.623277,3.707464,5.660410019999995,6.716309469999996,6.935549720000001,7.239648450000004,7.009015424687139,7.232131783982019,7.371451923076923,7.673152250039813,7.069751596114033,5.660410019999995,6.716309469999996,6.935549720000001,7.239648450000004,7.228344666666667,13817500,13502777.2,50.013587617656746,1.3016306520908638,1.5,2.75,NaN,NaN,0.2377448363285457,1.023308005111719,277.48294794058023,-0.026638019102857874,0.10138603031008042,0.1280240494129383,37.556882950600176,-4.975159152194378,36.249361242332256,30.50108697541509,33.249551782252645,4589252792
1305552600,7.109096,7.276595,7.00743,7.044096,7.043407478260869,7.808920346938775,7.600758,5.955774,7.255762,5.955774,4.239124,3.176635,5.623277,3.707464,5.675882779999995,6.727776019999997,6.938516360000002,7.247565050000004,7.010391133522937,7.2142236140789695,7.339208615384615,7.681617814177781,6.9967994165914495,5.675882779999995,6.727776019999997,6.938516360000002,7.247565050000004,7.1093736666666665,12731776,13391756.8,46.289450824568746,2.234652749607659,1.5,2.75,NaN,NaN,0.23998913373364958,0.9507173845928862,274.2782638687878,-0.042811091671904736,0.07451018482305738,0.11732127649496212,38.30998791451153,-5.410413038252936,18.401647598171433,50.98170876075683,30.616643641071743,4576521016
1305639000,6.961596,7.055763,6.858265,7.024096,7.072537608695652,7.817745081632653,7.600758,5.955774,7.255762,5.955774,4.239124,3.176635,5.623277,3.707464,5.689990974999995,6.738517579999996,6.9446163000000025,7.266398150000005,7.010928579267135,7.196116222261924,7.299850076923077,7.660008015286842,6.9396921385593116,5.689990974999995,6.738517579999996,6.9446163000000025,7.266398150000005,6.979374666666668,17787080,13196102,45.74264753257323,3.3648946158400297,1.5,2.75,NaN,NaN,0.23695405275267456,1.3479041007715764,271.8000761960289,-0.05304978102578245,0.05100905021273405,0.1040588312385165,38.075982886913394,-3.6905855543337265,4.359382349039822,77.29205917533135,18.348558475628824,4558733936
1305725400,7.039096,7.245761,6.99243,7.228262,7.101667739130435,7.82656981632653,7.600758,5.955774,7.255762,5.955774,4.239124,3.176635,5.623277,3.707464,5.705415824999996,6.751550779999997,6.9512829000000025,7.290231300000005,7.019451458511561,7.199177724903646,7.271196538461538,7.58765560275567,6.954737474167406,5.705415824999996,6.751550779999997,6.9512829000000025,7.290231300000005,7.155484333333334,11597776,12891953.4,51.97884427563898,0.8582190205202865,1.5,2.75,NaN,NaN,0.2381238346989121,0.899613552745234,276.42663682906283,-0.044605523324762725,0.04830192708256309,0.09290745040732581,41.381285278636014,1.5453210348256403,19.027247882168368,50.10795871868057,30.864793399151058,4570331712
1305811800,7.296594,7.334843,7.154096,7.265761,7.130797869565217,7.835394551020408,7.600758,5.955774,7.255762,5.955774,4.239124,3.176635,5.623277,3.707464,5.720582344999996,6.764908979999997,6.959299500000002,7.300731200000004,7.02911065621699,7.205518989198537,7.249017384615384,7.5202434011874715,6.977791368043297,5.720582344999996,6.764908979999997,6.959299500000002,7.300731200000004,7.251566666666666,13915408,12778316.4,53.04630507031,0.3994135495586208,1.5,2.75,NaN,NaN,0.23402548936327555,1.0889860263594662,278.86263065788626,-0.03542845186579828,0.04862188557507796,0.08405033744087624,38.65819833157336,0.8699871374735458,18.335223233227385,51.075378792257226,30.589397974515407,4584247120
1305898200,7.22326,7.249095,7.058246,7.10993,7.159928,7.844219285714285,7.600758,5.955774,7.255762,5.955774,4.239124,3.176635,5.623277,3.707464,5.7350280449999955,6.776558869999997,6.971716060000002,7.298335450000003,7.032280042247697,7.196415275941534,7.223088153846153,7.477577412448369,6.968598895243938,5.7350280449999955,6.776558869999997,6.971716060000002,7.298335450000003,7.139090333333333,12927488,12971969,48.24669708344589,0.9699918004302464,1.5,2.75,NaN,NaN,0.23213188298018447,0.996570990880413,275.91041177537176,-0.0385302645282143,0.03588750678060837,0.07441777130882267,40.29841100922105,-2.7026886481383854,18.911778834653727,50.26809379035297,30.82012737499331,4571319632
1306157400,6.841599,6.91743,6.780931,6.845764,7.189058130434782,7.853044020408163,7.600758,5.955774,7.255762,5.955774,4.239124,3.176635,5.623277,3.707464,5.748415404999995,6.785292929999997,6.976416000000001,7.283502200000004,7.024965687649748,7.163019916328055,7.188665384615384,7.508535993773851,6.868794775456918,5.748415404999995,6.785292929999997,6.976416000000001,7.283502200000004,6.848041666666667,18450352,13479582,41.40706389289032,4.502907118769894,1.5,2.75,NaN,NaN,0.23905096276731416,1.3687629186127581,271.336937530701,-0.055991510074084615,0.004428383716216899,0.060419893790301514,43.84587599222434,-8.737444467033498,15.672836697185051,54.9771503604981,29.350012942316834,4552869280
1306243800,6.909098,6.956597,6.789932,6.832433,7.2181882608695656,7.86186875510204,7.600758,5.955774,7.255762,5.955774,4.239124,3.176635,5.623277,3.707464,5.761381949999995,6.7941095199999975,6.983115960000001,7.258960850000004,7.017415386173287,7.131535448106335,7.166678538461538,7.53803419154286,6.795322885380215,5.761381949999995,6.7941095199999975,6.983115960000001,7.258960850000004,6.859654,12461764,13624342,41.09048859748888,3.6999303596396804,1.5,2.75,NaN,NaN,0.23388053685536314,0.9146690533752015,269.8438341189558,-0.0654023029369261,-0.02133298488085611,0.04406931805606999,38.87272424742049,-5.920803059362935,18.529087928049265,50.795900607691564,30.67501146425918,4540407516
1306330200,6.749933,6.98933,6.747433,6.906598,7.247318391304348,7.870693489795918,7.600758,5.955774,7.255762,5.955774,4.239124,3.176635,5.623277,3.707464,5.7751359799999955,6.803592759999998,6.995365840000001,7.231127800000005,7.013069606323354,7.11011283400097,7.143871076923076,7.539129396501521,6.74861275734463,5.7751359799999955,6.803592759999998,6.995365840000001,7.231127800000005,6.881120333333333,16633784,13975449.2,43.67071479604208,2.8936216302012947,1.5,2.75,NaN,NaN,0.2344531413656943,1.190214622940349,273.01094830144086,-0.0635410433174536,-0.035356986090747,0.028184057226706593,37.38857655884396,-6.212509809422568,22.586855272003593,45.39613847518406,32.017006252812344,4557041300
1306416600,6.849098,7.045763,6.818266,7.00993,7.27644852173913,7.879518224489796,7.600758,5.955774,7.255762,5.955774,4.239124,3.176635,5.623277,3.707464,5.791135819999995,6.8124176699999985,7.01644896,7.204836450000005,7.0129464845067515,7.100571611715163,7.1209866923076905,7.510118403737429,6.731854980877952,5.791135819999995,6.8124176699999985,7.01644896,7.204836450000005,6.957986333333334,13210728,13988660.8,47.144350659793965,1.6096605580552088,1.5,2.75,NaN,NaN,0.23395627412528755,0.9443883291529951,276.56299296284305,-0.05270605719152793,-0.03769851426270332,0.01500754292882461,37.567383428868176,-2.345024464139096,21.489384424043713,46.80143864066328,31.709176935293023,4570252028
1306503000,7.070763,7.154096,7.050763,7.097429,7.305578652173913,7.888342959183673,7.600758,5.955774,7.255762,5.955774,4.239124,3.176635,5.623277,3.707464,5.807893984999995,6.822417569999999,7.03534878,7.179670000000004,7.0162595243300165,7.100272315361338,7.089929307692306,7.4112720959001015,6.7685865194845105,5.807893984999995,6.822417569999999,7.03534878,7.179670000000004,7.1007626666666654,11782832,14128836,49.95841513253502,0.36829271260052415,1.5,2.75,NaN,NaN,0.22754268311633846,0.8339563145895388,280.20559073346203,-0.03770479832356366,-0.03212345497562996,0.005581343347933695,36.235768318250415,0.7571305104302993,44.0421326320538,23.672770475968875,32.28509689197732,4582034860
1306848600,7.289927,7.316594,7.145762,7.316594,7.334708782608695,7.897167693877551,7.600758,5.955774,7.255762,5.955774,4.239124,3.176635,5.623277,3.707464,5.825956304999994,6.833667459999999,7.0569529,7.167795200000005,7.02803734690531,7.12087438056502,7.094095999999998,7.425523955344746,6.76266804465525,5.825956304999994,6.833667459999999,7.0569529,7.167795200000005,7.259650000000001,13772476,14304714,56.24257444958641,2.056413295846963,1.5,2.75,NaN,NaN,0.22694427717945717,0.962792824798874,284.54395777319354,-0.012390037806776808,-0.009906203910537315,0.0024838338962394927,38.37693192057421,4.164208461843348,80.86662147400452,3.2091928843164017,15.924185641679069,4595807336
1306935000,7.258262,7.269094,6.809099,6.827431,7.3638389130434785,7.905992428571428,7.600758,5.955774,7.255762,5.955774,4.239124,3.176635,5.623277,3.707464,5.8415644799999935,6.84034239,7.06303616,7.136816250000004,7.020170431340396,7.09292739193978,7.052814307692306,7.3729354952288,6.732693120155812,5.8415644799999935,6.84034239,7.06303616,7.136816250000004,6.9685413333333335,26533476,15021953.4,43.202222710840346,2.3891922212874106,1.5,2.75,NaN,NaN,0.24698361452378167,1.76631329451468,279.5699996169301,-0.027113614613415108,-0.03140818437052939,-0.004294569757114283,56.92678244499451,-5.545330260579932,62.55401608840002,11.237633052231478,26.208350859368487,4569273860
1307021400,6.838265,6.891598,6.6891,6.804932,7.392969043478261,7.9148171632653055,7.600758,5.955774,7.255762,5.955774,4.239124,3.176635,5.623277,3.707464,5.856360169999993,6.847092319999999,7.070069420000001,7.1123998500000045,7.011729708542733,7.065499259374087,7.024096615384613,7.360612454170193,6.687580776599033,5.856360169999993,6.847092319999999,7.070069420000001,7.1123998500000045,6.79521,12971948,14995548.4,42.711693131523646,3.468277148406939,1.5,2.75,NaN,NaN,0.24380607062922585,0.8650532580722423,278.326146807583,-0.036317407677093086,-0.04969132935348064,-0.013373921676387554,53.30558107604098,-6.34247396797115,37.35654593179601,29.71136256964267,32.9320914985613,4556301912
1307107800,6.566601,6.751599,6.549101,6.599101,7.422099173913043,7.923641897959183,7.600758,5.955774,7.255762,5.955774,4.239124,3.176635,5.623277,3.707464,5.869989199999993,6.851933939999999,7.0718860600000015,7.086441800000005,6.9955481905606645,7.021080377528936,6.989866230769229,7.394846155972862,6.584886305565595,5.869989199999993,6.851933939999999,7.0718860600000015,7.086441800000005,6.633267,14668692,14796067.4,38.414485111754665,5.0978225735027864,1.5,2.75,NaN,NaN,0.2446649941557097,0.9913912665739817,274.46786174341736,-0.053196074410386776,-0.07986901468937102,-0.026672940278984248,54.506111777369625,-7.184726150609081,16.34984443148111,54.21900417249959,29.431151396019313,4541633220
1307367000,6.559102,6.585767,6.354936,6.374936,7.451229304347826,7.93246663265306,7.600758,5.955774,7.600758,5.955774,7.255762,3.176635,4.239124,3.707464,5.883493229999992,6.85385058,7.065369460000002,7.045033850000005,6.971210457597501,6.959542817764275,6.939930846153844,7.4595697331169095,6.420291959190779,5.883493229999992,6.85385058,7.065369460000002,7.045033850000005,6.438546333333332,17938664,14798793.8,34.36001052600609,7.314639389734119,1.5,2.75,NaN,NaN,0.2446292802874447,1.2121706838026218,270.2345660911852,-0.07504918410634272,-0.12048442041191265,-0.045435236305569934,56.02456969866515,-6.8776545612732205,3.1956452540705094,80.80315676667718,16.001197979252304,4523694556
1307453400,6.468269,6.529102,6.361603,6.36827,7.480359434782608,7.941291367346938,7.600758,5.955774,7.600758,5.955774,7.255762,3.176635,4.239124,3.707464,5.897138929999992,6.853983920000001,7.0574112000000015,6.998076000000005,6.947565733770149,6.903231120834344,6.873777615384613,7.44604701973488,6.3015082110343466,5.897138929999992,6.853983920000001,7.0574112000000015,6.998076000000005,6.4196583333333335,12601576,14979559.4,34.244263568321784,6.142046065159175,1.5,2.75,NaN,NaN,0.23911997455262726,0.8412514456199559,272.10717567854357,-0.08482327182536281,-0.15146432608727345,-0.06664105426191064,53.476114446791435,-6.793524356550589,0,100,0,4511092980
1307539800,6.349103,6.398187,6.249938,6.280771,7.509489565217391,7.950116102040815,7.600758,5.955774,7.600758,5.955774,7.255762,3.176635,4.239124,3.707464,5.910572129999991,6.85351727,7.048677960000003,6.937055800000005,6.921416920681123,6.843949204564407,6.798009153846152,7.402536833787518,6.193481473904787,5.910572129999991,6.85351727,7.048677960000003,6.937055800000005,6.309632000000001,21049468,15439506.6,32.6877127877225,6.981598364125591,1.5,2.75,NaN,NaN,0.232629190656011,1.363351080143973,268.1941425893672,-0.09147933257453542,-0.1809902199800799,-0.0895108874055445,53.48160266237895,-9.061291825584755,0,100,0,4490043512
1307626200,6.331603,6.491601,6.284937,6.411603,7.538619695652174,7.958940836734693,7.600758,5.955774,7.600758,5.955774,7.255762,3.176635,4.239124,3.707464,5.925451149999991,6.853192279999999,7.039828060000002,6.894514600000005,6.901424217909314,6.802773375558273,6.74429169230769,7.352498975824842,6.136084408790538,5.925451149999991,6.853192279999999,7.039828060000002,6.894514600000005,6.396047,13001120,15114941.2,37.27850304877505,4.567089515276531,1.5,2.75,NaN,NaN,0.23107210560915312,0.8601502201014186,271.33776358134065,-0.08169027845985954,-0.19162373548036893,-0.10993345702050938,55.042803261535006,-8.535420467822068,2.8535318156071123,81.92172558737356,15.224742597019327,4503044632
1307712600,6.332438,6.345769,6.098272,6.140772,7.567749826086956,7.967765571428571,7.600758,5.955774,7.600758,5.955774,7.255762,3.176635,4.239124,3.707464,5.938796849999991,6.849575649999999,7.022503220000002,6.8333485500000055,6.871594719167772,6.739725625505104,6.690061538461536,7.373477143347472,6.0066459335756,5.938796849999991,6.849575649999999,7.022503220000002,6.8333485500000055,6.194937666666665,19471380,15366264.4,32.35864563646898,6.867965283169091,1.5,2.75,NaN,NaN,0.2369477409227851,1.2671511756624465,266.5956327440431,-0.0875539089688174,-0.21937584323153114,-0.13182193426271374,56.49198248601785,-13.478923142450595,2.5973899778097747,82.79961947461017,14.602990547580047,4483573252
1307971800,6.180772,6.233271,6.054105,6.146604,7.596879956521739,7.976590306122448,7.600758,5.955774,7.600758,5.955774,7.255762,3.176635,4.239124,3.707464,5.952509204999991,6.848108989999999,7.005686680000002,6.781765650000006,6.8431637105729575,6.683237851647474,6.6373054615384595,7.372535348104607,5.9020755749723115,5.952509204999991,6.848108989999999,7.005686680000002,6.781765650000006,6.144659999999998,11221060,15236442.4,32.565032963562686,6.501636743014952,1.5,2.75,NaN,NaN,0.23282047371401474,0.7364619446859852,264.83940458420807,-0.08506541836284504,-0.23815370721627005,-0.15308828885342501,54.95465861208603,-15.990910524760567,11.867081943892055,61.24353892966822,26.88937912643973,4494794312
1308058200,6.314104,6.445695,6.306603,6.38077,7.626010086956521,7.985415040816326,7.600758,5.955774,7.600758,5.955774,7.255762,3.176635,4.239124,3.707464,5.966588234999992,6.84938148,6.991803520000002,6.748599350000006,6.825030623883822,6.6544313895858105,6.596857153846151,7.326209411009196,5.867504896683106,5.966588234999992,6.84938148,6.991803520000002,6.748599350000006,6.377689333333333,12548044,15227255.8,40.42508096172363,2.2448787558698604,1.5,2.75,NaN,NaN,0.23755408273444223,0.8240515667964282,269.66711814052206,-0.06270680709355436,-0.23147179772036797,-0.1687649906268136,57.13272981073465,-6.54215326379717,29.400907629676095,37.48632560291634,33.11276676740757,4507342356
1308144600,6.223279,6.286604,6.000772,6.050773,7.655140217391304,7.994239775510203,7.600758,5.955774,7.600758,5.955774,7.255762,3.176635,4.239124,3.707464,5.9797881099999906,6.846948170000001,6.9709037400000025,6.6999332000000065,6.794667579809946,6.596940114387162,6.523075846153844,7.264314662222788,5.7818370300849,5.9797881099999906,6.846948170000001,6.9709037400000025,6.6999332000000065,6.112716333333334,18463000,15261051.8,34.34898297459915,6.521587427344159,1.5,2.75,NaN,NaN,0.24772864825341062,1.2098117640882393,264.1154611336107,-0.06492670766400668,-0.24992337520682195,-0.18499666754281527,51.933312890000686,-11.082535431654565,32.149183134242,34.589689368866615,33.26112749689139,4488879356
1308231000,6.062439,6.17573,5.935774,6.075773,5.935774,8.00306451020408,7.600758,5.955774,7.600758,5.955774,7.255762,3.176635,4.239124,3.707464,5.99302964499999,6.843698210000001,6.950503960000003,6.642308750000007,6.7664756355036735,6.5473051511121945,6.444486923076921,7.140756353465192,5.74821749268865,5.99302964499999,6.843698210000001,6.950503960000003,6.642308750000007,6.062425666666667,15602448,15461285.4,35.1442935641673,5.877531161230141,1.5,2.75,NaN,NaN,0.24717345909245267,1.0091300688363207,262.13022148294175,-0.05963251213222548,-0.25953730770809713,-0.19990479557587165,52.56170907249137,-7.930292323151293,33.745205145791985,32.98027296230437,33.27452189190366,4504481804
1308317400,6.255772,6.257437,6.068273,6.125771,5.9222578780487805,8.011889244897958,7.600758,5.955774,7.600758,5.955774,7.255762,3.176635,4.239124,3.707464,6.00508784999999,6.8409065600000005,6.929987460000003,6.585309250000006,6.741349963523137,6.507159041482462,6.3528851538461515,6.851343926577178,5.854426381115125,6.00508784999999,6.8409065600000005,6.929987460000003,6.585309250000006,6.150493666666667,12906716,15410850.8,36.79342352378787,3.691281649738377,1.5,2.75,NaN,NaN,0.24302992630013467,0.8375083353606927,265.42436042223244,-0.048174928696135544,-0.26012345644604107,-0.21194852774990552,52.05370339609183,-3.9085098266084497,67.12806051882085,8.728467741005987,24.14347174017317,4517388520
1308576600,6.074938,6.257446,6.067439,6.224938,5.9087417560975615,8.020713979591836,7.600758,5.955774,7.600758,5.955774,7.255762,3.176635,4.239124,3.707464,6.01710022999999,6.8381815900000005,6.9125876400000035,6.541059650000006,6.72109851397321,6.48028084705556,6.306539538461536,6.725605362771982,5.887473714151089,6.01710022999999,6.8381815900000005,6.9125876400000035,6.541059650000006,6.183274333333333,10209772,15274965,40.04952934438162,2.537626753752416,1.5,2.75,NaN,NaN,0.2392425744215536,0.668399043794863,268.8011101944824,-0.03020722746323376,-0.24970756207894773,-0.21950033461571397,50.49041985240982,-2.2507211534686817,66.6045338777876,8.991926641023694,24.403539481188716,4527598292
1308663000,6.32327,6.524935,6.29827,6.486602,5.895225634146342,8.029538714285714,7.600758,5.955774,7.600758,5.955774,7.255762,3.176635,4.239124,3.707464,6.02967510499999,6.8375316,6.902102740000004,6.523101550000007,6.71190257224877,6.480882861621698,6.282052615384614,6.6088011937253865,5.955304037043841,6.02967510499999,6.8375316,6.902102740000004,6.523101550000007,6.436602333333333,16650236,15184959.2,47.704784706814046,1.9372771905474009,1.5,2.75,NaN,NaN,0.24358217624858552,1.0964952740867424,274.4332135524912,0.0013380201929828472,-0.21782780937448543,-0.21916582956746827,56.35626206341061,3.2771613548718905,68.92698991683386,7.861100344774855,23.211909738391288,4544248528
1308749400,6.428269,6.544101,6.364936,6.374104,5.881709512195123,8.038363448979592,7.600758,6.050773,7.600758,5.955774,7.255762,3.176635,4.239124,3.707464,6.04233747999999,6.8391566,6.890636200000004,6.500185100000006,6.698655569415485,6.470713446229155,6.264745153846151,6.5426741492076905,5.986816158484612,6.04233747999999,6.8391566,6.890636200000004,6.500185100000006,6.4277136666666665,11653808,15144561.4,45.0418019696449,1.3687471379950544,1.5,2.75,NaN,NaN,0.23898094937368658,0.7695044902389844,272.41937255689214,0.015858562550340544,-0.1993426263795426,-0.21520118892988313,56.76543788900668,-0.5848615393061671,78.47163408568886,3.9568944992739454,17.571471415037202,4532594720
1308835800,6.151606,6.337495,6.015773,6.324936,5.868193390243903,8.047188183673468,7.600758,6.050773,7.600758,5.955774,7.255762,3.176635,4.239124,3.707464,6.05438735499999,6.83892327,6.881452940000003,6.471102000000006,6.683999900026643,6.456829879921616,6.260898999999997,6.533963274595389,5.987834725404604,6.05438735499999,6.83892327,6.881452940000003,6.471102000000006,6.226068000000001,20230724,15324408.4,43.888664196727845,2.088933223687819,1.5,2.75,NaN,NaN,0.2475059529898518,1.3201634589691567,269.3572702417767,0.022952586402956388,-0.18651045592618765,-0.20946304232914403,55.58994884094163,2.999036603215361,39.211990611726144,27.840503977253373,32.94750541102049,4512363996
1308922200,6.331603,6.342437,6.084939,6.115772,5.854677268292683,8.056012918367346,7.600758,6.050773,7.600758,5.955774,7.255762,3.176635,4.239124,3.707464,6.065137244999991,6.83362332,6.867936400000002,6.426394100000006,6.6617164529667745,6.424348177071939,6.241476076923074,6.5171360592049945,5.965816094641153,6.065137244999991,6.83362332,6.867936400000002,6.426394100000006,6.181049333333334,14040020,15365873,39.28141555821787,3.163534717415062,1.5,2.75,NaN,NaN,0.24821967063343384,0.9137144371816688,266.50228453319136,0.01475704735228539,-0.1910167331387873,-0.2057737804910727,53.19111379198582,-0.501610320105219,17.17155309978045,52.80196891534285,30.026477984876696,4498323976
1309181400,6.126605,6.331603,6.081606,6.259937,5.841161146341464,8.064837653061224,7.600758,6.050773,7.600758,5.955774,7.255762,3.176635,4.239124,3.707464,6.0763037949999905,6.830115020000001,6.8569531600000015,6.384519500000006,6.645960395987685,6.408689969731754,6.2398734615384575,6.514842388322911,5.9649045347540035,6.0763037949999905,6.830115020000001,6.8569531600000015,6.384519500000006,6.224381999999999,9324788,15242970.8,43.67058277565566,1.4391400689736111,1.5,2.75,NaN,NaN,0.24834662273104574,0.6117434798208758,270.2305549096528,0.019922927224483772,-0.180870121460468,-0.20079304868495176,54.91383179017193,-1.893705618600893,17.063967437546594,52.90300821164077,30.033024350812642,4507648764
1309267800,6.336602,6.514934,6.314104,6.511602,5.827645024390244,8.073662387755101,7.600758,6.050773,7.600758,5.955774,7.255762,3.176635,4.239124,3.707464,6.0880328399999915,6.828640040000002,6.8494699200000015,6.344269900000007,6.640691439282286,6.418491115471587,6.247565692307688,6.5459211120621354,5.949210272553241,6.0880328399999915,6.828640040000002,6.8494699200000015,6.344269900000007,6.44688,12222240,15165459,50.40972570044933,2.221092383920283,1.5,2.75,NaN,NaN,0.24882164967882822,0.8059261509987927,274.54905980557254,0.040007672143984985,-0.15078345850497055,-0.19079113064895553,55.40290735633524,7.61603517434879,13.103446401924282,59.08370320763138,27.81285039044433,4519871004
1309354200,6.595767,6.717433,6.527435,6.685766,5.814128902439025,8.08248712244898,7.600758,6.050773,7.600758,5.955774,7.255762,3.176635,4.239124,3.707464,6.1006618799999925,6.82839004,6.850236560000002,6.337186650000006,6.642459069114353,6.443945866379055,6.289488307692304,6.660378671634065,5.918597943750543,6.1006618799999925,6.82839004,6.850236560000002,6.337186650000006,6.643544666666667,17418028,14709686.6,54.469415819450745,4.093415842567431,1.5,2.75,NaN,NaN,0.24575088898748335,1.184119585525364,278.48352292015375,0.06335327879047409,-0.11159953216086294,-0.17495281095133702,44.1140637667992,10.039759549937106,38.69142345227899,28.25714036041609,33.051436187304915,4537289032
1309440600,6.747433,6.901598,6.724933,6.874099,5.800612780487805,8.091311857142856,7.600758,6.050773,7.600758,5.955774,7.255762,3.176635,4.239124,3.707464,6.113999249999991,6.828656710000001,6.852686560000002,6.340645000000006,6.651542987972614,6.484912831485811,6.3454494615384585,6.818641950674907,5.87225697240201,6.113999249999991,6.828656710000001,6.852686560000002,6.340645000000006,6.833543333333333,14384720,14780325.2,58.43224757224357,5.855798741510531,1.5,2.75,NaN,NaN,0.24361382548837737,0.9732343372255436,282.6325331291416,0.0882787526580732,-0.06460437012874554,-0.15288312278681873,45.041720612557036,12.216062271998085,76.44694641252816,4.668774677293924,18.8842789101779,4551673752
1309527000,6.884931,7.199927,6.840765,7.169095,5.787096658536586,8.100136591836733,7.600758,6.050773,7.600758,5.955774,7.255762,3.176635,4.239124,3.707464,6.128828269999991,6.8309783500000005,6.854953200000002,6.369144700000006,6.671839145307021,6.550073038010972,6.406089846153843,7.052274216047355,5.759905476260331,6.128828269999991,6.8309783500000005,6.854953200000002,6.369144700000006,7.069928999999999,15760956,14834938.4,63.753809990920686,8.292714990770472,1.5,2.75,NaN,NaN,0.2518672665249218,1.0624213983928643,287.95952210925066,0.11949360050673666,-0.003516122153397916,-0.12300972266013457,47.980281145750105,15.167331787079656,100,0,0,4567434708
1309872600,7.155762,7.209928,7.095762,7.159928,5.773580536585366,8.108961326530611,7.600758,6.050773,7.600758,5.955774,7.255762,3.176635,4.239124,3.707464,6.1435864549999915,6.83361166,6.8549948600000015,6.4083943000000065,6.690979884706746,6.608154462962308,6.491409461538457,7.215593990230341,5.767224932846573,6.1435864549999915,6.83361166,6.8549948600000015,6.4083943000000065,7.155205999999999,11526688,14514339.6,63.48183568202658,7.254903700484657,1.5,2.75,NaN,NaN,0.24203146177314167,0.7941586264110838,287.0974784525516,0.1333308500505954,0.04365383990310967,-0.08967701014748572,48.95575934042086,10.380257644911763,81.0857578743762,3.09674164143713,15.817500484186686,4555908020
1309959000,7.109096,7.224094,7.053263,7.195762,5.760064414634146,8.11778606122449,7.600758,6.050773,7.600758,5.955774,7.255762,3.176635,4.239124,3.707464,6.157557149999992,6.83648247,6.856061520000002,6.449768900000007,6.710775261777069,6.664117085537327,6.577562461538458,7.348437872134296,5.806687050942619,6.157557149999992,6.83648247,6.856061520000002,6.449768900000007,7.1577063333333335,13177100,14543115.8,64.1260839606795,6.271841996223808,1.5,2.75,NaN,NaN,0.23694571450363153,0.9060713110735183,288.8919654227575,0.13811875686310288,0.08297143593139289,-0.055147320931709994,45.92140781560512,12.890564697406885,81.73008891038197,2.900662208800306,15.369248880817732,4569085120
1310045400,7.389093,7.474843,7.347009,7.427426,5.746548292682927,7.474843,7.600758,6.050773,7.600758,5.955774,7.255762,3.176635,4.239124,3.707464,6.172815334999992,6.84036577,6.858144840000002,6.507101650000007,6.738879212295616,6.7368131726290095,6.677689769230765,7.522425543895029,5.832953994566502,6.172815334999992,6.84036577,6.858144840000002,6.507101650000007,7.416426,11244088,14052846.8,68.05034948589491,8.27942511204222,1.5,2.75,NaN,NaN,0.2399553777533721,0.8001288393750937,293.4235086169608,0.14916633349971745,0.13131059594293681,-0.017855737556780632,43.62045189774231,17.430848312141016,80.2788719367495,3.3504651904112515,16.37066287283925,4580329208
1310131800,7.168262,7.271593,7.095762,7.269928,5.733032170731708,7.469498869565217,7.600758,6.050773,7.600758,5.955774,7.255762,3.176635,4.239124,3.707464,6.187669354999993,6.8421407599999995,6.854278220000002,6.550017900000006,6.759704654950689,6.787586013331008,6.758073615384611,7.613983722327566,5.902163508441657,6.187669354999993,6.8421407599999995,6.854278220000002,6.550017900000006,7.212427666666667,15461360,14175858.8,63.004305818862875,4.563935419779315,1.5,2.75,NaN,NaN,0.24650599362813125,1.090682421300641,290.0330200321051,0.1383828277556785,0.15512279713781751,0.016739969382139,46.84570833703975,18.87179574385704,48.476406263008755,20.249471310926896,31.274122426064366,4564867848
1310391000,7.003262,7.068263,6.809099,6.865765,5.719516048780489,7.464154739130435,7.600758,6.050773,7.600758,5.955774,7.255762,3.176635,4.239124,3.707464,6.201020894999992,6.84055577,6.840878380000003,6.586267550000007,6.763863884168309,6.7950316311090075,6.787239999999995,7.629897635335321,5.94458236466467,6.201020894999992,6.84055577,6.840878380000003,6.586267550000007,6.914375666666667,21624756,14283527.6,52.289151466331084,0.8974713392751472,1.5,2.75,NaN,NaN,0.26181477979755047,1.513964659542507,284.4074481657497,0.09842432520178712,0.1397703758843729,0.04134605068258578,56.52635420029558,9.677860975278183,14.980345619584522,56.04509903946747,28.974555340948005,4543243092
1310477400,6.809099,6.971248,6.759099,6.767433,5.705999926829269,7.458810608695652,7.600758,6.050773,7.600758,5.955774,7.255762,3.176635,4.239124,3.707464,6.212624949999992,6.83667248,6.824211880000003,6.617309000000008,6.764003849495042,6.792403190051007,6.817496076923072,7.626207114797906,6.008785039048237,6.212624949999992,6.83667248,6.824211880000003,6.617309000000008,6.832593333333333,20131460,14729047.6,50.05851318978717,0.5380772713286194,1.5,2.75,NaN,NaN,0.25826722409772546,1.3667862679729543,282.5731681071618,0.06156728158995453,0.11830515267002895,0.056737871080074415,57.78980764955839,3.9288488454914736,12.136388194270905,60.71846656025592,27.14514524547318,4523111632
1310563800,6.871599,7.04993,6.791599,6.833265,5.692483804878049,7.45346647826087,7.600758,6.050773,7.600758,5.955774,7.255762,3.176635,4.239124,3.707464,6.224791494999993,6.83273919,6.809795380000002,6.639933750000007,6.766719973044256,6.79629479099853,6.856598307692303,7.6137794049671825,6.099417210417423,6.224791494999993,6.83273919,6.809795380000002,6.639933750000007,6.891597999999999,17762132,14989752,51.54873041026378,0.40532158711338045,1.5,2.75,NaN,NaN,0.25999792237645936,1.184951692329533,286.1956289036677,0.038922518161707415,0.10539101878220869,0.06646850062050128,54.25631114457206,2.206164559154476,14.843335708285844,56.25973799620065,28.896926295513513,4540873764
1310650200,6.888264,6.984931,6.643851,6.689933,5.67896768292683,7.448122347826087,7.600758,6.050773,7.600758,5.955774,7.255762,3.176635,4.239124,3.707464,6.235966379999993,6.8270808999999995,6.794653840000003,6.6718917500000074,6.763708719199383,6.786165096617718,6.900764538461534,7.537316699626722,6.264212377296346,6.235966379999993,6.8270808999999995,6.794653840000003,6.6718917500000074,6.772904999999999,25390092,15336106.6,48.177973500843414,1.88242018674991,1.5,2.75,NaN,NaN,0.2657894993495694,1.6555761290808972,281.71541806525545,0.01293574240565272,0.08263817862756717,0.06970243622191445,54.20625570667948,-2.6791292938900106,3.609007336722587,79.45743553699053,16.933557126286892,4515483672
1310736600,6.795765,6.831598,6.662433,6.808265,5.66545156097561,7.442778217391305,7.600758,6.050773,7.600758,5.955774,7.255762,3.176635,4.239124,3.707464,6.247882919999992,6.827097569999999,6.784953940000004,6.708516350000008,6.765456024328819,6.788269849320792,6.942943615384611,7.466735672421071,6.419151558348152,6.247882919999992,6.827097569999999,6.784953940000004,6.708516350000008,6.7674319999999994,19063736,15509171,51.02522380012422,1.1875398546466103,1.5,2.75,NaN,NaN,0.2588877493960287,1.2291911669553452,284.35256528423,0.0028858298059202397,0.07330972347931475,0.07042389367339451,52.587874897511774,-5.033131796970201,16.33257136195533,53.97688049000682,29.690548148037852,4534547408
1310995800,6.717433,6.739099,6.477435,6.618267,5.651935439024391,7.437434086956522,7.600758,6.050773,7.600758,5.955774,7.255762,3.176635,4.239124,3.707464,6.258995309999993,6.82652257,6.7749540400000035,6.733141150000009,6.759683905727689,6.772079101766431,6.951148615384612,7.450424403482371,6.451872827286852,6.258995309999993,6.82652257,6.7749540400000035,6.733141150000009,6.6116003333333335,24173940,16072532.2,46.598199558815104,3.265362856124808,1.5,2.75,NaN,NaN,0.26402648158202663,1.5040529830140892,279.2487056940719,-0.016331810365376315,0.05000913071667412,0.06634094108205044,46.72842151383424,-7.5651738397369295,15.477553416831121,55.28515352073631,29.237293062432567,4510373468
1311082200,6.733266,6.96993,6.729099,6.94993,5.638419317073171,7.432089956521739,7.600758,6.050773,7.600758,5.955774,7.255762,3.176635,4.239124,3.707464,6.271516009999994,6.8294225399999995,6.769890740000003,6.769390750000008,6.767144536875623,6.78901728255058,6.971468923076919,7.446816140172258,6.4961217059815795,6.271516009999994,6.8294225399999995,6.769890740000003,6.769390750000008,6.882986333333332,16389700,16381528.6,54.086749062894924,1.3831664394322631,1.5,2.75,NaN,NaN,0.2702862328975961,1.000498817918616,284.20826436619404,-0.006959774292512294,0.057641223216410076,0.06460099750892237,57.06670395003118,-3.4163442315073795,36.14682711370013,30.607716400475358,33.245456485824526,4526763168
1311168600,7.004097,7.026522,6.89314,6.933264,5.624903195121952,7.4267458260869565,7.600758,6.050773,7.600758,5.955774,7.255762,3.176635,4.239124,3.707464,6.284455464999993,6.829955869999999,6.762407480000003,6.791723850000008,6.773659025625599,6.80275506516481,6.9760200769230725,7.4486764392677465,6.5033637145783985,6.284455464999993,6.829955869999999,6.762407480000003,6.791723850000008,6.950975333333334,13661248,16232079.2,53.67939834951171,1.6846574015899527,1.5,2.75,NaN,NaN,0.26050735911919637,0.8416203390629095,285.842416912762,-0.002373260927886839,0.06163442134906383,0.06400768227695067,56.84676347597529,-6.6532066425165235,16.886971524733617,53.1648761182496,29.9481523570168,4513101920
1311255000,7.054095,7.261594,7.005847,7.212428,5.611387073170732,7.421401695652174,7.600758,6.050773,7.600758,6.050773,7.255762,5.955774,4.239124,3.176635,6.297492004999993,6.831955859999999,6.756632540000003,6.8336400500000085,6.790865652071654,6.841771535149114,6.97935338461538,7.457982663915558,6.500724105315202,6.297492004999993,6.831955859999999,6.756632540000003,6.8336400500000085,7.159956333333334,23017392,16800258.4,59.21978228203146,4.47609874827382,1.5,2.75,NaN,NaN,0.26535183346782515,1.3700617842877942,290.28161973974915,0.017857935533665145,0.0863301016940321,0.06847216616036696,58.76010380218187,-0.7909294287371224,49.170986994466425,19.711853760934723,31.117159244598852,4536119312
1311341400,7.210761,7.260761,7.104096,7.238261,5.597870951219512,7.4160575652173915,7.600758,6.050773,7.600758,6.050773,7.255762,5.955774,4.239124,3.176635,6.310702289999994,6.837749549999999,6.756149220000003,6.879306300000008,6.808410567676687,6.879532436563484,6.985378999999996,7.474800452742218,6.495957547257773,6.310702289999994,6.837749549999999,6.756149220000003,6.879306300000008,7.201039333333335,14488932,16513168.8,59.70014497190297,4.0500072735103725,1.5,2.75,NaN,NaN,0.2575884882201233,0.8774168165712688,289.06627443071824,0.03062666908354726,0.10675550251480104,0.07612883343125378,57.624142621637496,5.425411443590043,46.98597843254127,21.354238816703383,31.659782750755348,4550608244
1311600600,7.02743,7.217428,7.004097,7.10993,5.584354829268293,7.4107134347826085,7.600758,6.050773,7.600758,6.050773,7.255762,5.955774,4.239124,3.176635,6.323347999999994,6.841916179999998,6.751065960000003,6.929014200000007,6.8202348591403466,6.901475061652676,6.978776538461535,7.458894683295854,6.498658393627216,6.323347999999994,6.841916179999998,6.751065960000003,6.929014200000007,7.110485,12327888,16427562.2,56.161018204294564,2.478953055510776,1.5,2.75,NaN,NaN,0.2559153104901145,0.7504392830726887,282.9786785563675,0.028140526641543845,0.11130449173318357,0.08316396509163973,46.89658324899554,5.060958859880856,60.3442259046309,12.392410651058704,27.26336344431039,4538280356
1311687000,7.100763,7.123262,6.977264,7.02743,5.5708387073170735,7.405369304347826,7.600758,6.050773,7.600758,6.050773,7.255762,5.955774,4.239124,3.176635,6.335177049999994,6.841799519999999,6.7480493200000025,6.967388850000008,6.828360158781901,6.9134707700667075,6.948007615384611,7.354849875905273,6.541165354863949,6.335177049999994,6.841799519999999,6.7480493200000025,6.967388850000008,7.042652,15855192,16754082.4,53.946931942332085,1.1516981759680736,1.5,2.75,NaN,NaN,0.24806407402653494,0.9463479778516548,280.14071202131925,0.019083940556818807,0.10701889078766325,0.08793495023084444,46.53762778267037,2.8414674390646333,32.161541200636385,34.58711146022401,33.2513473391396,4522425164
1311773400,6.914098,6.914931,6.550768,6.582435,5.5573225853658546,7.400025173913043,7.600758,6.050773,7.600758,6.050773,7.255762,5.955774,4.239124,3.176635,6.344689459999994,6.8386662299999985,6.738816100000001,6.970930500000007,6.8187160349081015,6.8819435538698785,6.895123538461534,7.299558643635398,6.49068843328767,6.344689459999994,6.8386662299999985,6.738816100000001,6.970930500000007,6.682711333333334,25193024,17402621.6,43.89479389000779,4.3984723214990264,1.5,2.75,NaN,NaN,0.26439249731035386,1.447656828899848,273.43381585838733,-0.01679319131105468,0.06694346109202609,0.08373665240308077,60.780860684017554,-1.6068621315041518,25.360059367642037,42.073887434228574,32.566053198129374,4497232140
1311859800,6.587434,6.752432,6.483269,6.507435,5.543806463414635,7.394681043478261,7.600758,6.050773,7.600758,6.050773,7.255762,5.955774,4.239124,3.176635,6.353593539999994,6.836549589999999,6.728482880000001,6.9620139500000064,6.806508935499941,6.846276072548938,6.8675596923076885,7.321993821425098,6.413125563190279,6.353593539999994,6.836549589999999,6.728482880000001,6.9620139500000064,6.581045333333333,24527080,17758074.2,42.4588075706302,4.302511949396815,1.5,2.75,NaN,NaN,0.2647332475024714,1.3811790469937333,271.19192224884165,-0.04394969153469776,0.02879953798470858,0.07274922951940634,60.01120218401432,-4.418600039804554,3.4920117611265047,79.85915237633867,16.648835862534806,4472705060
1311946200,6.314937,6.562434,6.221604,6.392437,5.530290341463415,7.389336913043478,7.600758,6.050773,7.600758,6.050773,7.255762,5.955774,4.239124,3.176635,6.361414299999994,6.831524639999998,6.711766380000001,6.937930850000006,6.790270820382296,6.803053303734753,6.838713846153842,7.35790193089791,6.319525761409775,6.361414299999994,6.831524639999998,6.711766380000001,6.937930850000006,6.392158333333334,34695392,18773607.8,40.2827513042753,6.2776661472231545,1.5,2.75,NaN,NaN,0.2701687298237234,1.8480940035404383,267.4304533005917,-0.06666908885499742,-0.010587131549340434,0.05608195730565698,59.060334623341774,-3.412222565212316,0,100,0,4438009668
1312205400,6.621601,6.825765,6.124939,6.30327,5.516774219512196,7.383992782608695,7.600758,6.050773,7.600758,6.050773,7.255762,5.955774,4.239124,3.176635,6.369014224999994,6.825908029999998,6.692516560000001,6.894639600000007,6.771172748994755,6.755454893855253,6.797944999999997,7.390493863729459,6.205396136270535,6.369014224999994,6.825908029999998,6.692516560000001,6.894639600000007,6.417991333333333,39899100,19980515,38.62956902361347,7.261891279639256,1.5,2.75,NaN,NaN,0.3009299634077431,1.9969004802929253,269.12849138418505,-0.08361598127354966,-0.04843801928628011,0.03517796198726956,57.67072509417952,-9.304554146588524,0,100,0,4398110568
1312291800,6.165773,6.275771,5.805775,5.808275,5.503258097560976,7.378648652173913,7.600758,6.050773,7.600758,6.050773,7.255762,5.955774,4.239124,3.176635,6.374035009999995,6.819099759999998,6.66648346,6.8270569500000065,6.733412052955745,6.665247284916657,6.73012515384615,7.5241620089360985,5.936088298756202,6.374035009999995,6.819099759999998,6.66648346,6.8270569500000065,5.963273666666666,43321464,21570253.8,31.019089767800594,11.156583207107595,1.5,2.75,NaN,NaN,0.3149703231643329,2.0083891641553144,266.65918831912427,-0.12176481248439769,-0.11702805361822755,0.004736758866170136,61.69306220213325,-16.22596514426683,0,100,0,4354789104
1312378200,5.836607,5.918274,5.518278,5.904108,5.489741975609757,7.37330452173913,7.600758,6.050773,7.600758,6.050773,7.255762,5.955774,4.239124,3.176635,6.379384964999994,6.812033169999998,6.647650340000001,6.762474250000007,6.700890325388853,6.592757829210309,6.66057461538461,7.565674883560816,5.755474347208405,6.379384964999994,6.812033169999998,6.647650340000001,6.762474250000007,5.78022,47156268,23269212.2,33.74077231301196,12.095013208721744,1.5,2.75,NaN,NaN,0.321043585795452,2.0265519775525536,268.9813435816533,-0.13321999409421317,-0.16178823375159634,-0.028568239657383164,64.30124219870973,-18.139799801121068,6.517377473837609,71.90001141514766,21.58261111101474,4401945372
1312464600,5.659943,5.67411,5.015783,5.033282,5.476225853658537,7.367960391304348,7.600758,6.050773,7.600758,6.050773,7.255762,5.955774,4.239124,3.176635,6.381197439999994,6.797391639999997,6.611667320000001,6.642767050000008,6.635493920471643,6.44423632166647,6.5386526923076875,7.793240336821125,5.28406504779425,6.381197439999994,6.797391639999997,6.611667320000001,6.642767050000008,5.241058333333333,56516532,25532834.4,24.342083321154675,21.173195229644488,1.5,2.75,NaN,NaN,0.36156368681006257,2.213484453570889,258.95637475377157,-0.18872989750139946,-0.2644806115341325,-0.07575071403273304,95.28603077182527,-30.46282801905043,5.223198376626876,75.03835462678303,19.73844699659008,4345428840
1312551000,5.221614,5.260781,4.579955,4.963284,5.462709731707317,7.362616260869565,7.600758,6.050773,7.600758,6.050773,7.255762,5.955774,4.239124,3.176635,6.381968264999994,6.784083439999998,6.572801040000002,6.527434850000008,6.569917060845304,6.303193243412521,6.385833769230765,7.866427039445243,4.905240499016287,6.381968264999994,6.784083439999998,6.572801040000002,6.527434850000008,4.9346733333333335,72750484,28397290.6,23.768942879285447,23.412453674773882,1.5,2.75,NaN,NaN,0.38436813775220097,2.5618811676350557,253.2793009770212,-0.21740540049470497,-0.34750746465111426,-0.1301020641564093,93.13113978168887,-30.192224114724063,4.183124605122596,77.82735428674106,17.98952110813635,4272678356
1312810200,4.588287,4.734119,3.948294,3.984961,5.449193609756098,7.357272130434783,7.600758,6.050773,7.600758,6.050773,7.255762,5.955774,4.239124,3.176635,6.3776891449999935,6.764375309999998,6.512301660000002,6.383394650000008,6.468546234929802,6.0824092202303754,6.159041230769227,8.074192598823004,4.243889862715451,6.3776891449999935,6.764375309999998,6.512301660000002,6.383394650000008,4.2224580000000005,88494836,31740794.6,17.54952231802241,41.06413754254892,1.5,2.75,NaN,NaN,0.4294125564841866,2.7880472784383286,237.34453814017087,-0.28523007252924704,-0.4866396548179681,-0.20140958228872108,138.24018651906607,-43.29419147540423,3.5840307100205777,79.58690539729926,16.829063892680157,4184183520
1312896600,4.176625,4.555788,3.781629,4.555788,3.781629,7.351928,7.600758,6.050773,7.600758,6.050773,7.255762,5.955774,4.239124,3.176635,6.376089164999993,6.748408809999998,6.461468840000002,6.272812400000007,6.393536108069809,5.937016723065578,5.954684307692303,7.942203823886587,3.967164791498019,6.376089164999993,6.748408809999998,6.461468840000002,6.272812400000007,4.297735,83289880,34898715.6,29.1916293069948,30.562827363640015,1.5,2.75,NaN,NaN,0.45403730244960183,2.3866173458830673,247.13304235760955,-0.27452397295584924,-0.5445645484835326,-0.2700405755276834,176.01152030340043,-30.78871268763004,19.51555258216021,49.51072736817096,30.973720049668845,4267473400
1312983000,4.264124,4.407456,3.91996,3.944127,3.723408864864865,7.346583869565217,7.600758,6.050773,7.600758,6.050773,7.255762,5.955774,4.239124,3.176635,6.3711912899999925,6.725486199999998,6.3940195000000015,6.128355500000007,6.297480848929816,5.747217701821238,5.70128938461538,7.806105449630021,3.596473319600739,6.3711912899999925,6.725486199999998,6.3940195000000015,6.128355500000007,4.090514333333333,81485588,38084888.4,25.101564679513245,32.66506957175699,1.5,2.75,NaN,NaN,0.46702235227463024,2.1395779644715986,240.7433184646255,-0.28999546455065306,-0.6325349062159997,-0.34253944166534667,185.1663047672144,-39.39045107634575,5.566551791497884,74.18447811478815,20.248970093713968,4185987812
1313069400,4.060793,4.666737,4.013293,4.498288,3.6651887297297296,7.341239739130435,7.600758,6.050773,7.600758,6.050773,7.255762,5.955774,4.239124,3.176635,6.3690704699999925,6.705236399999998,6.3474366400000015,6.018773250000008,6.226924266618843,5.628272015933501,5.500393846153841,7.526120032505764,3.474667659801918,6.3690704699999925,6.705236399999998,6.3474366400000015,6.018773250000008,4.392772666666667,76133116,40622039.6,34.10912102059666,19.12497854620007,1.5,2.75,NaN,NaN,0.4852786128264424,1.8741825065819688,248.9927203568203,-0.2460025271996441,-0.6500426006649018,-0.4040400734652577,212.47506414921727,-29.63109374406037,20.98489065356805,47.5416886952857,31.47342065114624,4262120928
1313155800,4.62662,4.709119,4.487456,4.593287,3.6069685945945946,7.335895608695652,7.600758,6.050773,7.600758,6.050773,7.255762,5.955774,4.239124,3.176635,6.367587154999992,6.686636579999998,6.303203740000002,5.908024350000007,6.16286006008477,5.529702014416024,5.313152076923073,7.183719375902711,3.442584777943435,6.367587154999992,6.686636579999998,6.303203740000002,5.908024350000007,4.5966206666666665,61731760,42755440.8,35.54028817517454,12.320142922096931,1.5,2.75,NaN,NaN,0.46644892619598227,1.4438340207686504,252.51927954649938,-0.19578657690681095,-0.6487732945987714,-0.45298671769196047,214.89121112665703,-27.1285063149762,45.52844390649878,22.54638850959329,31.92516758390793,4323852688
1313415000,4.714953,4.904951,4.699952,4.890784,3.5487484594594596,7.33055147826087,7.600758,6.050773,7.600758,6.050773,7.255762,5.955774,4.239124,3.176635,6.3675663149999915,6.670461729999999,6.269037400000001,5.821650200000007,6.112974724395172,5.4688526797097365,5.183025076923072,6.912320865027042,3.453729288819102,6.3675663149999915,6.670461729999999,6.269037400000001,5.821650200000007,4.831895666666667,37084904,43400989,39.93975832306241,5.901485479211277,1.5,2.75,NaN,NaN,0.4553928600391264,0.8544714038659349,259.957430321828,-0.13093337925403908,-0.6166534417595093,-0.48572006250547023,221.76911204233755,-15.796273420249557,73.89211485686945,5.6644075363522575,20.44347760677831,4360937592
1313501400,4.749953,4.894118,4.602454,4.752452,3.4905283243243246,7.325207347826087,7.600758,6.050773,7.600758,6.050773,7.255762,5.955774,4.239124,3.176635,6.366762149999991,6.650978589999998,6.236587720000001,5.7117763000000075,6.059620892065949,5.400624043546904,5.04802638461538,6.608442391193811,3.4876103780369485,6.366762149999991,6.650978589999998,6.236587720000001,5.7117763000000075,4.7496746666666665,54432076,45303107.8,38.619839480514834,6.696924266856254,1.5,2.75,NaN,NaN,0.44369794146490305,1.2015086523490117,255.10578508145215,-0.08782071526001722,-0.5954959565804918,-0.5076752413204746,218.90882844524117,-19.506011746397593,43.98224062734854,23.73318045176868,32.28457892088278,4306505516
1313587800,4.832453,4.942451,4.63912,4.750785,3.432308189189189,7.319863217391305,7.600758,3.944127,7.600758,6.050773,7.255762,5.955774,4.239124,3.176635,6.3659496499999895,6.630824609999998,6.204238020000002,5.602652350000008,6.008293994337873,5.338734610828151,4.921745461538456,6.279007646650964,3.5644832764259484,6.3659496499999895,6.630824609999998,6.204238020000002,5.602652350000008,4.777452,41823248,46711207.8,38.60328316608284,6.0741468118774185,1.5,2.75,NaN,NaN,0.4336717313602671,0.8953578802558816,256.90778147746295,-0.051672831466015645,-0.5722662806529941,-0.5205934491869785,218.10173102263835,-5.612580419694351,52.239736501175436,17.525215853436716,30.235047645387844,4264682268
1313674200,4.384956,4.389955,3.986627,4.124126,3.374088054054054,7.314519086956522,7.600758,3.944127,7.600758,6.050773,7.255762,5.955774,4.239124,3.176635,6.361420529999989,6.604891539999998,6.161105120000001,5.448237250000007,5.934405053383446,5.223057600273089,4.754118999999995,5.91094843817527,3.59728956182472,6.361420529999989,6.604891539999998,6.161105120000001,5.448237250000007,4.166902666666666,53378452,48229260.8,32.89435093442164,19.6965780458262,1.5,2.75,NaN,NaN,0.4572778934059623,1.1067648791332918,248.32275365556845,-0.061553025280678186,-0.5975347307878263,-0.5359817055071481,214.13282623309166,-16.907313786597733,21.236442642755907,47.14526527906959,31.6182920781745,4211303816
1313760600,3.959126,4.265791,3.895794,3.914128,3.315867918918919,7.309174956521739,7.600758,3.944127,7.600758,6.050773,7.255762,5.955774,4.239124,3.176635,6.355520589999989,6.575491839999997,6.111155620000001,5.282030600000008,5.85517850227037,5.098397638342319,4.60841538461538,5.670732529223781,3.5460982400069794,6.355520589999989,6.575491839999997,6.111155620000001,5.282030600000008,4.0252376666666665,44503560,49729992.2,31.22771983988784,20.04908606700684,1.5,2.75,NaN,NaN,0.451043543876965,0.894903820234261,243.41875729261417,-0.07303416692295328,-0.6272744141608397,-0.5542402472378865,214.86834284664252,-1.7775079856490532,3.4661965759703444,79.90392301150258,16.62988041252707,4166800256
1314019800,4.169957,4.174959,3.878294,3.913295,3.257647783783784,7.303830826086957,7.600758,3.944127,7.600758,6.050773,7.255762,5.955774,4.239124,3.176635,6.348249834999989,6.544554649999997,6.066606080000001,5.122198850000008,5.779026208063689,4.985530720404955,4.455275923076918,5.271869888807731,3.6386819573461056,6.348249834999989,6.544554649999997,6.066606080000001,5.122198850000008,3.9888493333333326,46694504,51448323,31.220962450086546,17.657400030103645,1.5,2.75,NaN,NaN,0.4400165050286104,0.9076001175004286,242.60002066198766,-0.0714020099393542,-0.6434927596620792,-0.572090749722725,174.9930846864765,-14.102785292028504,0,100,0,4120105752
1314106200,3.955794,4.312457,3.892544,4.304123,3.1994276486486486,7.298486695652174,7.600758,3.944127,7.600758,6.050773,7.255762,5.955774,4.239124,3.176635,6.342554049999989,6.517721569999996,6.02975646,4.9860335000000084,5.721186866570995,4.920634747033055,4.399186769230765,5.146498219222061,3.651875319239468,6.342554049999989,6.517721569999996,6.02975646,4.9860335000000084,4.169708,47940404,53052583.6,37.99982692716903,9.694605210403966,1.5,2.75,NaN,NaN,0.4385805403837097,0.9036393846802213,245.29564553251822,-0.0364786221376775,-0.6176890273948219,-0.5812104052571444,165.1756110767149,9.12739371729155,4.698922894813045,76.48653679317755,18.814540312009388,4168046156
1314192600,4.274957,4.502455,4.242624,4.483289,3.1412075135135136,7.293142565217392,7.600758,3.944127,7.600758,6.050773,7.255762,5.955774,4.239124,3.176635,6.337874934999989,6.4918051799999965,5.991806840000001,4.881076200000008,5.672641852195662,4.878982771125145,4.362264076923072,5.038494943838739,3.686033210007405,6.337874934999989,6.4918051799999965,5.991806840000001,4.881076200000008,4.409456,46331956,54109530.2,40.87665852040626,3.6291959373103646,1.5,2.75,NaN,NaN,0.4258127160705876,0.8562623964530374,248.79651650428733,0.004055690285470037,-0.5761407924003068,-0.5801964826857768,140.79101432227486,-0.3334379657327308,21.181629390896184,47.37895986904193,31.43941074006188,4214378112
1314279000,4.560788,4.63662,4.224958,4.269124,3.0829873783783786,7.287798434782609,7.600758,3.944127,7.600758,6.050773,7.255762,5.955774,4.239124,3.176635,6.332758324999989,6.463538799999997,5.95617386,4.769160650000009,5.617601936423283,4.820900983398941,4.384122769230764,5.027740580559173,3.7405049579023553,6.332758324999989,6.463538799999997,5.95617386,4.769160650000009,4.376900666666667,51736596,55470006,38.5726774512576,5.330957593209302,1.5,2.75,NaN,NaN,0.4248019506369742,0.9326949775343453,246.3327291892205,0.02087123665707813,-0.5541074368644292,-0.5749786735215073,122.01367951786293,-7.05732082493431,21.14782993316122,47.42319254785888,31.428977518979895,4162641516
1314365400,4.198291,4.528288,4.003292,4.479122,3.024767243243243,7.2824543043478265,7.600758,3.944127,7.600758,6.050773,7.255762,5.955774,4.239124,3.176635,6.328337534999988,6.437372399999996,5.9242408399999995,4.673494900000009,5.572955664406684,4.788350604027613,4.378225384615379,5.016828766149001,3.739622003081757,6.328337534999988,6.437372399999996,5.9242408399999995,4.673494900000009,4.336900666666667,50740536,56272263.2,42.023381738235955,4.127241834988767,1.5,2.75,NaN,NaN,0.43195866844861885,0.9016970904415303,251.5328894431614,0.04896034321699971,-0.5137782445002577,-0.5627385877172574,125.08474507208162,-8.417096318299883,47.029804632079035,21.449444020515745,31.520751347405216,4213382052
1314624600,4.648287,4.883285,4.64162,4.869951,2.966547108108108,7.2771101739130435,7.600758,3.913295,7.600758,6.050773,7.255762,5.955774,4.239124,3.176635,6.3260875549999875,6.414555949999996,5.8991244400000005,4.601828950000009,5.545386854037794,4.796122070310697,4.44944261538461,5.085007647652405,3.8138775831168163,6.3260875549999875,6.414555949999996,5.8991244400000005,4.601828950000009,4.798285333333333,29043636,55729490,47.89043355017551,5.474765452329885,1.5,2.75,NaN,NaN,0.4299732635594317,0.5211538092309834,260.6121698845473,0.09407164295684312,-0.4451490340212034,-0.5392206769780465,129.5591421752179,2.472386885759193,72.47853259188165,6.265650888693639,21.255816519424712,4242425688
1314711000,4.811619,5.009117,4.70662,4.905784,2.908326972972973,7.2717660434782605,7.600758,3.913295,7.600758,6.050773,7.255762,5.955774,4.239124,3.176635,6.325050064999988,6.392664499999996,5.87274136,4.556704400000009,5.520304389173567,4.80656606361444,4.480788461538456,5.161490076746048,3.800086846330864,6.325050064999988,6.392664499999996,5.87274136,4.556704400000009,4.873840333333334,41673536,55647093.6,48.40595612044943,6.2821814524315585,1.5,2.75,NaN,NaN,0.42086781616232943,0.7488897138016926,263.1035342801595,0.12461789104427745,-0.3834483131726998,-0.5080662042169772,128.32993160219152,3.2625976549138747,72.41896937068869,6.291004983374443,21.290025645936865,4284099224
1314797400,5.016617,5.146365,4.870785,4.994116,2.850106837837838,5.146365,7.600758,3.913295,7.600758,6.050773,7.255762,5.955774,4.239124,3.176635,6.324554234999988,6.372497189999995,5.84289164,4.51120480000001,5.499669550382446,4.824427962317826,4.511621461538455,5.244244403514273,3.778998519562638,6.324554234999988,6.372497189999995,5.84289164,4.51120480000001,5.003755333333333,48416704,55710115.4,49.726310648018995,6.626691630425505,1.5,2.75,NaN,NaN,0.41049011500787735,0.8690828165112723,264.84963627616406,0.1475000962793631,-0.32369108386777334,-0.47119118014713646,128.5709901056105,21.0951362785715,73.45127729023459,5.8581946430913785,20.69052806667405,4332515928
1314883800,4.990783,5.129115,4.800219,4.823285,2.791886702702703,5.0866604358974365,7.600758,3.913295,7.600758,6.050773,7.255762,5.955774,4.239124,3.176635,6.324400069999988,6.351255729999996,5.811875260000001,4.500704950000009,5.473144666053723,4.824319108763747,4.506429230769225,5.229119222686029,3.783739238852421,6.324400069999988,6.351255729999996,5.811875260000001,4.500704950000009,4.917539666666667,44807440,55124660.8,47.21003279511848,4.628228830354404,1.5,2.75,NaN,NaN,0.4046619639358861,0.8128383803134441,260.50044175789446,0.14750374515870635,-0.28681149869875355,-0.4343152438574599,94.15443056888236,23.227574570887832,73.96485902682461,5.6481048555978655,20.38703611757752,4287708488
1314970200,4.516622,4.594954,4.390789,4.44329,2.7336665675675675,5.026955871794872,7.600758,3.913295,7.600758,6.050773,7.255762,5.955774,4.239124,3.176635,6.322241764999988,6.327847639999996,5.774242340000001,4.474705250000009,5.43275820856142,4.788030622214819,4.482647538461533,5.191605526427888,3.7736895504951784,6.322241764999988,6.327847639999996,5.774242340000001,4.474705250000009,4.4763443333333335,38387024,53406487.8,42.10601290585324,4.679878466899644,1.5,2.75,NaN,NaN,0.40665010936903717,0.718770800726574,254.7962929666342,0.11948281815836215,-0.28496172115950724,-0.4044445393178694,103.12249149894785,13.543446124046358,46.42568370341243,21.824496244130806,31.749820052456762,4249321464
1315315800,4.056625,4.362457,4.04996,4.347457,2.6754464324324325,4.967251307692308,7.600758,3.913295,7.600758,6.050773,7.255762,5.955774,4.239124,3.176635,6.318529304999988,6.303406219999996,5.738876040000001,4.49283005000001,5.39019737685313,4.746071229622932,4.451622307692302,5.146080609572324,3.757164005812281,6.318529304999988,6.303406219999996,5.738876040000001,4.49283005000001,4.253291333333333,50932120,51528352,40.90492299133686,8.297468864109057,1.5,2.75,NaN,NaN,0.4056986729855346,0.9884290497006386,250.2744163184877,0.09322776269291361,-0.28790983595172737,-0.381137598644641,104.83607796779086,1.0068020825613175,21.33337389317228,47.285729388303935,31.38089671852379,4198389344
1315402200,4.545788,4.729119,4.503287,4.708286,2.6172262972972975,4.9075467435897435,7.600758,3.913295,7.600758,6.050773,7.255762,5.955774,4.239124,3.176635,6.316406409999988,6.282398089999997,5.707843020000001,4.50045495000001,5.363455754231438,4.74247263632551,4.496557692307686,5.175869119140378,3.817246265474994,6.316406409999988,6.282398089999997,5.707843020000001,4.50045495000001,4.646897333333334,31600168,48943866.4,47.03152798271551,1.368717047559519,1.5,2.75,NaN,NaN,0.40398176777228206,0.6456410235706266,257.4975675036339,0.09838647175192938,-0.25815450895472924,-0.35654098070665863,100.56579600364296,5.018570072105548,17.940965160898898,51.90755035177645,30.151484487324645,4229989512
1315488600,4.639953,4.800785,4.539955,4.572454,2.559006162162162,4.84784217948718,7.600758,3.913295,7.600758,6.050773,7.255762,5.955774,4.239124,3.176635,6.313602264999989,6.259264989999997,5.669060060000001,4.5318713000000095,5.332436077594911,4.7262803852468895,4.547198153846148,5.1376232987374415,3.9567730089548543,6.313602264999989,6.259264989999997,5.669060060000001,4.5318713000000095,4.637731333333334,40627028,46900938.4,45.13454686464549,0.6278386978214254,1.5,2.75,NaN,NaN,0.39375664150283335,0.8662305997698332,255.12576056275654,0.09104430437588729,-0.24273560023679952,-0.3337799046126868,100.49390450214021,7.105204721155907,2.454518600241273,83.4084350771224,14.137046322636342,4189362484
1315575000,4.418289,4.471622,4.134959,4.209958,2.500786027027027,4.788137615384616,7.600758,3.913295,7.600758,6.050773,7.255762,5.955774,4.239124,3.176635,6.3101147999999885,6.234890229999998,5.619543900000002,4.517454800000009,5.288417329453934,4.677106824747185,4.570018384615379,5.077829316384607,4.062207452846151,6.3101147999999885,6.234890229999998,5.619543900000002,4.517454800000009,4.272179666666667,46033288,45395947,40.4460286127018,8.497527458763884,1.5,2.75,NaN,NaN,0.3968808099669166,1.0140396013767485,249.56841785503963,0.06157904304117279,-0.2568061008112208,-0.3183851438523936,108.26681933835488,-6.009302716023362,2.5842975524423424,82.9496796401723,14.46602280738534,4143329196
1315834200,4.0458,4.296624,4.004127,4.289957,2.442565891891892,4.728433051282051,7.600758,3.913295,7.600758,6.050773,7.255762,5.955774,4.239124,3.176635,6.305869009999989,6.210273809999997,5.567861060000002,4.502288300000009,5.249262022416525,4.6402354128665015,4.568928692307687,5.079072684014031,4.058784700601343,6.305869009999989,6.210273809999997,5.567861060000002,4.502288300000009,4.196902666666667,52490960,44933907,41.88089500990224,9.010253351086272,1.5,2.75,NaN,NaN,0.38942482354070823,1.168181524922816,248.6362451945599,0.047890718752661876,-0.25852174541156625,-0.3064124641642281,104.63547768105929,-11.909647550868582,17.575563717918662,52.330293993463,30.09414228861833,4195820156
1315920600,4.327456,4.464123,4.240791,4.414956,2.3843457567567565,4.668728487179488,7.600758,3.913295,7.600758,6.050773,7.255762,5.955774,4.239124,3.176635,6.302789914999989,6.183865739999996,5.512778280000003,4.478496900000009,5.216544139184505,4.618780230688739,4.563672307692302,5.078623133855126,4.048721481529478,6.302789914999989,6.183865739999996,5.512778280000003,4.478496900000009,4.37329,49243944,45541859,44.14536524764887,3.029065388007485,1.5,2.75,NaN,NaN,0.37756105043065763,1.0812897207380139,253.7452269830628,0.04757127976919784,-0.24694836445273083,-0.29451964422192867,91.71713760760508,-10.005087871785625,46.322781632191685,21.999475487463638,31.677742880344695,4245064100
1316007000,4.489955,4.762452,4.301624,4.603954,2.326125621621622,4.609023923076924,7.600758,3.913295,7.600758,6.050773,7.255762,5.955774,4.239124,3.176635,6.300776599999989,6.158326829999997,5.461658800000002,4.471072000000009,5.192520996471387,4.617368208718383,4.589428461538457,5.07556127802675,4.1032956450501645,6.300776599999989,6.158326829999997,5.461658800000002,4.471072000000009,4.55601,51805740,45410542.2,47.47754246791628,2.6086731974904334,1.5,2.75,NaN,NaN,0.38350868968561064,1.1408306857873192,258.1087118289171,0.059623786713342675,-0.21998991083025032,-0.279613697543593,96.11316719629153,-7.812433671945147,51.23511222740558,18.343627251419203,30.421260521175206,4296869840
1316093400,4.751619,4.840785,4.623287,4.839952,2.2679054864864865,4.549319358974359,7.600758,3.913295,7.600758,6.050773,7.255762,5.955774,4.239124,3.176635,6.30041410499999,6.135302059999998,5.414542600000002,4.475530350000009,5.178694761315646,4.638566665030918,4.617184615384611,5.115994244398781,4.118374986370441,6.30041410499999,6.135302059999998,5.414542600000002,4.475530350000009,4.768008000000001,39707700,45304764.8,51.378182397062375,4.967734862885736,1.5,2.75,NaN,NaN,0.3730317118509242,0.8764574802516136,262.9340182533374,0.08166251287951382,-0.17753555644420072,-0.25919806932371453,100.72189671278117,0.3455528752706918,77.32629391840528,4.390240687280772,18.28346539431395,4336577540
1316179800,4.891618,4.967884,4.770786,4.909118,2.2096853513513515,4.4896147948717955,7.600758,3.913295,7.600758,6.050773,7.255762,5.955774,4.239124,3.176635,6.298839124999989,6.111160639999998,5.364176440000001,4.51477995000001,5.1681231236169936,4.664333458837498,4.620197461538457,5.1255083791410545,4.11488654393586,6.298839124999989,6.111160639999998,5.364176440000001,4.51477995000001,4.8825959999999995,33819060,44326795.2,52.491780792353474,5.4427539716090765,1.5,2.75,NaN,NaN,0.36046501814728676,0.762948456964017,263.82212432491116,0.09797214747042715,-0.1367328849856806,-0.23470503245610774,98.99877848437487,10.483853180863733,100,0,0,4370396600
1316439000,4.664953,4.839119,4.565787,4.764527,2.1514652162162164,4.429910230769231,7.600758,3.913295,7.600758,6.050773,7.255762,5.955774,4.239124,3.176635,6.29552036499999,6.084173319999999,5.314068420000001,4.557299900000009,5.152295824651621,4.6738757008529745,4.609331538461534,5.0953162195221715,4.123346857400897,6.29552036499999,6.084173319999999,5.314068420000001,4.557299900000009,4.723144333333334,39726384,44087936.4,49.91790806652968,2.019163563149956,1.5,2.75,NaN,NaN,0.35924115970819487,0.901071523048196,258.8795974986237,0.09597114975078166,-0.11474109526763066,-0.21071224501841232,86.61775053113399,9.593424385796105,77.63109780861613,4.235812563659974,18.133089627723912,4330670216
1316525400,4.827451,4.95995,4.722453,4.731619,2.093245081081081,4.370205666666667,7.600758,3.913295,7.600758,6.050773,7.255762,5.955774,4.239124,3.176635,6.29178706499999,6.056131939999999,5.271385500000001,4.598216100000009,5.135798694273126,4.679375062676501,4.5891394615384575,5.0291336538166425,4.149145269260273,6.29178706499999,6.056131939999999,5.271385500000001,4.598216100000009,4.804674,37661776,43636300,49.325107361841944,3.5289662829268473,1.5,2.75,NaN,NaN,0.35054514830046674,0.8630836253302869,255.9691699981877,0.08950690852662974,-0.09882860936012516,-0.1883355178867549,85.2219400645815,0.4955731236377749,49.96111775541104,19.127014610453298,30.911867634135675,4293008440
1316611800,4.729119,4.775786,4.291624,4.294956,2.035024945945946,4.310501102564103,7.600758,3.913295,7.600758,6.050773,7.255762,5.955774,4.239124,3.176635,6.285945449999989,6.023073919999998,5.2219359600000015,4.597757750000008,5.102824470968298,4.642763723373977,4.548498769230765,4.992061793825677,4.104935744635853,6.285945449999989,6.023073919999998,5.2219359600000015,4.597757750000008,4.454121999999999,64955196,44487039.6,42.16902285017802,3.385040741556426,1.5,2.75,NaN,NaN,0.3600892091361477,1.4600925704213412,249.78184271834186,0.0546133537432508,-0.1200688257076914,-0.1746821794509422,91.2025069488403,-6.068907418204745,16.39086746571633,53.889758102515465,29.719374431768205,4228053244
1316698200,3.928294,4.037218,3.713214,3.879128,1.976804810810811,4.250796538461539,7.600758,3.913295,7.600758,6.050773,7.255762,5.955774,4.239124,3.176635,6.2779871999999886,5.986324299999999,5.1628532200000015,4.567549700000009,5.05483637406758,4.570036511624075,4.505101692307688,5.074024255492296,3.9361791291230803,6.2779871999999886,5.986324299999999,5.1628532200000015,4.567549700000009,3.8765199999999993,70631108,45701997.2,36.707494606474604,17.005661279261215,1.5,2.75,NaN,NaN,0.3759215513407086,1.5454709274718523,242.0504133550223,0.004935199934202467,-0.16851317953318912,-0.17344837946739158,105.40949317518496,-7.858273170421182,2.659714221198674,82.5254445596662,14.814841219135138,4157422136
1316784600,3.810795,4.014959,3.799129,3.954127,1.9185846756756757,4.191091974358975,7.600758,3.913295,7.600758,6.050773,7.255762,5.955774,4.239124,3.176635,6.270178944999989,5.951395469999999,5.108137100000002,4.551799850000008,5.011671300574734,4.511378462897972,4.474845538461535,5.111847525895998,3.8378435510270723,6.270178944999989,5.951395469999999,5.108137100000002,4.551799850000008,3.922738333333333,44408460,45335590.4,38.26062982515724,12.55302605855305,1.5,2.75,NaN,NaN,0.364486440530658,0.9795496123063614,245.04255993840866,-0.020093259047234635,-0.19856495327643486,-0.17847169422920023,97.97129133410795,-7.828283593518537,2.940936693901258,81.57102627165467,15.488037034444083,4201830596
1317043800,4.071626,4.240791,3.879128,4.22329,1.8603645405405405,4.13138741025641,7.600758,3.913295,7.600758,6.050773,7.255762,5.955774,4.239124,3.176635,6.263416504999989,5.920695769999998,5.056437600000002,4.539008250000008,4.980754386826705,4.4839414664314985,4.43753815384615,5.072288083169912,3.802788224522388,6.263416504999989,5.920695769999998,5.056437600000002,4.539008250000008,4.114403,57883044,45692715.8,43.608886271688526,6.552354600288575,1.5,2.75,NaN,NaN,0.36428476620703953,1.2667893117440834,249.69013995385757,-0.01592284419798573,-0.1983752494766824,-0.18245240527869666,105.76618648925155,-4.341289018508897,16.54084000798607,53.70737722443266,29.751782767581254,4259713640
1317130200,4.466623,4.598287,4.29829,4.374124,1.8021444054054054,4.071682846153847,7.600758,3.913295,7.600758,6.050773,7.255762,5.955774,4.239124,3.176635,6.256912404999988,5.893254389999999,5.011554740000003,4.514216900000008,4.956964959892324,4.473482660104689,4.4222819999999965,5.052847705207142,3.791716294792851,6.256912404999988,5.893254389999999,5.011554740000003,4.514216900000008,4.423567,58257628,47153415.4,46.41043899195597,1.7021638846305067,1.5,2.75,NaN,NaN,0.3650499257636795,1.2354911623220404,256.07332865851106,-0.0011849499046254763,-0.1839335926594785,-0.18274864275485303,106.49259429595891,-4.992013386754076,38.96938876207487,28.0362846419615,32.99432659596363,4317971268
1317216600,4.403289,4.473288,4.070793,4.083293,1.7439242702702704,4.011978282051283,7.600758,3.913295,7.600758,6.050773,7.255762,5.955774,4.239124,3.176635,6.2489208249999875,5.86205637,4.954222000000002,4.473092350000008,4.92270331440635,4.436321740094718,4.4125385384615345,5.0596244341948555,3.7654526427282136,6.2489208249999875,5.86205637,4.954222000000002,4.473092350000008,4.209124666666667,33211760,46730326.6,42.07042473913518,3.878424680001722,1.5,2.75,NaN,NaN,0.3677245739234167,0.7107110610264812,250.10868926648382,-0.008779476743372067,-0.19372298868406812,-0.18494351194069605,109.10827283255384,-15.633605457244203,49.458288786224706,19.52354480843923,31.018166405336057,4284759508
1317303000,4.302457,4.352456,3.95226,4.176625,1.685704135135135,3.952273717948718,7.600758,3.879128,7.600758,6.050773,7.255762,5.955774,4.239124,3.176635,6.241325064999988,5.83074835,4.899089220000002,4.432217800000008,4.8934453412923755,4.411588717228555,4.403820692307688,5.060263662260793,3.747377722354584,6.241325064999988,5.83074835,4.899089220000002,4.432217800000008,4.160447,62391716,47429077.2,43.884004701174675,5.781609409193774,1.5,2.75,NaN,NaN,0.37004396150031554,1.3154739599276875,254.44051404160493,-0.005437019461993209,-0.19173978626818755,-0.18630276680619434,104.45855924901362,-14.921071361495093,85.30068895741212,1.9211106067215276,12.778200435866362,4347151224
1317389400,4.001627,4.110792,3.856628,3.864128,1.627484,3.8925691538461544,7.600758,3.879128,7.600758,6.050773,7.255762,5.955774,4.239124,3.176635,6.232556404999988,5.794377880000001,4.832123220000002,4.384259950000008,4.853079955359341,4.359449601302026,4.361449307692303,5.077912055365421,3.644986560019185,6.232556404999988,5.794377880000001,4.832123220000002,4.384259950000008,3.9438493333333344,49061828,47641796.6,39.432649171452915,8.071376239230759,1.5,2.75,NaN,NaN,0.3664691785360073,1.0298064200206924,248.23653453630934,-0.021301356174859398,-0.2129294620247686,-0.1916281058499092,108.38546529552356,-18.89797245350903,61.03138195481081,11.978784103660256,26.989833941528943,4298089396
1317648600,3.792461,3.945795,3.503297,3.510798,1.569263864864865,3.8328645897435902,7.600758,3.879128,7.600758,6.050773,7.255762,5.955774,4.239124,3.176635,6.221539844999988,5.756861590000001,4.757573960000003,4.337635350000007,4.800441447306033,4.278625639273261,4.27736038461538,5.1077751344293745,3.4469456348013856,6.221539844999988,5.756861590000001,4.757573960000003,4.337635350000007,3.6532966666666664,61619356,48803413.2,35.09769980385411,15.849176487072224,1.5,2.75,NaN,NaN,0.3718998086405782,1.2626034115171272,239.29947865968333,-0.05092982108794625,-0.255290382209842,-0.20436056112189577,116.04032888651406,-25.80133776620646,29.927021262062745,36.9695818732218,33.10339686471545,4236470040
1317735000,3.3708,3.771628,3.269968,3.751629,3.269968,3.773160025641026,7.600758,3.879128,7.600758,6.050773,7.255762,5.955774,4.239124,3.176635,6.2115399449999895,5.72073695,4.690407940000003,4.307843950000007,4.759311547411679,4.228435483151998,4.193643230769227,4.9993795864562385,3.3879068750822148,6.2115399449999895,5.72073695,4.690407940000003,4.307843950000007,3.5977416666666664,105557036,51534659,39.94390421776055,15.73550711690459,1.5,2.75,NaN,NaN,0.3811683937376798,2.0482727168137465,241.85236748987361,-0.04959815549612484,-0.26635825549205183,-0.216760099995927,128.4209893706191,-12.65035078357031,38.0303291678676,28.948298964267924,33.02137186786448,4342027076
1317821400,3.778296,3.998293,3.675797,3.966628,3.256848487179487,3.7134554615384623,7.600758,3.879128,7.600758,6.050773,7.255762,5.955774,4.239124,3.176635,6.202465039999989,5.68862061,4.629191900000002,4.270761050000006,4.728225918101417,4.203501437137522,4.121143999999996,4.818664435418089,3.423623564581902,6.202465039999989,5.68862061,4.629191900000002,4.270761050000006,3.8802393333333334,71071968,53508249,43.96642853896003,4.897945002950204,1.5,2.75,NaN,NaN,0.3769775084707026,1.3282432022770918,245.95596422601125,-0.03046658167471103,-0.2548433270893158,-0.22437674541460476,126.24774632285582,2.2556615816750547,60.07179406943486,12.575011819776316,27.353194110788817,4413099044
1317907800,3.958294,4.208291,3.874129,4.195792,3.2437289743589743,3.653750897435898,7.600758,3.879128,7.600758,6.050773,7.255762,5.955774,4.239124,3.176635,6.1939567949999885,5.660137570000001,4.581459040000002,4.251927950000007,4.707346156607244,4.202767205029186,4.077395153846149,4.6717240195896075,3.483066288102691,6.1939567949999885,5.660137570000001,4.581459040000002,4.251927950000007,4.092737333333333,56575224,54305658.8,47.966940587829356,0.9207672757701103,1.5,2.75,NaN,NaN,0.3739192578656524,1.041792425506861,251.59760627420962,-0.0002078622192913937,-0.224636573188719,-0.2244287109694276,115.37379340637374,6.111715683385985,59.27783670771884,13.046076661743355,27.67608663053781,4469674268
1317994200,4.259957,4.272624,4.028293,4.087459,3.2306094615384615,3.594046333333334,7.600758,3.879128,7.600758,6.050773,7.255762,5.955774,4.239124,3.176635,6.184644389999989,5.630771200000001,4.533059520000003,4.245803000000007,4.683036856348136,4.191785471216883,4.02784438461538,4.487998512221497,3.567690257009263,6.184644389999989,5.630771200000001,4.533059520000003,4.245803000000007,4.129458666666667,47213536,54364671.2,46.28464137894231,1.17259832214408,1.5,2.75,NaN,NaN,0.3646629537323916,0.8684598831897286,247.37285955417008,0.013901128151448255,-0.20705230078011727,-0.22095342893156553,116.6689425421198,-3.2162366306836723,59.011353163664566,13.206051129998295,27.782595706337148,4422460732
1318253400,4.309957,4.510788,4.28329,4.504955,3.2174899487179487,3.53434176923077,7.600758,3.510798,7.600758,6.050773,7.255762,5.955774,4.239124,3.176635,6.17754445499999,5.6035381300000005,4.495309880000002,4.256552900000006,4.676053254138405,4.221611140624798,4.04399815384615,4.5527083078636625,3.5352879998286384,6.17754445499999,5.6035381300000005,4.495309880000002,4.256552900000006,4.433011,28001800,53140213.2,53.109893146190764,6.3025265279345435,1.5,2.75,NaN,NaN,0.3688533856086494,0.5269418076026838,254.27787550513057,0.05067365947953134,-0.15761135458215136,-0.2082850140616827,123.97184299081427,2.991021745153994,81.38702720316316,3.005092774627693,15.607880022209146,4450462532
1318339800,4.434956,4.565787,4.409956,4.519956,3.204370435897436,3.4746372051282055,7.600758,3.510798,7.600758,6.050773,7.255762,5.955774,4.239124,3.176635,6.170494529999989,5.5760800800000005,4.459643600000003,4.2618029000000055,4.669931793191801,4.25002493675577,4.093292615384612,4.650433393089183,3.5361518376800403,6.170494529999989,5.5760800800000005,4.459643600000003,4.2618029000000055,4.498566333333334,21852852,51770658.6,53.3393092688659,6.856644842210175,1.5,2.75,NaN,NaN,0.3536375009223173,0.42210882748939954,256.00335304113986,0.07392179623950895,-0.11588276876229653,-0.18980456500180548,122.62327213542561,10.693893384579537,74.58929461730213,5.393378472817056,20.01732690988083,4472315384
1318426200,4.619961,4.801619,4.597454,4.645787,3.191250923076923,3.4149326410256418,7.600758,3.510798,7.600758,6.050773,7.255762,5.955774,4.239124,3.176635,6.1639987599999895,5.5514386500000015,4.436393840000003,4.263894550000005,4.668984938556829,4.287716561826649,4.146497230769227,4.768628177247244,3.52436628429121,6.1639987599999895,5.5514386500000015,4.436393840000003,4.263894550000005,4.68162,31997236,50780233.4,55.314292758509104,9.561258818020715,1.5,2.75,NaN,NaN,0.3484964651421518,0.6301120309541547,261.768451794532,0.09437882770501926,-0.0718310303705314,-0.16620985807555066,114.08400423826289,11.233041031933697,69.72542251724819,7.480993881517869,22.793583601233955,4504312620
1318512600,4.572454,4.66662,4.454122,4.623287,3.17813141025641,3.3552280769230776,7.600758,3.510798,7.600758,6.050773,7.255762,5.955774,4.239124,3.176635,6.157253404999989,5.529213880000001,4.410777420000003,4.253061300000006,4.667192862534992,4.3196756511764915,4.177266230769226,4.8491238895224225,3.5054085720160306,6.157253404999989,5.529213880000001,4.410777420000003,4.253061300000006,4.581343,28112080,50200452.4,54.867090702107724,6.076083612436155,1.5,2.75,NaN,NaN,0.3387822890605695,0.5599965469633895,260.40938637170296,0.10233281072063621,-0.038293844674755384,-0.1406266553953916,114.31746200110824,19.64632123987612,37.05974781804557,29.783279496271813,33.15697268568261,4476200540
1318599000,4.792451,4.866617,4.70412,4.860785,3.1650118974358974,3.2955235128205134,7.600758,3.510798,7.600758,6.050773,7.255762,5.955774,4.239124,3.176635,6.151803459999989,5.5094974,4.407327480000003,4.250644650000005,4.674784711063031,4.371209874873968,4.214701692307688,4.974712393997275,3.4546909906181016,6.151803459999989,5.5094974,4.407327480000003,4.250644650000005,4.810507333333333,23740904,49696544.6,58.66581623556741,8.5484046785061,1.5,2.75,NaN,NaN,0.33196426841338594,0.47771739848488376,265.779510699325,0.1183923920409812,0.0073638346558349,-0.1110285573851463,101.15290457678974,38.4524259157035,74.01605134654751,5.623227329061048,20.360721324391434,4499941444
1318858200,4.804118,4.817452,4.543288,4.566621,3.1518923846153846,3.2358189487179496,7.600758,3.510798,7.600758,6.050773,7.255762,5.955774,4.239124,3.176635,6.144845194999989,5.486097630000001,4.399394220000002,4.240749350000005,4.670542996903697,4.3898204582193046,4.251880769230765,5.029621507630297,3.474140030831234,6.144845194999989,5.486097630000001,4.399394220000002,4.240749350000005,4.6424536666666665,23997416,48910096.2,52.74428229650705,4.882097102866982,1.5,2.75,NaN,NaN,0.3309308920981441,0.49064340216938684,260.8713803435028,0.1044912685667769,0.01958552832332483,-0.08490574024345207,87.72994633567797,21.72368323200401,47.79332444601848,20.73039958152624,31.476275972455273,4475944028
1318944600,4.568288,4.94995,4.454122,4.850786,3.1387728717948717,3.176114384615385,7.600758,3.510798,7.600758,6.050773,7.255762,5.955774,4.239124,3.176635,6.1384619299999885,5.46450619,4.416710720000003,4.246707700000005,4.677611349966297,4.433721938388895,4.303739307692303,5.142038900372036,3.46543971501257,6.1384619299999885,5.46450619,4.416710720000003,4.246707700000005,4.751619333333333,32818624,48667938.6,57.23488371563525,6.606146586517618,1.5,2.75,NaN,NaN,0.34270925694827664,0.6743376634407112,266.3710306820383,0.10920952458622304,0.05160616548932673,-0.05760335909689631,86.79545408284746,22.289914758832946,53.097732383145285,16.92477420037818,29.977493416476513,4508762652
1319031000,4.831618,4.908283,4.624245,4.657453,3.125653358974359,3.1164098205128212,7.600758,3.510798,7.600758,6.050773,7.255762,5.955774,4.239124,3.176635,6.131261999999989,5.440106429999999,4.418744020000003,4.264832550000006,4.676820826438207,4.455029658542333,4.364764307692304,5.181392985043045,3.5481356303415623,6.131261999999989,5.440106429999999,4.418744020000003,4.264832550000006,4.729993666666666,26369624,46738660,53.50925848407646,4.802729260007867,1.5,2.75,NaN,NaN,0.33851845288054255,0.5641929828540228,262.1485968615479,0.09462899074292308,0.06068287933175753,-0.03394611141116554,92.04761112570577,11.002952481915221,24.696802712042164,42.79392140543497,32.50927588252285,4482393028
1319117400,4.69912,4.77662,4.509955,4.733286,3.112533846153846,3.056705256410257,7.600758,3.510798,7.600758,6.050773,7.255762,5.955774,4.239124,3.176635,6.123970404999989,5.414273349999999,4.4345272000000024,4.307540450000006,4.679035146970042,4.481530262490683,4.4588018461538415,5.128809379955731,3.788794312351952,6.123970404999989,5.414273349999999,4.4345272000000024,4.307540450000006,4.673286999999999,24831260,44448667.6,54.753376189618216,3.5370491063579785,1.5,2.75,NaN,NaN,0.3333860633890753,0.5586502664930275,264.53064583320463,0.08567855165836463,0.07315207816179026,-0.012526473496574379,88.4708495473592,15.800207414924524,51.528588285545794,18.008980042634747,30.462431671819445,4507224288
1319203800,4.909118,5.018283,4.854118,4.991616,3.0994143333333333,2.997000692307693,7.600758,3.510798,7.600758,6.050773,7.255762,5.955774,4.239124,3.176635,6.118128794999989,5.395915199999999,4.444393760000002,4.359414900000005,4.691293219637884,4.530109856539189,4.554185461538458,5.142398101008032,3.9659728220688835,6.118128794999989,5.395915199999999,4.444393760000002,4.359414900000005,4.954672333333334,27041932,43580341.2,58.7983091386638,7.036615004778593,1.5,2.75,NaN,NaN,0.3299297017184271,0.6205075787704021,270.52257589007706,0.09217739714574953,0.10269527293561254,0.010517875789863004,87.63989681279679,10.8027938125908,53.18885687008851,16.862863554083567,29.94827957582793,4534266220
1319463000,5.025783,5.247448,5.014117,5.22078,3.0862948205128204,2.937296128205129,7.600758,3.510798,7.600758,6.050773,7.255762,5.955774,4.239124,3.176635,6.1135829999999896,5.380073679999999,4.456943620000001,4.409289400000005,4.712057407103065,4.595887965440219,4.650658692307688,5.233123816462647,4.068193568152728,6.1135829999999896,5.380073679999999,4.456943620000001,4.409289400000005,5.160781666666668,25085600,41940469,62.04024750301242,9.782336155059092,1.5,2.75,NaN,NaN,0.32463700873853957,0.5981239742454955,275.68609908950066,0.10594747776459666,0.14295222299560884,0.03700474523101217,75.0179403334396,15.505106686879271,79.03181279426232,3.7614549834504367,17.20673222228724,4559351820
1319549400,5.136615,5.144115,4.873285,4.909951,3.0731753076923076,2.877591564102565,7.600758,3.510798,7.600758,6.050773,7.255762,5.955774,4.239124,3.176635,6.10755805999999,5.363182179999999,4.457326960000002,4.436080750000006,4.719817940157847,4.625798730636388,4.705593999999996,5.238715292718209,4.172472707281783,6.10755805999999,5.363182179999999,4.457326960000002,4.436080750000006,4.9757836666666675,24089484,40232061.8,55.644757966737714,5.204208667394776,1.5,2.75,NaN,NaN,0.3262697224000725,0.5987633474951563,270.18498146832883,0.08885060984590279,0.14806800753839067,0.05921739769248788,86.84864031254037,5.686097963595835,50.706987036983044,18.6243842216694,30.668628741347558,4535262336
1319635800,5.07995,5.10995,4.798285,5.052449,3.060055794871795,2.8178870000000007,7.600758,3.510798,7.600758,6.050773,7.255762,5.955774,4.239124,3.176635,6.10190394499999,5.349957309999999,4.463326900000002,4.484538550000005,4.732862295445774,4.666432089623399,4.779823999999996,5.206004106937824,4.353643893062168,6.10190394499999,5.349957309999999,4.463326900000002,4.484538550000005,4.986894666666667,24992996,39821123.6,57.79287511224404,5.118247275844901,1.5,2.75,NaN,NaN,0.32522652794292456,0.6276316120823874,275.4197675264812,0.08203094421657744,0.16175607796320968,0.07972513374663223,86.94384971490985,9.282616458809496,78.53947252806282,3.9291906339929863,17.5313368379442,4560255332
1319722200,5.465779,5.686611,5.337447,5.579111,3.046936282051282,5.686611,7.600758,3.510798,7.600758,6.050773,7.255762,5.955774,4.239124,3.176635,6.09802481999999,5.342065719999998,4.479893420000002,4.554662850000005,4.766048519153784,4.753353890611646,4.8624513846153805,5.434854648003132,4.290048121227629,6.09802481999999,5.342065719999998,4.479893420000002,4.554662850000005,5.534389666666667,35630576,38483066.6,64.61395231458198,12.626711623270426,1.5,2.75,NaN,NaN,0.3472933473755728,0.9258767335345359,282.0757337818384,0.10633981190881203,0.21264989863264727,0.10631008672383524,100.53509119326327,14.777983391571532,81.31757407625135,3.0264670086185594,15.655958915130087,4595885908
1319808600,5.497445,5.612361,5.477445,5.576611,3.033816769230769,5.7001171500000005,7.600758,3.510798,7.600758,6.050773,7.255762,5.955774,4.239124,3.176635,6.09427069499999,5.335024119999998,4.508943120000002,4.640287000000006,4.797835283108538,4.831759329601013,4.943732538461534,5.593391050401278,4.294074026521789,6.09427069499999,5.335024119999998,4.508943120000002,4.640287000000006,5.555472333333333,16484624,36854206.4,64.56061543976642,10.329345908849069,1.5,2.75,NaN,NaN,0.3321235368487461,0.4472928767230218,281.2277354778333,0.11487287765141377,0.24990118378810244,0.13502830613668867,98.95232314253768,22.11679051097081,60.94257578915524,12.032694992384714,27.02472921846003,4579401284
1320067800,5.389945,5.410778,5.168282,5.168282,3.0206972564102563,5.7136233,7.600758,3.510798,7.600758,6.050773,7.255762,5.955774,4.239124,3.176635,6.0878915949999906,5.322590909999998,4.534026200000002,4.723161200000006,4.812362605339575,4.86380910773425,4.983924461538458,5.619373044432399,4.348475878644518,6.0878915949999906,5.322590909999998,4.534026200000002,4.723161200000006,5.249114,17052264,34625851.8,56.375141942535194,5.5040801321495465,1.5,2.75,NaN,NaN,0.33756678421669284,0.49247204367691544,275.40883101712876,0.08690978173958747,0.24366553331117302,0.15675575157158556,103.00203652809111,6.545248543225764,36.17938081603405,30.566176875059764,33.2544423089062,4562349020
1320154200,4.744953,4.928284,4.681495,4.74912,3.0075777435897435,5.72712945,7.600758,3.510798,7.600758,6.050773,7.255762,5.955774,4.239124,3.176635,6.0791250199999896,5.3086743899999975,4.5507427000000025,4.773035750000007,4.809882503169396,4.852886335569083,4.993603923076919,5.610342039969313,4.376865806184525,6.0791250199999896,5.3086743899999975,4.5507427000000025,4.773035750000007,4.786299666666666,33984312,31047215.6,49.444821435688304,3.935122271411737,1.5,2.75,NaN,NaN,0.3482253710583576,1.0946009599649895,268.3591732652514,0.03664804872067173,0.20256581247242522,0.1659177637517535,111.5043291291977,1.9681787449062669,31.658607160261784,35.03666831206962,33.304724527668604,4528364708
1320240600,4.947451,5.028283,4.833285,4.97245,2.9944582307692307,5.7406356,7.600758,3.510798,7.600758,6.050773,7.255762,5.955774,4.239124,3.176635,6.072520919999991,5.2969328499999975,4.564109240000002,4.823326850000006,4.816257699123537,4.864273351229171,5.002193538461534,5.614386734066981,4.390000342856087,6.072520919999991,5.2969328499999975,4.564109240000002,4.823326850000006,4.9446726666666665,25514676,28769351,52.77585938390637,0.6476866308198134,1.5,2.75,NaN,NaN,0.3432923445541892,0.8868700583478578,274.10230886850655,0.01596357520321537,0.1858722327557727,0.16990865755255732,111.62549466284213,5.052811091491209,31.718440722661843,34.97481562367518,33.30674365366299,4553879384
1320327000,5.158281,5.279947,4.924952,5.247448,2.981338717948718,5.7541417500000005,5.579111,3.510798,7.600758,6.050773,7.255762,5.955774,4.239124,3.176635,6.06749055499999,5.2855996299999966,4.579392420000002,4.875909650000007,4.83316712268732,4.900766174921631,5.054564846153842,5.623722703873661,4.485406988434024,6.06749055499999,5.2855996299999966,4.579392420000002,4.875909650000007,5.150782333333334,27097600,27295469.8,56.570461935834345,4.003370293921462,1.5,2.75,NaN,NaN,0.3441282485146043,0.9927508190388428,278.64791113883336,0.01816281605293668,0.19261217761872818,0.1744493615657915,114.85136198953448,5.125233992358401,25.731739867805455,41.56467776388713,32.703582368307416,4580976984
1320413400,5.122449,5.197032,4.974117,5.172449,2.968219205128205,5.7676479,5.579111,3.510798,7.600758,6.050773,7.255762,5.955774,4.239124,3.176635,6.061882279999989,5.276816389999997,4.597458920000002,4.930159150000007,4.846472294346641,4.926640729690999,5.07930815384615,5.638763662978349,4.519852644713952,6.061882279999989,5.276816389999997,4.597458920000002,4.930159150000007,5.114532666666666,19528092,25911197.6,55.26617759511478,2.104884226609178,1.5,2.75,NaN,NaN,0.3390713021921326,0.7536545512662833,277.49516275829717,0.01221245028243495,0.1897149244188352,0.17750247413640025,112.1502990574531,-0.9257428966552913,24.955732003208826,42.483543136469834,32.560724860321336,4561448892
1320676200,5.165783,5.262447,5.001617,5.250032,2.955099692307692,5.78115405,5.579111,3.510798,7.600758,3.510798,7.255762,6.050773,4.239124,5.955774,6.056128594999989,5.268558979999997,4.612877120000002,4.967413000000008,4.862298165156576,4.957439898291856,5.12489115384615,5.63370345081647,4.61607885687583,6.056128594999989,5.268558979999997,4.612877120000002,4.967413000000008,5.171365333333334,14827708,25252493,56.386389981979065,2.380877592138087,1.5,2.75,NaN,NaN,0.3334826377498374,0.5871779867437247,278.9204974373703,0.011175589108807088,0.1914719605224091,0.18029637141360202,109.3995186975845,6.926362401579967,41.904290147914544,25.47064486140261,32.62506499068283,4576276600
1320762600,5.332448,5.464113,5.174115,5.449112,2.9419801794871794,5.7946602,5.579111,3.510798,7.600758,3.510798,7.255762,6.050773,4.239124,5.955774,6.05134947499999,5.261792389999997,4.624460340000002,5.013870800000008,4.8853104724053384,5.00426581274025,5.179954692307689,5.661535741356874,4.6983736432585035,6.05134947499999,5.261792389999997,4.624460340000002,5.013870800000008,5.362446666666667,22998072,25309754,59.20914334750503,5.0484359479281995,1.5,2.75,NaN,NaN,0.33037659219627763,0.9086643829094506,282.6074211677187,0.02100095467483623,0.2065475647571473,0.18554661008231108,103.45778400803214,7.850905570744013,78.8166501884443,3.830890596688688,17.352459214866997,4599274672
1320849000,5.062449,5.135782,4.810785,4.839952,2.9288606666666666,5.8081663500000005,5.579111,3.510798,7.600758,3.510798,7.255762,6.050773,4.239124,5.955774,6.04306205999999,5.247942529999998,4.623143700000003,5.0235790500000075,4.883531708781599,4.98861687819356,5.168288230769227,5.674283664815002,4.662292796723452,6.04306205999999,5.247942529999998,4.623143700000003,5.0235790500000075,4.928839666666667,43312920,25875538.2,48.8011030363374,3.939895875227347,1.5,2.75,NaN,NaN,0.3523730498965435,1.673894458357585,274.8835272931652,-0.014508362401386227,0.1674111570805783,0.18191951948196453,125.9490301575278,-13.248687828580573,35.90235669863454,30.858438623224657,33.239204678140794,4555961752
1320935400,5.034116,5.04745,4.813284,4.953284,2.9157411538461537,5.8216725,5.579111,3.510798,7.600758,3.510798,7.255762,6.050773,4.239124,5.955774,6.03507047499999,5.232609349999999,4.622327060000003,5.040078900000007,4.886267092750948,4.985251842175126,5.147711615384612,5.665122106713849,4.630301124055375,6.03507047499999,5.232609349999999,4.622327060000003,5.040078900000007,4.938006000000001,23145372,25627202.8,50.54296649912099,2.510046012373513,1.5,2.75,NaN,NaN,0.34392968918964756,0.9031563913015118,279.1454727532195,-0.030430304141915193,0.14388163930457054,0.17431194344648573,109.63906830281034,-11.177523409827218,33.10114283988432,33.59671999551538,33.30213716460031,4579107124
1321021800,5.149114,5.28578,5.134115,5.240781,2.902621641025641,5.83517865,5.579111,3.510798,7.600758,3.510798,7.255762,6.050773,4.239124,5.955774,6.030216359999989,5.221276119999999,4.630676980000003,5.059078700000008,4.900169598917578,5.0095879524441616,5.173160076923073,5.67355436433464,4.672765789511505,6.030216359999989,5.221276119999999,4.630676980000003,5.059078700000008,5.2202253333333335,23107152,25595515.2,54.74877321593027,2.9175366384087376,1.5,2.75,NaN,NaN,0.34311299710467275,0.9027812809956645,284.69910734174414,-0.022056443759390754,0.1467413887472473,0.16879783250663805,116.44053802059594,1.4027678830218735,57.67144685304897,13.976587676154468,28.351965470796554,4602214276
1321281000,5.187448,5.217448,5.03745,5.109116,2.889502128205128,5.8486848,5.579111,3.510798,7.600758,3.510798,7.255762,6.050773,4.239124,5.955774,6.024020594999989,5.209117919999999,4.643993500000003,5.086203450000008,4.908363575430614,5.0190668141161465,5.177519076923073,5.67460764899818,4.6804305048479655,6.024020594999989,5.209117919999999,4.643993500000003,5.086203450000008,5.121338000000001,19988176,25395053.2,52.54496370497871,0.6141651821681136,1.5,2.75,NaN,NaN,0.33312856874005325,0.787089353291845,280.3558139449237,-0.02559308539669275,0.1368064757607721,0.16239956115746484,108.72055766942962,7.580267502189893,39.00193374616175,27.98120073700154,33.01686551683672,4582226100
1321367400,5.066616,5.262581,5.009117,5.182448,2.8763826153846153,5.8621909500000005,5.579111,3.510798,7.600758,3.510798,7.255762,6.050773,4.239124,5.955774,6.016703999999989,5.199784679999999,4.660693320000004,5.102786550000007,4.919111984237256,5.034626927057466,5.147006538461534,5.58718497575652,4.706828101166549,6.016703999999989,5.199784679999999,4.660693320000004,5.102786550000007,5.151382000000001,20019260,24755085,53.66370290370488,2.0633324484428925,1.5,2.75,NaN,NaN,0.327438242401478,0.8086928402790781,283.0398559775031,-0.023268840908406002,0.13331351002195735,0.15658235093036335,94.91915156011272,4.223229997285034,36.87554259857215,29.92426734513358,33.20019005629427,4602245360
1321453800,5.024116,5.215781,4.91745,4.939117,2.8632631025641024,5.8756971,5.579111,3.510798,7.600758,3.510798,7.255762,6.050773,4.239124,5.955774,6.0083457499999895,5.1865764799999985,4.665309940000004,5.116869750000007,4.919896494659325,5.025530743528184,5.097968538461534,5.472999642894314,4.722937434028753,6.0083457499999895,5.1865764799999985,4.665309940000004,5.116869750000007,5.0241159999999985,30221952,24947701.4,49.494154236816456,1.1396355868155832,1.5,2.75,NaN,NaN,0.3253591536585153,1.2114122866646144,279.1864086113421,-0.037548605759799736,0.1096465937306137,0.14719519949041343,96.74535385752029,-5.875827640407297,44.3719563550964,23.413716557893718,32.21432708700988,4572023408
1321540200,4.904118,4.946951,4.597854,4.693287,2.8501435897435896,5.88920325,5.579111,3.510798,7.600758,3.510798,7.255762,6.050773,4.239124,5.955774,5.99851668499999,5.168393329999999,4.6677266000000035,5.114869800000006,4.9110098478099395,4.993888482239785,5.061430461538456,5.490588790237867,4.632272132839045,5.99851668499999,5.168393329999999,4.6677266000000035,5.114869800000006,4.746030666666667,40219456,25717111.2,45.636339755047075,7.716815164384494,1.5,2.75,NaN,NaN,0.3270547141114785,1.5639181122333834,274.4051159520635,-0.06156077259653964,0.07024423374473887,0.1318050063412785,93.81038785359603,-9.26373561150628,15.135597629017417,55.81512492192335,29.049277449059232,4531803952
1321626600,4.738286,4.769953,4.61912,4.672454,2.837024076923077,5.9027094,5.579111,3.510798,7.600758,3.510798,7.255762,6.050773,4.239124,5.955774,5.98832512499999,5.14826021,4.676976520000004,5.0989117000000075,4.901654716523275,4.9632756744074245,5.055533076923071,5.503395543932042,4.6076706099141,5.98832512499999,5.14826021,4.676976520000004,5.0989117000000075,4.687175666666667,28215988,25775814,45.31399441625728,6.1541030157118835,1.5,2.75,NaN,NaN,0.31446744881780153,1.0946691344063857,276.2506551788463,-0.07591517062673456,0.036911043057860304,0.11282621368459486,93.8584172082556,-11.001418658019606,2.804568236829606,82.03561916095761,15.1598126022128,4503587964
1321885800,4.467455,4.490788,4.299958,4.417455,2.823904564102564,5.91621555,5.579111,3.510798,7.600758,3.510798,7.255762,6.050773,4.239124,5.955774,5.97617523999999,5.12369377,4.679526480000003,5.058745450000007,4.882666492345892,4.911292753035289,5.012841153846149,5.575372410040503,4.450309897651795,5.97617523999999,5.12369377,4.679526480000003,5.058745450000007,4.402733666666667,39379928,26490530.4,41.4543113736774,11.146234098476015,1.5,2.75,NaN,NaN,0.3186123453308157,1.486566233494517,269.8175676320601,-0.09823468604240897,-0.00996714386841635,0.08826754217399262,95.74476983648994,-18.9325710317571,2.3029729878945577,83.81995418315586,13.87707282894958,4464208036
1321972200,4.388289,4.462455,4.288291,4.36079,2.810785051282051,5.9297217,5.579111,3.510798,7.600758,3.510798,7.255762,6.050773,4.239124,5.955774,5.9632945349999895,5.095610719999999,4.678443160000004,5.031287400000006,4.862200747548013,4.85886391941288,4.944636692307687,5.5862910204426965,4.302982364172677,5.9632945349999895,5.095610719999999,4.678443160000004,5.031287400000006,4.370512,31197044,26845908.4,40.62620402350903,10.279550438498552,1.5,2.75,NaN,NaN,0.3082946063786146,1.1620781660716686,266.9598295988131,-0.11149544759005797,-0.05110176731357985,0.06039368027647812,89.43545901513798,-9.900139505515767,0,99.99999999999999,0,4433010992
1322058600,4.240791,4.251624,4.065792,4.065792,2.7976655384615383,5.9432278499999995,5.579111,3.510798,7.600758,3.510798,7.255762,6.050773,4.239124,5.955774,5.949140509999991,5.06466936,4.667679920000004,4.981954550000006,4.8309690319578955,4.783333260421178,4.859509230769225,5.636951495576727,4.082066965961723,5.949140509999991,5.06466936,4.667679920000004,4.981954550000006,4.127736,37126364,27452576.8,36.534459729264974,14.544115914918198,1.5,2.75,NaN,NaN,0.3073448487801421,1.3523817552893613,260.2560115470915,-0.13333894127014498,-0.1062799963112031,0.02705894495894188,73.23201349616912,-17.917244397858067,0,99.99999999999999,0,4395884628
1322231400,4.03496,4.183292,4.03496,4.042293,4.03496,5.956734,5.579111,3.510798,7.600758,3.510798,7.255762,6.050773,4.239124,5.955774,5.934808569999991,5.033134669999999,4.6517267400000035,4.905113650000007,4.800040560116409,4.712757997523923,4.766606230769225,5.620103164625609,3.9131092969128414,5.934808569999991,5.033134669999999,4.6517267400000035,4.905113650000007,4.086848333333333,15163996,26429247.8,36.221503424161945,14.045924556710077,1.5,2.75,NaN,NaN,0.2959867881529891,0.5737581377552485,259.15497090170487,-0.14178651481463783,-0.15017419855935543,-0.008387683744717586,69.14347347023785,-22.868499943042846,0,99.99999999999999,0,4380720632
1322490600,4.384123,4.447456,4.306623,4.393289,4.0556354594594595,5.97024015,5.579111,3.510798,7.600758,3.510798,7.255762,6.050773,4.239124,5.955774,5.921579534999991,5.002793299999999,4.641410160000004,4.845947550000007,4.784089518543217,4.682332378712121,4.685389076923072,5.461034910666783,3.9097432431793613,5.921579534999991,5.002793299999999,4.641410160000004,4.845947550000007,4.382456,26756040,26942818.6,43.9452951716483,5.059333351188845,1.5,2.75,NaN,NaN,0.30378508899920414,0.9930675924158877,265.4444615255704,-0.11717239321696274,-0.15485317526592102,-0.03768078204895827,80.75632299451803,-14.010779947059335,3.528587897652511,79.80809965914575,16.663312443201736,4407476672
1322577000,4.436623,4.518288,4.38329,4.425789,4.076310918918919,5.9837463,5.579111,3.510798,7.600758,3.510798,7.255762,6.050773,4.239124,5.955774,5.9082463349999905,4.974351909999999,4.634635400000004,4.808822900000006,4.770038517816032,4.657899675977633,4.6535303846153795,5.435164531619458,3.8718962376113013,5.9082463349999905,4.974351909999999,4.634635400000004,4.808822900000006,4.442455666666667,31990576,27689734.2,44.6141334344943,2.685279806623803,1.5,2.75,NaN,NaN,0.29172886835640394,1.155322610500176,264.88646931114863,-0.09318476561229805,-0.15416173906433084,-0.06097697345203278,81.7823174331084,-14.600416637079618,22.229336607127333,46.01341494162299,31.757248451249673,4439467248
1322663400,4.813284,5.001617,4.786619,4.978284,4.096986378378379,5.9972524499999995,5.579111,3.510798,7.600758,3.510798,7.255762,6.050773,4.239124,5.955774,5.898016434999992,4.955477099999999,4.639568700000004,4.820281100000006,4.778205007313443,4.688412468741668,4.655453461538457,5.440145151719086,3.8707617713578273,5.898016434999992,4.955477099999999,4.639568700000004,4.820281100000006,4.922173333333334,45719712,28276504.2,54.5437470193795,6.052362114933797,1.5,2.75,NaN,NaN,0.31202166347380367,1.6168799253480564,272.0216715585353,-0.03745003035492199,-0.10778951139568527,-0.07033948104076328,111.16968975893307,0.7929959950331192,59.47556680870932,12.958151063341619,27.566282127949084,4485186960
1322749800,4.954951,5.060783,4.915785,4.97745,4.117661837837837,6.0107586,5.579111,3.510798,7.600758,3.510798,7.255762,6.050773,4.239124,5.955774,5.887124874999992,4.9375772699999985,4.653218580000004,4.820531100000006,4.786018536438406,4.715939852671033,4.635197230769227,5.370441357274223,3.89995310426423,5.887124874999992,4.9375772699999985,4.653218580000004,4.820531100000006,4.984672666666667,23138400,28157690.4,54.52785517914703,6.28560899773847,1.5,2.75,NaN,NaN,0.3000914017971034,0.8217435333403623,269.5021823073265,0.00003466210799409064,-0.07029615340577067,-0.07033081551376476,107.57016799309692,6.054669147657077,65.10539930774208,9.805609908379864,25.088990783878057,4462048560
1322836200,5.114116,5.166615,4.956617,4.97495,4.138337297297297,6.02426475,5.579111,3.510798,5.579111,3.510798,7.600758,6.050773,7.255762,5.955774,5.875866654999992,4.918994119999999,4.675135020000004,4.8069062000000065,4.793427613440821,4.740607485749982,4.624876769230766,5.3366126855537335,3.913140852907798,5.875866654999992,4.918994119999999,4.675135020000004,4.8069062000000065,5.032727333333333,26842252,28144923,54.476616492650734,6.384223829043304,1.5,2.75,NaN,NaN,0.2936561588115961,0.953715595526767,272.5572327706304,0.02400917256012712,-0.040319349813605854,-0.06432852237373297,102.46110458550201,6.4740284227517195,54.28051164446869,16.238846415049125,29.48064194048219,4435206308
1323095400,5.198281,5.248281,5.041616,5.125781,4.1590127567567565,6.0377709,5.579111,3.510798,5.579111,3.510798,7.600758,6.050773,7.255762,5.955774,5.865216749999991,4.903352599999999,4.698568100000004,4.804572800000007,4.806461079580397,4.777290677583317,4.620517769230766,5.319113813388411,3.921921725073121,5.865216749999991,4.903352599999999,4.698568100000004,4.804572800000007,5.138559333333333,25607128,28448874.8,57.09607704127595,7.1165238558106605,1.5,2.75,NaN,NaN,0.2922043617536251,0.9001103973363473,276.7684134308718,0.04798948365972507,-0.004341667799076632,-0.052331151458801704,103.09061752464527,16.034707767255117,57.48078400005934,14.075664384086037,28.44355161585462,4460813436
1323181800,5.121616,5.228282,5.069116,5.130783,4.179688216216216,6.0512770499999995,5.579111,3.510798,5.579111,3.510798,7.600758,6.050773,7.255762,5.955774,5.856837674999992,4.886577779999999,4.716717960000004,4.798610350000006,4.819179586263519,4.810956613051573,4.635261307692304,5.367414656028308,3.9031079593563005,5.856837674999992,4.886577779999999,4.716717960000004,4.798610350000006,5.142727000000001,22516700,28833324.4,57.18406444986292,6.602107790820827,1.5,2.75,NaN,NaN,0.28270162162836615,0.7809262535124115,277.2684134308718,0.06130049912194912,0.024294472443634696,-0.03700602667831442,94.72858052081905,17.657190554922398,55.724970740524824,15.185814410774626,29.089214848700546,4483330136
1323268200,5.064949,5.237448,4.96245,5.170782,4.200363675675676,6.0647832,5.579111,3.510798,5.579111,3.510798,7.600758,6.050773,7.255762,5.955774,5.849312749999992,4.872102929999999,4.732651120000004,4.784693850000006,4.832967916213969,4.845225697522852,4.671991692307689,5.458030361101802,3.8859530235135757,5.849312749999992,4.872102929999999,4.732651120000004,4.784693850000006,5.12356,38678976,29617369.6,57.92711094132709,4.9377533087585626,1.5,2.75,NaN,NaN,0.2821513629406257,1.3059558131725513,277.99072854938646,0.06932013189464419,0.049644138189990805,-0.019675993704653377,93.23695640437127,27.1777306856819,53.720223264398435,16.504416566070997,29.775360169530575,4522009112
1323354600,5.072449,5.107448,4.791619,4.834952,4.221039135135135,6.07828935,5.579111,3.510798,5.579111,3.510798,7.600758,6.050773,7.255762,5.955774,5.840187844999992,4.850953149999999,4.747684300000004,4.784443850000007,4.8330457234212645,4.844247250139723,4.684491538461534,5.47531568732499,3.8936673895980785,5.840187844999992,4.850953149999999,4.747684300000004,4.784443850000007,4.911339666666667,38341724,29368809.8,50.070308138819996,0.8839263974250257,1.5,2.75,NaN,NaN,0.28908076558772383,1.3055252923460317,272.46176441092035,0.04946030272936304,0.04214938470705043,-0.007310918022312613,92.26070424622779,19.609142632659246,45.12819792656014,22.797568342972195,32.07423373046767,4483667388
1323441000,4.897451,5.114949,4.881618,5.078283,4.241714594594594,6.0917955,5.579111,3.510798,5.579111,3.510798,7.600758,6.050773,7.255762,5.955774,5.831179604999993,4.832403339999998,4.765717460000004,4.790693800000007,4.842662871522391,4.866536369174035,4.7353244615384575,5.535849403791349,3.9347995192855665,5.831179604999993,4.832403339999998,4.765717460000004,4.790693800000007,5.02495,27216152,29572348.8,54.84885039938769,3.5195111416213556,1.5,2.75,NaN,NaN,0.28843192518860067,0.9203243267575688,277.4558785936947,0.05001522395753769,0.055208111924609504,0.00519288796707181,92.60357024954253,15.591826533606135,70.66687287234785,7.035801890355787,22.29732523729635,4510883540
1323700200,4.941617,4.941617,4.728287,4.851618,4.262390054054054,6.1053016499999995,5.579111,3.510798,5.579111,3.510798,7.600758,6.050773,7.255762,5.955774,5.820375549999992,4.8087952399999985,4.785467260000004,4.771235650000007,4.843014053031316,4.865115572109842,4.773080461538457,5.5451799006382565,4.000981022438658,5.820375549999992,4.8087952399999985,4.785467260000004,4.771235650000007,4.840507333333333,30242412,29929111.8,50.044197871094696,1.8540354871821725,1.5,2.75,NaN,NaN,0.29282935910370067,1.0104680754341664,272.76546283387125,0.03322858380906245,0.04672861772839987,0.013500033919337422,91.35893830984547,9.621538668020555,42.560059424205804,24.9520755772911,32.48786499850309,4480641128
1323786600,4.932451,5.009117,4.630788,4.69912,4.283065513513513,6.1188078,5.579111,3.510798,5.579111,3.510798,7.600758,6.050773,7.255762,5.955774,5.810576689999992,4.783403829999998,4.8092337000000045,4.750735850000007,4.837371148990872,4.849306470004143,4.821797999999996,5.480889686953395,4.162706313046597,5.810576689999992,4.783403829999998,4.8092337000000045,4.750735850000007,4.779675,32145116,30536958.8,47.057523403968155,1.937875464883845,1.5,2.75,NaN,NaN,0.29893647631057924,1.0526626508727517,269.0809896740079,0.01111000237517866,0.02738753688831075,0.01627753451313209,94.4842249950637,-5.607635080682432,21.1716386065643,47.28512628168016,31.543235111755546,4448496012
1323873000,4.632454,4.689953,4.513347,4.538289,4.303740972972973,6.13231395,5.579111,3.510798,5.579111,3.510798,7.600758,6.050773,7.255762,5.955774,5.799801799999992,4.757687419999998,4.824966900000004,4.718527900000007,4.82564243726574,4.819685758575177,4.859951538461535,5.376040774627062,4.3438623022960074,5.799801799999992,4.757687419999998,4.824966900000004,4.718527900000007,4.580529666666667,30391416,31055566.6,44.07028223376546,5.673743936241862,1.5,2.75,NaN,NaN,0.2908533708598235,0.9786141206646025,265.12386653599316,-0.013748158506872,-0.0009076636204579103,0.012840494886414089,64.32312607032374,-8.823011783141977,3.5989307442590737,79.53434238285782,16.86672687288312,4418104596
1323959400,4.693287,4.705786,4.568288,4.598287,4.324416432432432,6.1458201,5.579111,3.510798,5.579111,3.510798,7.600758,6.050773,7.255762,5.955774,5.787597754999992,4.733395989999998,4.837600080000004,4.701486400000007,4.816726537765123,4.798600162520398,4.875720615384611,5.344136308688384,4.407304922080838,5.787597754999992,4.733395989999998,4.837600080000004,4.701486400000007,4.624120333333333,25409160,30814927,45.46119074830209,3.7482051080513017,1.5,2.75,NaN,NaN,0.2820422015126932,0.8245731038077747,267.7617318345506,-0.024896203125564974,-0.01827975902054213,0.0066164441050228446,65.45081271797177,-7.571191670268039,16.735377645264183,53.44844214970214,29.816180205033675,4443513756
1324045800,4.695787,4.775786,4.591421,4.622454,4.345091891891892,6.1593262499999994,5.579111,3.510798,5.579111,3.510798,7.600758,6.050773,7.255762,5.955774,5.776231204999992,4.713796179999999,4.846133320000004,4.6979447500000076,4.809108006872373,4.781824337518455,4.890848692307688,5.310307485490878,4.471389899124498,5.776231204999992,4.713796179999999,4.846133320000004,4.6979447500000076,4.663220333333334,25260480,30066978.2,46.04325686283193,2.7808149795137225,1.5,2.75,NaN,NaN,0.2750652585475008,0.8401402971715994,270.94948413137075,-0.02909652078863633,-0.02975420688077257,-0.000657686092136239,65.77056312382426,-9.819518235367442,14.809891636449466,56.38209735368388,28.80801100986666,4468774236
1324305000,4.66662,4.714953,4.440788,4.470788,4.440788,6.1728324,5.579111,3.510798,5.579111,3.510798,7.600758,6.050773,7.255762,5.955774,5.764989649999993,4.693429709999999,4.853799900000004,4.687861450000008,4.795840555622476,4.752201829183364,4.851810538461534,5.3227564940730465,4.380864582850022,5.764989649999993,4.693429709999999,4.853799900000004,4.687861450000008,4.542176333333334,20038532,29658105.4,42.94558532068897,4.774275432309404,1.5,2.75,NaN,NaN,0.27500095436553645,0.6756511155968851,266.52552339788446,-0.03987688462872194,-0.05050379187803866,-0.010626907249316723,62.619994883765294,-12.863436243551918,18.203297894388747,51.29629061917649,30.50041148643477,4448735704
1324391400,4.687453,4.899117,4.67662,4.871619,4.46615225,6.18633855,5.579111,3.510798,5.579111,3.510798,7.600758,6.050773,7.255762,5.955774,5.754873084999994,4.678221529999999,4.861133180000005,4.710569650000007,4.798812259323555,4.763574893070663,4.843669692307688,5.309275451444938,4.378063933170438,5.754873084999994,4.678221529999999,4.861133180000005,4.710569650000007,4.815785333333333,30638848,29221051.4,52.11473350561821,2.5857210788102654,1.5,2.75,NaN,NaN,0.28595295762514106,1.0485196983706069,272.46460811463396,-0.018866414157076218,-0.034209924945661996,-0.015343510788585778,84.82907440140254,-5.785643254734005,50.1677663046993,19.008941267605508,30.823292427695193,4479374552
1324477800,4.868285,4.929951,4.732452,4.909118,4.4915165,6.1998447,5.579111,3.510798,5.579111,3.510798,7.600758,6.050773,7.255762,5.955774,5.745094019999994,4.66428001,4.868916420000004,4.737986050000008,4.8031379746442004,4.777436141349647,4.838605692307688,5.299801108291568,4.377410276323808,5.745094019999994,4.66428001,4.868916420000004,4.737986050000008,4.857173666666667,24175356,28869967,52.8777066010592,2.133303512351033,1.5,2.75,NaN,NaN,0.2796348177947738,0.837387725451851,274.7636762488384,-0.002175467265977799,-0.018062844871058026,-0.015887377605080227,84.82364990972845,1.5339552491937862,82.03965585034882,2.8087706784383015,15.151573471212865,4503549908
1324564200,4.96495,5.061783,4.934951,5.04995,4.51688075,6.213350849999999,5.579111,3.510798,5.579111,3.510798,7.600758,6.050773,7.255762,5.955774,5.7378982599999935,4.65669676,4.876999680000004,4.787193950000008,4.81281687759933,4.80338984217349,4.832772538461534,5.281028428040151,4.384516648882918,5.7378982599999935,4.65669676,4.876999680000004,4.787193950000008,5.015561333333333,25204140,28273855.8,55.73054909102282,4.647777802617823,1.5,2.75,NaN,NaN,0.2705655450951471,0.8914291767732648,278.574039476213,0.017532547896620385,0.006028307265695254,-0.01150424063092513,76.61868325849261,-0.5579247946599263,82.38764572672717,2.706812071278074,14.905542201994745,4528754048
1324650600,5.104116,5.172449,5.054949,5.165783,4.542245,6.226857,5.579111,3.510798,5.579111,3.510798,7.600758,6.050773,7.255762,5.955774,5.730673339999994,4.64931351,4.8878496000000045,4.843368450000008,4.826658686320925,4.8379034762522055,4.835464846153842,5.291205955118027,4.379723737189657,5.730673339999994,4.64931351,4.8878496000000045,4.843368450000008,5.131060333333334,14339768,28232644.4,57.983673120316475,5.3614440443077696,1.5,2.75,NaN,NaN,0.2599893633026366,0.5079144481414571,281.5373568739954,0.03646313827979081,0.03407468221881338,-0.0023884560609774286,72.36411085025469,6.475468596249747,80.87470682544637,3.1624956201185257,15.962797554435097,4543093816
1324996200,5.132449,5.225782,5.124949,5.175782,4.56760925,6.24036315,5.579111,3.510798,5.579111,3.510798,7.600758,6.050773,7.255762,5.955774,5.724065074999994,4.65073851,4.894149540000004,4.882493100000008,4.840349796661281,4.870082383275805,4.835849461538458,5.292728881167291,4.378970041909625,5.724065074999994,4.65073851,4.894149540000004,4.882493100000008,5.1755043333333335,10494116,27419548.2,58.18153312645617,5.664813108315167,1.5,2.75,NaN,NaN,0.24862105163816256,0.3827238845605779,282.09697036542184,0.04707689554288037,0.056457663367623034,0.009380767824742665,65.83992478722978,10.143643916307738,100.00000000000001,0,0,4553587932
1325082600,5.183282,5.187448,4.96245,4.987451,4.5929735,6.2538693,5.579111,3.510798,5.579111,3.510798,7.600758,6.050773,7.255762,5.955774,5.717531809999993,4.65098018,4.902566140000004,4.9105762000000075,4.846118471302015,4.881260346773347,4.847580153846151,5.311541165285588,4.3836191424067135,5.717531809999993,4.65098018,4.902566140000004,4.9105762000000075,5.045783,16626164,26651327.6,53.10864714595488,2.610595778121266,1.5,2.75,NaN,NaN,0.24693369080686525,0.6238399921210679,277.0472178962408,0.0391571772034261,0.05832723932902528,0.01917006212559919,66.98742637355518,9.8971660905685,79.43565667001012,3.6260285924663958,16.9383147375235,4536961768
1325169000,5.02495,5.142457,5.00495,5.125781,4.61833775,6.267375449999999,5.579111,3.510798,5.579111,3.510798,7.600758,6.050773,7.255762,5.955774,5.713381844999994,4.66238838,4.908066040000004,4.917951050000008,4.857085629290171,4.9045480280330285,4.851233846153843,5.323085446013112,4.379382246294574,5.713381844999994,4.66238838,4.908066040000004,4.917951050000008,5.091062666666667,19461096,25338396.8,56.13400773862616,3.2375284331106298,1.5,2.75,NaN,NaN,0.2403674271778035,0.768047645382205,281.3630461627933,0.04079369488426647,0.07016218073093228,0.029368485846665807,62.5010265036962,11.47153276861579,78.41746857053076,3.9709234737610513,17.611607955708195,4556422864
1325255400,5.105782,5.155782,5.064949,5.069949,4.643702000000001,6.2808816,5.579111,3.510798,5.579111,3.510798,7.600758,6.050773,7.255762,5.955774,5.7079693999999925,4.66752999,4.916315960000004,4.922576000000007,4.865433212455262,4.920300501553692,4.868028538461535,5.3540681534735155,4.381988923449554,5.7079693999999925,4.66752999,4.916315960000004,4.922576000000007,5.096893333333334,11572564,24760105,54.60274281782809,2.7112668286705706,1.5,2.75,NaN,NaN,0.22968639666510324,0.46738751713694265,280.62968736517075,0.03585014488200219,0.07418116694916854,0.038331022067166355,63.87537457655816,9.680896770416751,51.13016117526147,18.322331014059692,30.547507810678837,4544850300
1325601000,5.33328,5.400779,5.277447,5.294946,4.669066250000001,6.29438775,5.579111,3.510798,5.579111,3.510798,7.600758,6.050773,7.255762,5.955774,5.703262189999992,4.681038180000001,4.927549160000004,4.938575800000007,4.882276851182507,4.955981025215245,4.9138613076923034,5.438392517576907,4.3893300978077,5.703262189999992,4.681038180000001,4.927549160000004,4.938575800000007,5.324390666666667,23286748,24582329.8,59.408260421525696,5.923587731747017,1.5,2.75,NaN,NaN,0.236910939760453,0.9472962159998357,285.694419850852,0.04488162597333544,0.09443305453383566,0.04955142856050022,66.5797872642537,18.43428943622468,57.635920401155005,14.005126056003267,28.358953542841718,4568137048
1325687400,5.260781,5.324946,5.187448,5.304947,4.694430500000001,6.3078939,5.579111,3.510798,5.579111,3.510798,7.600758,6.050773,7.255762,5.955774,5.697170584999993,4.689104770000001,4.933815780000004,4.947534100000007,4.898852151136134,4.98921587995665,4.9728349999999955,5.4875008439115875,4.458169156088403,5.697170584999993,4.689104770000001,4.933815780000004,4.947534100000007,5.2724470000000005,19714396,24287693.2,59.6129070223913,4.6744225542431,1.5,2.75,NaN,NaN,0.2298100154918492,0.8117031056699943,284.7739730994197,0.0483761038958149,0.11002155843026884,0.06164545453445394,60.27512930640186,8.894948476061046,62.865622621217874,10.948036896088086,26.186340482694046,4587851444
1325773800,5.228282,5.38347,5.147449,5.366612,4.719794750000001,6.321400049999999,5.579111,3.510798,5.579111,3.510798,7.600758,6.050773,7.255762,5.955774,5.691737299999993,4.69683802,4.936732420000005,4.959325550000007,4.9171956746209915,5.025158367579826,5.031936923076919,5.537362155093538,4.5265116910603,5.691737299999993,4.69683802,4.936732420000005,4.959325550000007,5.299177,24559408,24389828.6,60.92115066038887,4.6527432565681694,1.5,2.75,NaN,NaN,0.2302536572424314,1.0069528737893632,287.3340617803162,0.05140372605180381,0.1259001120992087,0.0744963860474049,41.44164871126062,9.31927079365376,87.8507287523381,1.3359068115126953,10.813364436149214,4612410852
1325860200,5.379946,5.392447,5.270781,5.329948,4.745159000000001,6.3349062,5.579111,3.510798,5.579111,3.510798,7.600758,6.050773,7.255762,5.955774,5.685845694999994,4.701229660000001,4.945132360000005,4.9672838500000065,4.933382040322129,5.054185951619843,5.086359538461535,5.554698116052652,4.6180209608704175,5.685845694999994,4.701229660000001,4.945132360000005,4.9672838500000065,5.331058666666666,20627088,23487234.2,59.683254192542755,3.9975028624631634,1.5,2.75,NaN,NaN,0.22249739601082913,0.8782255000463188,286.0172964376139,0.047587732546427244,0.13398105173043895,0.0863933191840117,42.52057860986165,5.544569748215328,60.35941657339085,12.368117986773624,27.27246543983553,4591783764
1326119400,5.362447,5.389113,5.287447,5.359113,4.770523250000001,6.34841235,5.579111,3.510798,5.579111,3.510798,7.600758,6.050773,7.255762,5.955774,5.679137429999994,4.7072962700000005,4.951265640000005,4.993491900000007,4.950077372074202,5.083226622894143,5.154692230769227,5.481740953800524,4.827643507737929,5.679137429999994,4.7072962700000005,4.951265640000005,4.993491900000007,5.345224333333333,10764404,22108368.2,60.37303929469995,3.7642159783572002,1.5,2.75,NaN,NaN,0.2138665820100556,0.48689274136478333,287.9661498329852,0.043774924935527176,0.14111197535342068,0.0973370504178935,40.55747624164742,3.7425110578589837,75.24472247525009,5.1234393893093015,19.631838135440617,4602548168
1326205800,5.539945,5.572945,5.489112,5.514944,4.795887500000001,6.3619185,5.579111,3.510798,5.579111,3.510798,7.600758,6.050773,7.255762,5.955774,5.672881234999994,4.714937860000001,4.949982300000005,5.015324950000006,4.97222900454188,5.124342563570892,5.204178769230765,5.53950307811503,4.8688544603465,5.672881234999994,4.714937860000001,4.949982300000005,5.015324950000006,5.525666999999999,11764844,21335802.8,63.92457627335686,5.657998533990641,1.5,2.75,NaN,NaN,0.2138641118664802,0.5514132329719508,292.264045842937,0.04814774415333638,0.15752173060956398,0.1093739864562276,41.59077381442534,6.552864861773544,71.66270175250051,6.597066665509555,21.740231581989935,4614313012
1326292200,5.458279,5.550778,5.438362,5.538279,4.821251750000001,6.375424649999999,5.579111,3.510798,5.579111,3.510798,7.600758,6.050773,7.255762,5.955774,5.6669854649999944,4.729079390000001,4.949215660000005,5.049658000000006,4.994427043579454,5.163765081326045,5.252575769230765,5.5851879833375495,4.91996355512398,5.6669854649999944,4.729079390000001,4.949215660000005,5.049658000000006,5.509139666666666,10385008,20342932.6,64.43855320720222,4.759851305709314,1.5,2.75,NaN,NaN,0.20661781816173166,0.5104970951926567,294.17498419706,0.04885660164289968,0.1704447385098522,0.12158813686695252,41.51887246063835,11.044278931261681,67.9767142006436,8.289064566449094,23.734221232907316,4624698020
1326378600,5.578278,5.594944,5.441612,5.569944,4.846616000000001,6.3889308,5.579111,3.510798,5.579111,3.510798,7.600758,6.050773,7.255762,5.955774,5.660564694999994,4.7456375500000005,4.957248900000004,5.093199200000006,5.016996335988103,5.202448787866421,5.292575307692304,5.642703305256609,4.942447310127998,5.660564694999994,4.7456375500000005,4.957248900000004,5.093199200000006,5.5355,20406492,19756001.4,65.16385483238433,4.618683693487063,1.5,2.75,NaN,NaN,0.20281168829303656,1.032926227672772,296.4823797145372,0.04765204648478086,0.1811531949729286,0.13350114848814773,30.921365013308638,8.665274618638596,66.30533457686495,9.114548211226419,24.580117211908643,4645104512
1326465000,5.453279,5.499113,5.34078,5.499113,4.871980250000001,6.40243695,5.579111,3.510798,5.579111,3.510798,7.600758,6.050773,7.255762,5.955774,5.653025189999995,4.761495730000001,4.972248760000004,5.141240400000006,5.0359028718317065,5.230702522355334,5.318216076923073,5.6761808105323714,4.960251343313774,5.653025189999995,4.761495730000001,4.972248760000004,5.141240400000006,5.446335333333334,27255368,19599199,62.11213774073458,2.417363307784037,1.5,2.75,NaN,NaN,0.20469399627210536,1.3906368316378643,294.04055662512224,0.03866168219626698,0.18182825123348145,0.14316656903721448,31.743884516781588,8.46485832500485,56.790435745991125,14.508732655231485,28.70083159877741,4617849144
1326810600,5.64161,5.66661,5.508279,5.539111,4.897344500000001,6.4159431,5.579111,3.510798,5.579111,3.510798,7.600758,6.050773,7.255762,5.955774,5.645783589999995,4.77384561,4.983581980000004,5.188281600000006,5.055636523916737,5.260074758321493,5.346164461538458,5.711931760951299,4.980397162125617,5.645783589999995,4.77384561,4.983581980000004,5.188281600000006,5.571333333333333,13577376,19007609.8,63.16129700524095,3.7848037492040265,1.5,2.75,NaN,NaN,0.20203706796695498,0.7143126433498229,296.73092746166043,0.03224734340195576,0.18347574828965918,0.15122840488770342,29.623830418936183,4.61128404331224,60.90626483831629,12.139239748993154,26.95449541269056,4631426520
1326897000,5.538279,5.745776,5.509112,5.732442,4.922708750000001,6.429449249999999,5.579111,3.510798,5.579111,3.510798,7.600758,6.050773,7.255762,5.955774,5.639071159999995,4.7863371400000005,4.993281860000003,5.2437810000000065,5.082177915135689,5.305062114671827,5.403471461538459,5.759796883798345,5.047146039278572,5.639071159999995,4.7863371400000005,4.993281860000003,5.2437810000000065,5.662443333333333,13240236,18406597.6,67.80232076919037,5.169175848239381,1.5,2.75,NaN,NaN,0.20451042025502963,0.7193201203029504,299.41862988050025,0.03749571334786744,0.1980980465725377,0.16060233322467027,25.977623781179567,8.058421695824661,61.98296006993172,11.523702984072465,26.4933369459958,4644666756
1326983400,5.794109,5.851608,5.747443,5.828275,4.948073000000001,6.4429554,5.579111,3.510798,5.579111,3.510798,7.600758,6.050773,7.255762,5.955774,5.632733724999996,4.801928650000001,5.006398380000004,5.311655350000007,5.111436624346054,5.3548919132745105,5.457509461538459,5.841027610490713,5.073991312586205,5.632733724999996,4.801928650000001,5.006398380000004,5.311655350000007,5.809108666666666,12277524,18018547.2,69.83124189196246,6.0107552276070075,1.5,2.75,NaN,NaN,0.19841439023681323,0.6813825700664702,302.50501501458126,0.04347136006063343,0.21494153330046206,0.17147017323982863,26.092915250146937,8.602503777057102,63.27907940253584,10.80282126309804,25.91809933436613,4656944280
1327069800,5.797443,5.835775,5.760776,5.833275,4.973437250000001,6.45646155,5.579111,3.510798,5.579111,3.510798,7.600758,6.050773,7.255762,5.955774,5.626421289999996,4.815470180000001,5.018063240000003,5.359738150000007,5.139744011626601,5.4004522072483665,5.5162268461538435,5.877509252883279,5.154944439424408,5.626421289999996,4.815470180000001,5.018063240000003,5.359738150000007,5.8099419999999995,9381536,16955681.6,69.93768135425205,4.882983116524555,1.5,2.75,NaN,NaN,0.189599005219898,0.5532974858409702,303.9906463927219,0.04369376660571997,0.2260873814969786,0.18239361489125863,26.488912597597327,9.443375432555825,57.22195316823802,14.361025804413922,28.417021027348046,4666325816
1327329000,5.831608,5.935774,5.760026,5.844108,4.998801500000001,6.4699677,5.579111,3.510798,5.579111,3.510798,7.600758,6.050773,7.255762,5.955774,5.619883849999996,4.825211750000001,5.0259631600000025,5.406487650000007,5.167366128817715,5.4427051398913795,5.558470076923076,5.934501433089808,5.182438720756344,5.619883849999996,4.825211750000001,5.0259631600000025,5.406487650000007,5.846636,19123508,16703089.2,70.1831356463925,4.722018436206397,1.5,2.75,NaN,NaN,0.18860964770419103,1.1449084520245514,306.5177719607069,0.040571156254499724,0.23310756020938328,0.19253640395488356,25.09930896391823,9.049911804434812,100,0,0,4685449324
1327415400,5.733276,5.839942,5.708276,5.839109,5.024165750000002,6.483473849999999,5.579111,3.510798,5.579111,3.510798,7.600758,6.050773,7.255762,5.955774,5.613604749999996,4.834545000000001,5.045946300000002,5.445945600000007,5.193708986511138,5.480457888473153,5.59955946153846,5.972524506060672,5.226594417016248,5.613604749999996,4.834545000000001,5.045946300000002,5.445945600000007,5.795775666666667,7823188,15834041.6,69.89951268846139,3.6858691357115023,1.5,2.75,NaN,NaN,0.1848398157253203,0.4940739829810729,307.97550993441826,0.03441281538553426,0.23555242318680136,0.2011396078012671,25.697429039662428,5.877938198465839,86.52300202059699,1.6361823864179634,11.840815592985052,4677626136
1327501800,5.808275,6.033272,5.752109,5.996608,5.049530000000001,6.49698,5.579111,3.510798,5.579111,3.510798,7.600758,6.050773,7.255762,5.955774,5.608533554999996,4.8445699200000005,5.066812780000003,5.487486850000006,5.22519522233423,5.5296150419519,5.64802069230769,6.049915108190488,5.246126276424892,5.608533554999996,4.8445699200000005,5.066812780000003,5.487486850000006,5.927329666666668,17993348,16016720.6,73.52909574399831,5.003396929450629,1.5,2.75,NaN,NaN,0.19172004317351174,1.1234102441669613,312.2630169081015,0.036966376812228974,0.24734757881655334,0.21038120200432436,25.133991995855705,8.275657474099805,87.73728372214248,1.3663935117076842,10.896322766149831,4695619484
1327588200,6.076606,6.114106,5.829943,5.894942,5.074894250000002,6.51048615,5.579111,3.510798,5.579111,3.510798,7.600758,6.050773,7.255762,5.955774,5.603271109999995,4.855286490000001,5.079896000000002,5.523444850000006,5.251459801850535,5.564408085575529,5.691481769230767,6.06777207934878,5.315191459112754,5.603271109999995,4.855286490000001,5.079896000000002,5.523444850000006,5.946330333333333,19421268,16463078.2,67.84231492207721,4.223991760952019,1.5,2.75,NaN,NaN,0.19832311151826088,1.1796863116400675,311.481280948131,0.02822296921711137,0.2456599135257136,0.21743694430860222,29.080326073405526,5.834852199591249,53.95607830209424,16.421284411817936,29.62263728608783,4676198216
1327674600,5.802442,5.935232,5.798275,5.898274,5.100258500000002,6.5239923,5.579111,3.510798,5.579111,3.510798,7.600758,6.050773,7.255762,5.955774,5.598841984999995,4.869836330000001,5.095679160000002,5.568986000000007,5.276825064523063,5.596204839330241,5.73295569230769,6.070418942931321,5.395492441684059,5.598841984999995,4.869836330000001,5.095679160000002,5.568986000000007,5.877260333333333,8564940,16060017,67.9298580553614,2.9169119920583872,1.5,2.75,NaN,NaN,0.19393981783838507,0.5333082773200053,314.52731944353184,0.019493585381475442,0.24180392603544654,0.2223103406539711,29.26355043105614,7.258643348481826,53.43425150059594,16.772831437958313,29.792917061445745,4684763156
1327933800,5.739109,5.855775,5.667442,5.840775,5.125622750000002,6.537498449999999,5.579111,3.510798,5.579111,3.510798,7.600758,6.050773,7.255762,5.955774,5.594087864999994,4.884769510000001,5.1088457000000025,5.604735700000006,5.298940748267257,5.619497235584504,5.758019615384613,6.074754884583975,5.44128434618525,5.594087864999994,4.884769510000001,5.1088457000000025,5.604735700000006,5.787997333333333,10177000,15595812.2,64.65868042149783,1.3541284820701205,1.5,2.75,NaN,NaN,0.19657497370707183,0.652546970269365,312.0748297121868,0.007304077959960825,0.23144043810392212,0.2241363601439613,28.613256914877248,5.446072483472523,24.157130430975442,43.484279893407546,32.358589675617004,4674586156
1328020200,5.921607,5.953157,5.750027,5.823275,5.1509870000000015,6.5510046,5.579111,3.510798,5.579111,3.510798,7.600758,6.050773,7.255762,5.955774,5.589158744999994,4.895919400000001,5.126528860000002,5.642402000000006,5.319502875786188,5.638904641719313,5.7799423846153815,6.071235747493677,5.488649021737086,5.589158744999994,4.895919400000001,5.126528860000002,5.642402000000006,5.842153,15534884,15793928.2,63.65399175094306,1.5142131372738115,1.5,2.75,NaN,NaN,0.1970431898708524,0.9835984945151265,314.25648398924704,-0.0038791785062989304,0.21928738701108763,0.22316656551738656,29.053294552162686,1.5845428527667607,19.150762483260227,49.96555037014488,30.88368714659488,4659051272
1328106600,5.954107,6.083273,5.941607,5.996608,5.1763512500000015,6.56451075,5.579111,3.510798,5.579111,3.510798,7.600758,6.050773,7.255762,5.955774,5.584712964999993,4.910160940000001,5.152595280000002,5.677485100000006,5.34605601791222,5.6729716282222356,5.81276269230769,6.098101815335155,5.5274235692802245,5.584712964999993,4.910160940000001,5.152595280000002,5.677485100000006,6.007162666666666,16503140,15454747.8,68.82156731578308,4.053674645706607,1.5,2.75,NaN,NaN,0.2015399620229344,1.0678362541768556,319.3371663581157,-0.0016581339128996508,0.221093898126262,0.22275203203916166,27.308807428966098,2.8882130647575917,17.732375398894344,51.96178821283629,30.305836388269384,4675554412
1328193000,6.03994,6.08244,5.969107,6.034106,5.2017155000000015,6.5780169,5.579111,3.510798,5.579111,3.510798,7.600758,6.050773,7.255762,5.955774,5.581646324999993,4.928402420000001,5.179828320000001,5.713943050000006,5.373038370150956,5.707365377915356,5.853915999999997,6.0977380334626154,5.610093966537379,5.581646324999993,4.928402420000001,5.179828320000001,5.713943050000006,6.028551,11769884,15057522.2,69.8212070603468,3.3948067401198947,1.5,2.75,NaN,NaN,0.19523946473558193,0.7816614077447617,320.2691444491767,0.00018314293046137187,0.22298096070223838,0.222797817771777,26.262950309631112,3.442851571372856,47.85107059839386,20.715395228158727,31.43353417344741,4687324296
1328279400,6.22327,6.302437,6.186606,6.291604,5.2270797500000015,6.591523049999999,5.579111,3.510798,5.579111,3.510798,7.600758,6.050773,7.255762,5.955774,5.579346349999994,4.948418890000001,5.217311300000001,5.760192650000006,5.409060551713664,5.763007151447227,5.911800076923074,6.1847447501721655,5.638855403673982,5.579346349999994,4.948418890000001,5.217311300000001,5.760192650000006,6.260215666666667,17924996,14725801.6,75.60529884733174,6.160645043561417,1.5,2.75,NaN,NaN,0.20046028868304036,1.2172509508752312,324.2785673126463,0.01572933455082956,0.24245948596031397,0.2267301514094844,34.08826293328625,7.657216464856572,56.3212776553111,14.82727205750462,28.851450287184267,4705249292
1328538600,6.205771,6.289104,6.191605,6.281604,5.2524440000000014,6.6050292,5.579111,3.510798,5.579111,3.510798,7.600758,6.050773,7.255762,5.955774,5.5754755549999935,4.967085370000001,5.255727580000001,5.8077754500000065,5.44327794184254,5.812397327499872,5.954043307692304,6.269544533972388,5.63854208141222,5.5754755549999935,4.967085370000001,5.255727580000001,5.8077754500000065,6.254104333333333,9988836,14193889,75.00408489501905,5.103696466972681,1.5,2.75,NaN,NaN,0.1932844823485375,0.7037420117911307,321.5172270583495,0.021943596420446077,0.254159646935042,0.23221605051459593,34.355070232864996,7.578125361249467,56.69341261549913,14.656909332983814,28.64967805151704,4695260456
1328625000,6.247438,6.356537,6.168338,6.329938,5.277808250000001,6.61853535,5.579111,3.510798,5.579111,3.510798,7.600758,6.050773,7.255762,5.955774,5.571336019999994,4.984345210000002,5.301010500000002,5.856316700000006,5.478048924515382,5.861686915357027,5.992632769230766,6.3562168827621495,5.629048655699382,5.571336019999994,4.984345210000002,5.301010500000002,5.856316700000006,6.284937666666667,12403888,14275863.2,75.99758776882595,5.164311127929864,1.5,2.75,NaN,NaN,0.19292123360935626,0.8688713128043984,323.34817789121774,0.025655749342191836,0.2642857371923357,0.2386299878501439,33.96901417240029,5.558642485885356,84.13657451167865,2.234862522831039,13.62856296549031,4707664344
1328711400,6.339937,6.392437,6.254154,6.37327,5.303172500000001,6.6320415,5.579111,3.510798,5.579111,3.510798,7.600758,6.050773,7.255762,5.955774,5.567490224999995,4.9996783900000015,5.347630040000002,5.899233000000007,5.513155633357916,5.9104091138944534,6.034170846153843,6.436734944719598,5.631606747588087,5.567490224999995,4.9996783900000015,5.347630040000002,5.899233000000007,6.339953666666666,12631732,14319207.6,76.88462472766449,4.7246017357096965,1.5,2.75,NaN,NaN,0.18901850263725942,0.8821530040531014,325.61141058412016,0.027227341062326715,0.2726641641780523,0.24543682311572557,31.853410646736194,8.114210453639737,83.319301544751,2.457882296395874,14.222816158853137,4720296076
1328797800,6.41327,6.434936,6.288271,6.404103,5.328536750000001,6.645547649999999,5.579111,3.510798,5.579111,3.510798,7.600758,6.050773,7.255762,5.955774,5.5628944399999956,5.014628240000002,5.387846320000003,5.9425242000000065,5.548094745775252,5.957427579237839,6.077247384615381,6.508093168387461,5.646401600843301,5.5628944399999956,5.014628240000002,5.387846320000003,5.9425242000000065,6.37577,16431308,14621522.6,77.5212027305216,4.768504420780417,1.5,2.75,NaN,NaN,0.1859932524488838,1.1237754404592584,325.9447439174535,0.026515171458088793,0.2785807874383366,0.2520656159802478,28.308482533225245,8.57588169013512,84.77418330053601,2.0675979712080292,13.158218728255957,4736727384
1328884200,6.230771,6.278271,6.184106,6.263271,5.353901000000001,6.6590538,5.579111,3.510798,5.579111,3.510798,7.600758,6.050773,7.255762,5.955774,5.556894499999995,5.029615680000002,5.424595960000002,5.9771905500000075,5.576140873391909,5.9865555240723305,6.109875230769228,6.52768884151498,5.692061620023477,5.556894499999995,5.029615680000002,5.424595960000002,5.9771905500000075,6.241882666666666,15049084,14353652.2,68.27276422667661,1.83381051501667,1.5,2.75,NaN,NaN,0.18842209155967785,1.0484498154413968,321.3723630642582,0.013393224908521517,0.2688071471158997,0.2554139222073782,33.175997777040884,7.233560614815667,53.61966936087915,16.668023951645395,29.71230668747545,4721678300
1329143400,6.394937,6.418269,6.311604,6.392437,5.379265250000001,6.67255995,5.579111,3.510798,5.579111,3.510798,7.600758,6.050773,7.255762,5.955774,5.551177899999995,5.046223860000001,5.452879020000003,6.0218567500000075,5.608152486200069,6.025210902732108,6.140323615384613,6.577906496337582,5.702740734431644,5.551177899999995,5.046223860000001,5.452879020000003,6.0218567500000075,6.374103333333333,11523496,13567058.6,71.61728153242802,3.6098369477447227,1.5,2.75,NaN,NaN,0.18603465644827227,0.8493732016459338,326.6207394365713,0.010381060434775491,0.2683902477508475,0.25800918731607203,32.43439584003401,9.77391588066853,73.1370080236273,5.975871217590449,20.887120758782235,4733201796
1329229800,6.344103,6.387435,6.248271,6.378269,5.404629500000001,6.6860661,5.579111,3.510798,5.579111,3.510798,7.600758,6.050773,7.255762,5.955774,5.545065454999994,5.067056990000001,5.480895400000003,6.063814650000007,5.6383531338000665,6.058835483424288,6.177502615384613,6.607437237209867,5.747567993559359,5.545065454999994,5.067056990000001,5.480895400000003,6.063814650000007,6.3379916666666665,15762660,13676322.8,70.73645673175622,2.2353148989067906,1.5,2.75,NaN,NaN,0.18304403813053854,1.152551035136433,323.54126771768574,0.004692512583961694,0.26387482804602413,0.25918231546206244,32.33151857520131,6.364614795564431,42.35363135552254,25.082313119579393,32.564055524898066,4717439136
1329316200,6.44577,6.470768,6.255772,6.287437,5.429993750000001,6.699572249999999,5.579111,3.510798,5.579111,3.510798,7.600758,6.050773,7.255762,5.955774,5.538732189999994,5.091140080000001,5.507145140000003,6.091564400000007,5.663807403062809,6.080607056431499,6.207438230769228,6.608670715562812,5.806205745975645,5.538732189999994,5.091140080000001,5.507145140000003,6.091564400000007,6.337992333333333,19049084,13966765.2,65.19997180014519,2.0585397216464028,1.5,2.75,NaN,NaN,0.18532632112121433,1.363886607043412,321.5465939588331,-0.007278550003509354,0.25008412795767576,0.2573626779611851,32.04711158718248,4.198318690457199,16.535963374731708,53.69359054900338,29.770446076264907,4698390052
1329402600,6.292436,6.525768,6.274937,6.504102,5.455358000000002,6.7130784,5.579111,3.510798,5.579111,3.510798,7.600758,6.050773,7.255762,5.955774,5.534017649999994,5.11663983,5.5347115600000025,6.125355750000006,5.696760132354464,6.120939908199928,6.258463384615383,6.62763314011676,5.889293629114006,5.534017649999994,5.11663983,5.5347115600000025,6.125355750000006,6.434935666666667,11225932,13914185.6,71.02556734039902,3.8418155525299347,1.5,2.75,NaN,NaN,0.1900052267554133,0.8067976324823496,326.30913720607174,-0.002919498774606344,0.25371330449292717,0.2566328032675335,36.17062564601357,3.377485296277375,12.460023541336241,60.18106911038854,27.358907348275217,4709615984
1329489000,6.579101,6.583268,6.491601,6.539935,5.480722250000001,6.72658455,5.579111,3.510798,5.579111,3.510798,7.600758,6.050773,7.255762,5.955774,5.530251024999995,5.13980628,5.5628946000000035,6.1606887500000065,5.729825813438603,6.160844202657078,6.313591076923076,6.613980583253631,6.01320157059252,5.530251024999995,5.13980628,5.5628946000000035,6.1606887500000065,6.5382679999999995,8207432,13855480.4,71.86443877790279,3.91865202334635,1.5,2.75,NaN,NaN,0.1829810677014552,0.5923599733142417,328.55844953222703,-0.00008717889610099228,0.2565238296474073,0.25661100854350827,28.85463071326097,4.11250056514228,29.45022887112115,37.39423623648403,33.15553489239481,4717823416
1329834600,6.588267,6.6366,6.489935,6.545768,5.506086500000002,6.7400907,5.579111,3.510798,5.579111,3.510798,7.600758,6.050773,7.255762,5.955774,5.527388554999995,5.161522719999999,5.590394320000004,6.195771750000006,5.761823546244932,6.197503611927832,6.3558341538461525,6.6180669774970164,6.0936013301952885,5.527388554999995,5.161522719999999,5.590394320000004,6.195771750000006,6.557434333333333,9343052,13366457.6,72.00651810031798,3.5000383630648604,1.5,2.75,NaN,NaN,0.18038706286563694,0.6989923792523758,328.6998708884643,-0.00027459075473268424,0.2562677701000924,0.25654236085482507,28.71788479831058,3.4096700473211508,30.483678585203492,36.43763107954358,33.07869033525293,4727166468
1329921000,6.512434,6.560768,6.449935,6.477435,5.531450750000002,6.753596849999999,5.579111,3.510798,5.579111,3.510798,7.600758,6.050773,7.255762,5.955774,5.523760254999994,5.185464139999999,5.623243980000004,6.2276880500000065,5.789886740509837,6.224163744125182,6.389936384615384,6.58180888057445,6.198063888656317,5.523760254999994,5.185464139999999,5.623243980000004,6.2276880500000065,6.496046,8634924,13407044.4,67.69383442994157,2.2832372196833903,1.5,2.75,NaN,NaN,0.17541891551809147,0.6440587307967742,325.92416459014214,-0.007077362531791476,0.24769565769008572,0.2547730202218772,29.766406304754003,1.6344043167792996,38.085065108701805,28.955370332749933,32.959564558548266,4718531544
1330007400,6.479934,6.588267,6.407436,6.578268,5.556815000000002,6.767103,5.579111,3.510798,5.579111,3.510798,7.600758,6.050773,7.255762,5.955774,5.520114459999994,5.209480569999999,5.653243680000004,6.256771050000006,5.820803652646706,6.257887958970403,6.41198746153846,6.618889309221202,6.205085613855718,5.520114459999994,5.209480569999999,5.653243680000004,6.256771050000006,6.524657,12120612,13113407.6,70.50142464185298,2.7421548574772583,1.5,2.75,NaN,NaN,0.17580549298108497,0.9242915624768653,329.8124865442822,-0.006857991549107489,0.24620053078549287,0.25305852233460036,30.64187942780753,2.7195846162998856,81.21011296336546,3.08359899988292,15.706288036751623,4730652156
1330093800,6.622434,6.660766,6.579935,6.614934,5.582179250000002,6.78060915,5.579111,3.510798,5.579111,3.510798,7.600758,6.050773,7.255762,5.955774,5.515683254999994,5.236988629999998,5.688510000000004,6.292770650000007,5.8519460192095805,6.291892343830365,6.43762823076923,6.655850298461265,6.219406163077195,5.515683254999994,5.236988629999998,5.688510000000004,6.292770650000007,6.618544999999999,7984312,12541559.8,71.47229376160598,3.069077490539541,1.5,2.75,NaN,NaN,0.16914067205386463,0.63662830838633,331.7151828323316,-0.006328134599753565,0.24514835408490843,0.251476488684662,30.65922743877506,5.614686000334335,79.76904993595481,3.5436947040556444,16.687255359989546,4738636468
1330353000,6.499935,6.699932,6.444936,6.6441,5.607543500000002,6.7941153,5.579111,3.510798,5.579111,3.510798,7.600758,6.050773,7.255762,5.955774,5.512591619999994,5.268321649999998,5.727409600000004,6.330061950000006,5.883010881201361,6.325435930132235,6.461794538461537,6.695960226231957,6.227628850691117,5.512591619999994,5.268321649999998,5.727409600000004,6.330061950000006,6.5963226666666674,10951764,12660901,72.25455070791111,3.1140534146076306,1.5,2.75,NaN,NaN,0.1752731954785886,0.8650066847533204,331.2031907207419,-0.006095656418264733,0.24385691816183108,0.24995257458009582,26.032685959237657,3.936886667791951,79.34970103593726,3.6480373054527973,17.00226165860994,4749588232
1330439400,6.654933,6.7166,6.610101,6.697433,5.632907750000002,6.807621449999999,5.579111,3.510798,5.579111,3.510798,7.600758,6.050773,7.255762,5.955774,5.5092583199999945,5.297779689999999,5.770592480000004,6.372894850000007,5.91494900350719,6.360864222500593,6.486730153846152,6.745612239910114,6.22784806778219,5.5092583199999945,5.297779689999999,5.770592480000004,6.372894850000007,6.674711333333334,9793068,12641704.4,73.67602145991528,2.850690902394405,1.5,2.75,NaN,NaN,0.17036075294440364,0.7746635809646047,331.870106097235,-0.00450558166223225,0.2443205975023055,0.24882617916453775,24.42989212283116,5.003928181768435,79.66554055999255,3.54372523370189,16.790734206305565,4759381300
1330525800,6.724099,6.786599,6.571601,6.580768,5.658272000000002,6.8211276,5.579111,3.510798,5.579111,3.510798,7.600758,6.050773,7.255762,5.955774,5.5062708499999955,5.323921089999999,5.810242100000003,6.410769500000006,5.941059552389261,6.381807439405299,6.500319769230767,6.758972995730179,6.241666542731355,5.5062708499999955,5.323921089999999,5.810242100000003,6.410769500000006,6.646322666666667,10345996,12382260,65.74159306439667,2.2593136893454018,1.5,2.75,NaN,NaN,0.17354912773408906,0.8355498915383783,328.46732086034143,-0.012986552102159349,0.23259298903683856,0.2455795411389979,27.411185376986303,4.665350921210029,75.61605393034493,4.984001338132965,19.3999447315221,4749035304
1330612200,6.6591,6.759932,6.630768,6.7166,5.683636250000002,6.83463375,5.579111,3.510798,5.579111,3.510798,7.600758,6.050773,7.255762,5.955774,5.504633369999994,5.3491291699999985,5.852125020000002,6.446769100000006,5.971472903275957,6.413692445176223,6.535191230769229,6.778379427642671,6.292003033895787,5.504633369999994,5.3491291699999985,5.852125020000002,6.446769100000006,6.702433333333332,11618564,12138031.2,69.81722402798385,2.76987535602235,1.5,2.75,NaN,NaN,0.173950190038797,0.9572033395333505,332.2106910681649,-0.011191904437626549,0.23158966059196473,0.24278156502959128,26.554861238254343,3.2671381844872682,75.47631019433113,5.037647659400978,19.486042146267888,4760653868
1330698600,6.710766,6.737433,6.604617,6.654101,5.709000500000002,6.8481399,5.579111,3.510798,5.579111,3.510798,7.600758,6.050773,7.255762,5.955774,5.5027833949999945,5.374795589999999,5.895791280000002,6.477768850000006,5.998242632559252,6.436588498016583,6.5553192307692285,6.791116152452213,6.319522309086244,5.5027833949999945,5.374795589999999,5.895791280000002,6.477768850000006,6.665383666666668,10144432,12056758.6,65.93061823183027,1.7820416124710945,1.5,2.75,NaN,NaN,0.17101203360745434,0.8413896584111753,328.9282843979933,-0.01568228928163029,0.22317870342755342,0.2388609927091837,21.40706936145853,1.7456748423340598,48.79688297723376,19.991222534648074,31.211894488118173,4750509436
1330957800,6.608267,6.6291,6.491601,6.564934,5.734364750000002,6.861646049999999,5.579111,3.510798,5.579111,3.510798,7.600758,6.050773,7.255762,5.955774,5.499466754999994,5.395395379999999,5.9296575800000015,6.491435350000005,6.020465823439282,6.448811879157861,6.569678076923074,6.7821839881160955,6.357172165730052,5.499466754999994,5.395395379999999,5.9296575800000015,6.491435350000005,6.5618783333333335,7573536,11539185.6,60.73582107753403,0.22372813140351375,1.5,2.75,NaN,NaN,0.17040403120692188,0.6563319338584865,326.2005607700434,-0.02554276369635433,0.2069325380887408,0.23247530178509512,23.06772083284242,0.29279986702859373,25.667631993414304,41.6456858639737,32.686682142612,4742935900
1331044200,6.35577,6.36327,6.208271,6.254104,6.208271,6.8751522,5.579111,3.510798,5.579111,3.510798,7.600758,6.050773,7.255762,5.955774,5.4944084699999935,5.412736859999999,5.956557300000002,6.490060350000006,6.029628104873035,6.430268271619017,6.5671139999999975,6.7935291949209144,6.3406988050790805,5.4944084699999935,5.412736859999999,5.956557300000002,6.490060350000006,6.275215,15654132,11822450.4,46.87161955565958,4.14247566851672,1.5,2.75,NaN,NaN,0.18370824326357033,1.3241021505998452,319.2515708046987,-0.05234000154518234,0.1670502998536172,0.21939030139879953,36.26652684650861,-3.447830815747282,5.740704683995937,73.69580150555657,20.56349381044749,4727281768
1331130600,6.31077,6.430769,6.291604,6.396602,6.242261057692308,6.88865835,5.579111,3.510798,5.579111,3.510798,7.600758,6.050773,7.255762,5.955774,5.490841829999994,5.430245009999998,5.98349034,6.493393550000006,6.044019238015269,6.427061960036253,6.558844769230766,6.801155675228893,6.316533863232639,5.490841829999994,5.430245009999998,5.98349034,6.493393550000006,6.372991666666667,7814236,11592967.8,52.252697917232204,1.8512557237019172,1.5,2.75,NaN,NaN,0.18320515445902957,0.6740496596566066,324.0737418233721,-0.05929849175255242,0.145267186708109,0.20456567846066143,39.12032639398447,-2.7616083747272064,18.481703380345298,50.86520269137924,30.65309392827545,4735096004
1331217000,6.521601,6.6341,6.476602,6.592434,6.276251115384615,6.9021645,6.7166,3.510798,5.579111,3.510798,7.600758,6.050773,7.255762,5.955774,5.489575179999994,5.449936479999999,6.0120233600000015,6.504351750000007,6.065525699269572,6.442811678128039,6.56288315384615,6.805548491731441,6.320217815960859,5.489575179999994,5.449936479999999,6.0120233600000015,6.504351750000007,6.567712,7910356,11356899,58.477004666532366,1.3875037995954662,1.5,2.75,NaN,NaN,0.1870832148548132,0.696524288892593,329.14997230888287,-0.04991885918403005,0.14216710448062386,0.1920859636646539,42.19969918117525,-0.3401394481033366,13.5075625760448,58.410509533940214,28.08192789001499,4743006360
1331303400,6.6391,6.732432,6.607492,6.679099,6.310241173076923,6.915670649999999,6.7166,3.510798,5.579111,3.510798,7.600758,6.050773,7.255762,5.955774,5.488808509999993,5.468119619999999,6.042089700000002,6.518101550000007,6.089587397337432,6.465315232592035,6.573139384615382,6.823201983600932,6.323076785629831,5.488808509999993,5.468119619999999,6.042089700000002,6.518101550000007,6.673007666666667,6811880,10875927.6,60.905843842366025,2.33910082702258,1.5,2.75,NaN,NaN,0.18371998522232655,0.6263263466373205,331.14997230888287,-0.03764351134832006,0.14503157447925386,0.1826750858275739,42.76173214992888,0.5267681100525279,33.76604347587289,32.90794208367299,33.32601444045412,4749818240
1331559000,6.685766,6.708266,6.604101,6.662433,6.344231230769231,6.9291768,6.7166,3.510798,5.579111,3.510798,7.600758,6.050773,7.255762,5.955774,5.487587684999993,5.489077739999998,6.075589340000001,6.538059650000006,6.11205193077518,6.4840883532975555,6.587369999999996,6.835072129561974,6.339667870438019,5.487587684999993,5.489077739999998,6.075589340000001,6.538059650000006,6.658266666666667,4149688,10330957.8,60.176869910200416,1.7878144140723744,1.5,2.75,NaN,NaN,0.17803748627787466,0.4016750508844397,329.4081081037593,-0.0307052251431435,0.14429355439864455,0.17499877954178805,42.74229292394978,-0.5225882812116245,39.79179978295535,27.28991292067002,32.918287296374615,4745668552
1331645400,6.780766,7.03993,6.747433,7.03493,6.378221288461538,6.94268295,6.7166,3.510798,5.579111,3.510798,7.600758,6.050773,7.255762,5.955774,5.487712684999994,5.510919179999998,6.113772320000001,6.570184300000006,6.148243227607526,6.536549462507312,6.622497846153843,6.966051078366259,6.2789446139414276,5.487712684999994,5.510919179999998,6.113772320000001,6.570184300000006,6.940764333333333,13556064,10432586.2,69.08359593987791,4.57687550637913,1.5,2.75,NaN,NaN,0.1922845944008836,1.2993963088462188,335.4595542119222,-0.00257036527636606,0.1717858229463305,0.17435618822269655,52.87639619893691,6.901352547301473,89.05108814730572,1.0931143246141788,9.855797528080087,4759224616
1331731800,7.044929,7.088262,6.939931,7.003262,6.412211346153846,6.9561891,6.7166,3.510798,5.579111,3.510798,7.600758,6.050773,7.255762,5.955774,5.487241849999993,5.534377269999998,6.15243858,6.601433950000008,6.181773375544485,6.580998275601854,6.652369230769228,7.05118204977943,6.253556411759026,5.487241849999993,5.534377269999998,6.15243858,6.601433950000008,7.010485,6801704,9984538.4,67.69736056326566,4.808834447158865,1.5,2.75,NaN,NaN,0.18914505194367767,0.6812236808063155,331.42138405926414,0.011588212756294014,0.18884145416806408,0.17725324141177007,51.35685661439297,4.267962957448719,65.63127165017167,9.467706543169234,24.901021806659084,4752422912
1331818200,7.040764,7.136595,6.979097,7.114929,6.446201403846153,6.969695249999999,6.7166,3.510798,5.579111,3.510798,7.600758,6.050773,7.255762,5.955774,5.486233524999994,5.558193699999997,6.188838240000001,6.642808550000007,6.218367713758427,6.63184882078263,6.688586846153844,7.157221119260018,6.21995257304767,5.486233524999994,5.558193699999997,6.188838240000001,6.642808550000007,7.076873666666667,9028084,9483488.4,69.98451897731842,5.2584532800404755,1.5,2.75,NaN,NaN,0.18688454823341494,0.951979231608487,334.0739572586902,0.02536540500686893,0.20895999767035622,0.1835945926634873,50.95765880249677,6.925473478686305,67.34883821005776,8.604212605145262,24.046949184796976,4761450996
1331904600,7.171595,7.178262,7.108129,7.160761,6.480191461538461,6.9832014,6.7166,3.510798,5.579111,3.510798,7.600758,6.050773,7.255762,5.955774,5.487900174999996,5.579885149999996,6.22595452,6.675641500000007,6.255324313218881,6.6822214092795225,6.724227461538458,7.256310638480164,6.192144284596752,5.487900174999996,5.579885149999996,6.22595452,6.675641500000007,7.149050666666667,8434728,9343928.2,70.89537327887243,4.982719178073194,1.5,2.75,NaN,NaN,0.17854515193102818,0.9026961487139853,332.17308026810576,0.03392208006805658,0.225997192748558,0.19207511268050143,50.04428589538443,9.075902362460916,69.25686025412712,7.689918188378506,23.053221557494382,4769885724
1332163800,7.134095,7.301594,7.120762,7.234094,6.514181519230769,6.99670755,6.7166,3.510798,5.579111,3.510798,7.600758,6.050773,7.255762,5.955774,5.490045984999995,5.600018289999997,6.2633041600000015,6.710349450000007,6.2937074381906895,6.734780703633854,6.774483307692304,7.363267052070432,6.185699563314175,5.490045984999995,5.600018289999997,6.2633041600000015,6.710349450000007,7.218816666666666,9237236,9395418.4,72.34163039240661,5.507100063138128,1.5,2.75,NaN,NaN,0.17870849822166898,0.9831638791094178,335.0302574657016,0.04043581533766197,0.24261988185257888,0.2021840665149169,48.25528569749364,15.669550746198016,84.76312900707515,2.0689473655889894,13.167923627335856,4779122960
1332250200,7.104928,7.184096,7.03743,7.157428,6.548171576923076,7.0102136999999995,6.7166,3.510798,5.579111,3.510798,7.600758,6.050773,7.255762,5.955774,5.492837619999994,5.622493059999997,6.299853760000001,6.740932450000007,6.327578832771446,6.775032827097297,6.80839315384615,7.429809208636074,6.186977099056225,5.492837619999994,5.622493059999997,6.299853760000001,6.740932450000007,7.126318000000001,10719488,9464240.2,68.50881446352675,3.5469393657069235,1.5,2.75,NaN,NaN,0.17999103406297837,1.1326305940544494,331.6430582865021,0.035662867600489645,0.24676265101552897,0.21109978341503932,34.507857644223996,11.894221338141731,50.48058985682951,18.847992550579413,30.67141759259109,4768403472
1332336600,7.177428,7.194095,7.084095,7.131595,6.582161634615384,7.023719849999999,6.7166,3.510798,5.579111,3.510798,7.600758,6.050773,7.255762,5.955774,5.496620914999995,5.643284519999996,6.335303400000002,6.773640450000007,6.359108878545115,6.808991129278507,6.845123461538458,7.481973421121316,6.208273501955601,5.496620914999995,5.643284519999996,6.335303400000002,6.773640450000007,7.136595,8650908,9465039.4,67.21651727572525,3.2171097149139585,1.5,2.75,NaN,NaN,0.17499167448705139,0.9139854188034335,331.74159121431853,0.02722861183708511,0.24513554821139572,0.2179069363743106,35.254035621036046,8.178481574483719,46.753853243077536,21.627177229827847,31.618969527094624,4759752564
1332423000,6.978264,7.02493,6.897431,6.96743,6.616151692307692,7.0372259999999995,6.7166,3.510798,5.579111,3.510798,7.600758,6.050773,7.255762,5.955774,5.499616714999995,5.657167709999997,6.3643531200000005,6.793098550000008,6.382964608798248,6.824080545537696,6.876084692307689,7.494300254481663,6.257869130133715,5.499616714999995,5.657167709999997,6.3643531200000005,6.793098550000008,6.963263666666667,13345176,9526267.6,59.53136937266098,0.3390668800425953,1.5,2.75,NaN,NaN,0.17921826916654768,1.400881915179456,329.84142168038136,0.008051572172841831,0.2279714015903629,0.21991982941752106,37.80189095868239,4.31691460180483,17.764657470977813,52.01055530844254,30.22478722057964,4746407388
1332509400,6.985763,7.064929,6.866597,7.03993,6.6501417499999995,7.05073215,6.7166,3.510798,5.579111,3.510798,7.600758,6.050773,7.255762,5.955774,5.503412509999995,5.671800899999997,6.394386140000002,6.8143483500000075,6.408727957472826,6.844637636438868,6.936532846153843,7.443288024967103,6.429777667340582,5.503412509999995,5.671800899999997,6.394386140000002,6.8143483500000075,6.990485333333333,11572072,9705655.6,61.61845740645271,1.1955377110498904,1.5,2.75,NaN,NaN,0.18058353565465146,1.19230193991223,331.6555390061976,-0.0017684879646216178,0.21770921946174404,0.21947770742636566,37.636519391536766,5.66605322710187,21.67017311297352,46.69826423889801,31.63156264812847,4757979460
1332768600,7.184928,7.32826,7.184928,7.32576,6.6841318076923075,7.0642382999999995,6.7166,3.510798,5.579111,3.510798,7.600758,6.050773,7.255762,5.955774,5.5079832949999945,5.693375679999997,6.429502460000001,6.848431350000007,6.444689998356245,6.890458813920881,7.008006538461535,7.447644411205851,6.568368665717219,5.5079832949999945,5.693375679999997,6.429502460000001,6.848431350000007,7.2796493333333325,10948692,9705502,68.51303347517795,3.8330032997747168,1.5,2.75,NaN,NaN,0.18827971167931926,1.1280912620490935,333.98923861114974,0.008409262133790368,0.2299892850936036,0.22158002295981324,42.00722125130511,4.13408520056347,21.97022261900881,46.18385771965578,31.84591966133543,4768928152
1332855000,7.352426,7.366592,7.248453,7.261594,6.7181218653846155,7.077744449999999,6.7166,3.510798,5.579111,3.510798,7.600758,6.050773,7.255762,5.955774,5.513587404999995,5.718500419999997,6.46475208,6.876639400000007,6.476725449401099,6.925805022118892,7.059480384615382,7.445914404966384,6.67304636426438,5.513587404999995,5.718500419999997,6.46475208,6.876639400000007,7.292212999999999,9886920,9710194.6,65.66150435109422,3.635581361697973,1.5,2.75,NaN,NaN,0.18326966084508217,1.0181999854050299,332.0021004808936,0.008232624313043002,0.23187080335111698,0.22363817903807398,31.69651258589804,3.6887381908601924,22.5624823141385,45.429766910169995,32.00775077569152,4759041232
1332941400,7.249928,7.281594,7.02243,7.149094,6.752111923076923,7.0912505999999995,6.7166,3.510798,5.579111,3.510798,7.600758,6.050773,7.255762,5.955774,5.518599854999995,5.740266859999997,6.496951740000001,6.905055700000007,6.503092843542232,6.94707063905995,7.095633846153844,7.415092631466991,6.776175060840697,5.518599854999995,5.740266859999997,6.496951740000001,6.905055700000007,7.151039333333333,11647760,9775282.8,60.87747858183919,1.2939633065528917,1.5,2.75,NaN,NaN,0.18869068507043346,1.1915522280337505,328.5568769442575,-0.0015280103902231834,0.221728166050295,0.22325617644051818,33.27797773968309,0.4801875043306796,20.12386253692622,48.60805460266603,31.26808286040776,4747393472
1333027800,7.02243,7.145762,6.936598,7.120762,6.786101980769231,7.10475675,6.7166,3.510798,5.579111,3.510798,7.600758,6.050773,7.255762,5.955774,5.522299814999996,5.758999999999998,6.524718140000001,6.925263800000008,6.527315163403321,6.963612673435192,7.130889923076921,7.329720963794661,6.932058882359182,5.522299814999996,5.758999999999998,6.524718140000001,6.925263800000008,7.067707333333334,13126028,9850656,59.69783540479474,0.04980808492564012,1.5,2.75,NaN,NaN,0.19039106470825962,1.3325029317844415,325.86429454069025,-0.011409152293778979,0.20899473607329444,0.22040388836707342,32.20741922758564,-0.5585858821429719,20.07331948559597,48.67605317588077,31.250627338523262,4734267444
1333114200,7.234094,7.241593,7.088262,7.181594,6.820092038461538,7.1182628999999995,6.7166,3.510798,5.579111,3.510798,7.600758,6.050773,7.255762,5.955774,5.527953919999995,5.7790914499999975,6.551784520000001,6.951638450000007,6.552973156995347,6.984372799774698,7.142171769230767,7.334479815258134,6.949863723203401,5.527953919999995,5.7790914499999975,6.551784520000001,6.951638450000007,7.170483,7882924,9737580.6,61.42616424106412,1.7034461078429493,1.5,2.75,NaN,NaN,0.1877439172290982,0.8095362003986905,328.40210386971324,-0.01513159804691716,0.20148939080842698,0.21662098885534414,32.378974110586874,-0.7257301328957049,16.06272970039511,54.38768311888794,29.54958718071694,4742150368
1333373400,7.181594,7.414093,7.134095,7.351593,6.854082096153846,7.414093,6.7166,3.510798,5.579111,3.510798,7.600758,6.050773,7.255762,5.955774,5.534333019999996,5.800107059999997,6.58215088,6.990971400000008,6.584291582211216,7.019346152177107,7.168966461538459,7.373093613303635,6.964839309773283,5.534333019999996,5.800107059999997,6.58215088,6.990971400000008,7.299927000000001,11692724,9943540,65.8354897240869,3.4434919754803546,1.5,2.75,NaN,NaN,0.1943334945698769,1.1759115968759617,332.621108491659,-0.007797484730575427,0.20687413294212487,0.2146716176727003,34.65724145228008,2.712776153668607,17.49261979370252,52.27196142436853,30.235418781928956,4753843092
1333459800,7.32326,7.369092,7.147429,7.28576,6.888072153846154,7.430237691588785,6.7166,3.510798,5.579111,3.510798,7.600758,6.050773,7.255762,5.955774,5.540132964999995,5.818473539999997,6.61098392,7.042554200000008,6.611800147614697,7.044718899588811,7.182107307692305,7.392525554395074,6.971689060989536,5.540132964999995,5.818473539999997,6.61098392,7.042554200000008,7.2674270000000005,14676972,9894682,62.839804880553494,1.6749656033246356,1.5,2.75,NaN,NaN,0.1962856021006,1.4833192213756845,329.7684025771836,-0.008950275978196254,0.203483772699955,0.21243404867815124,34.45537267570646,2.1617183813719074,14.565017933972362,56.70051349815994,28.734468567867697,4739166120
1333546200,7.108262,7.125754,6.97493,7.057429,6.922062211538461,7.44638238317757,6.7166,3.510798,5.579111,3.510798,7.600758,6.050773,7.255762,5.955774,5.544295419999995,5.840648309999995,6.63535032,7.075595550000008,6.6292757888847085,7.045929385342258,7.17415869230769,7.394762161493585,6.9535552231217945,5.544295419999995,5.840648309999995,6.63535032,7.075595550000008,7.052704333333334,15809676,10294454,53.71115664418787,1.135291666254828,1.5,2.75,NaN,NaN,0.20446734480770004,1.535746917709283,324.2985438186132,-0.02571190661138084,0.18029416541392518,0.20600607202530602,39.4967382291996,1.2917101427642577,12.693179201617976,59.76653688005024,27.540283918331767,4723356444
1333632600,6.985763,7.099929,6.961596,7.030763,6.956052269230769,7.4625270747663555,6.7166,3.510798,5.579111,3.510798,7.600758,6.050773,7.255762,5.955774,5.547016224999996,5.861423099999995,6.65603342,7.097512000000009,6.645020385399033,7.0444849676906145,7.158517846153844,7.388537215960082,6.928498476347605,5.547016224999996,5.861423099999995,6.65603342,7.097512000000009,7.030762666666667,9537524,10375812.4,52.747437055923115,1.2442964746834582,1.5,2.75,NaN,NaN,0.1997434630357215,0.9192074444214122,322.4103654924733,-0.038449791192954275,0.1579438330341132,0.19639362422706746,36.99005891456485,-0.1302143629268999,14.427770830563036,56.91853421983845,28.653694949598496,4713818920
1333978200,6.767433,6.876598,6.735991,6.794931,6.990042326923076,7.4786717663551405,6.7166,3.510798,5.579111,3.510798,7.600758,6.050773,7.255762,5.955774,5.5491203599999945,5.8769645999999955,6.6740332,7.103303600000008,6.650899233030444,7.020717923148651,7.13063346153846,7.431422250323615,6.829844672753306,5.5491203599999945,5.8769645999999955,6.6740332,7.103303600000008,6.802506666666666,10667132,10568575,45.04902549447107,3.96695198281406,1.5,2.75,NaN,NaN,0.20653121567602709,1.0093254767080708,318.3115851860895,-0.06125877936253343,0.11982015002390067,0.1810789293864341,41.36697609880049,-7.246060477001701,4.547205300471923,76.77362266851924,18.679172031008825,4703151788
1334064600,6.759099,6.813099,6.419102,6.438636,6.419102,7.494816457943926,7.351593,3.510798,5.579111,3.510798,7.600758,6.050773,7.255762,5.955774,5.549688859999995,5.8902597999999955,6.684840439999999,7.092113750000008,6.642575184676309,6.9652815495154465,7.077328923076921,7.553196345723485,6.601461500430357,5.549688859999995,5.8902597999999955,6.684840439999999,7.092113750000008,6.556945666666667,21185308,11420356,36.40441393336728,7.964742791116203,1.5,2.75,NaN,NaN,0.21992162884202518,1.8550479512197342,312.74646270448187,-0.09673250138838316,0.06016330265095515,0.1568958040393383,40.36792637092872,-11.333021372442468,0,100,0,4681966480
1334151000,6.642434,6.674934,6.566601,6.5866,6.427886624999999,7.510961149532711,7.351593,3.510798,5.579111,3.510798,7.600758,6.050773,7.255762,5.955774,5.552042999999995,5.904301319999995,6.6997569399999986,7.069697250000009,6.640380079394885,6.929216640037785,7.048034307692306,7.589696336030661,6.5063722793539505,5.552042999999995,5.904301319999995,6.6997569399999986,7.069697250000009,6.609378333333332,14310296,11458067.6,41.430848506460876,4.961601166473403,1.5,2.75,NaN,NaN,0.2210913696390234,1.2489275242188307,318.34048660935355,-0.10588353783586696,0.024541381744504598,0.13042491958037156,45.28215107493687,-7.868045937009642,4.650313336657834,76.4943183015224,18.855368361819753,4696276776
1334237400,6.621601,6.884931,6.605866,6.868265,6.43667125,7.527105841121496,7.351593,3.510798,5.579111,3.510798,7.600758,6.050773,7.255762,5.955774,5.555084639999995,5.923592799999994,6.720656739999998,7.0629474000000085,6.649316742948026,6.923411721938948,7.034829307692306,7.584941795469339,6.484716819915272,5.555084639999995,5.923592799999994,6.720656739999998,7.0629474000000085,6.786354,14299268,11832945.8,49.59754239761871,1.9024523320044087,1.5,2.75,NaN,NaN,0.22660848609337886,1.2084284202501798,320.6791728594106,-0.08928249699519389,0.018821798336379203,0.10810429533157309,53.76154808852666,-3.5459266859361396,22.653673710835058,45.315288010362636,32.031038278802306,4710576044
1334323800,6.818266,6.822432,6.614934,6.6291,6.4454558749999995,7.543250532710281,7.351593,3.510798,5.579111,3.510798,7.600758,6.050773,7.255762,5.955774,5.555672129999996,5.942950929999994,6.733306579999999,7.038655950000009,6.648523929499084,6.895382034135239,6.981240076923074,7.543151461892112,6.4193286919540355,5.555672129999996,5.942950929999994,6.733306579999999,7.038655950000009,6.688822000000001,15358832,12149483.2,43.98876118061804,2.835941806624067,1.5,2.75,NaN,NaN,0.22851723708670896,1.264155169991099,316.5778251989971,-0.09044546797924273,-0.004952539642480325,0.0854929283367624,56.69948345762683,-7.6931945749091275,19.500434315033754,49.45385851771821,31.045707167248032,4695217212
1334583000,6.727433,6.758267,6.537851,6.601601,6.454240499999999,7.559395224299066,7.351593,3.510798,5.579111,3.510798,7.600758,6.050773,7.255762,5.955774,5.555251304999996,5.962242399999993,6.744656479999999,7.010697950000008,6.646683814616767,6.867402888027121,6.930471384615382,7.501082349975004,6.35986041925576,5.555251304999996,5.962242399999993,6.744656479999999,7.010697950000008,6.632573,12098412,12332667.4,43.38130505559745,3.0921475191649463,1.5,2.75,NaN,NaN,0.2279385772948012,0.9810052933074316,317.993689916121,-0.0889674394218367,-0.025716370940533473,0.06325106848130323,55.881423942367064,-10.201761713413685,18.819279532154482,50.39057508002925,30.790145387816246,4683118800
1334669400,6.737433,6.944097,6.71184,6.898264,6.463025125,7.575539915887851,7.351593,3.510798,5.579111,3.510798,7.600758,6.050773,7.255762,5.955774,5.555372129999996,5.9870504899999935,6.756789679999998,6.993906450000009,6.656549704239639,6.870342041548348,6.9111767692307655,7.467702154401264,6.354651384060267,5.555372129999996,5.9870504899999935,6.756789679999998,6.993906450000009,6.851400333333333,9443696,12342990.4,51.20915808006842,1.0525581496978293,1.5,2.75,NaN,NaN,0.2361212503451726,0.7651059989481965,321.998494722658,-0.06502152788664882,-0.0180258413770078,0.04699568650964102,61.148953385521494,-5.318539177793388,45.75022686197035,22.307849608010052,31.941923530019597,4692562496
1334755800,6.821598,6.902431,6.799933,6.832433,6.471809749999999,7.591684607476636,7.351593,3.510798,5.579111,3.510798,7.600758,6.050773,7.255762,5.955774,5.553688819999996,6.011766919999994,6.767806259999998,6.977656700000009,6.663447088387104,6.866731656638981,6.8889976153846115,7.433189707626108,6.344805523143115,5.553688819999996,6.011766919999994,6.767806259999998,6.977656700000009,6.844932333333333,9979620,12305997,49.57134161628838,0.12167929174868868,1.5,2.75,NaN,NaN,0.22657673246337454,0.8109558290969842,318.60319062911344,-0.05123378984099388,-0.017046550791601334,0.03418723904939255,61.15922120881928,-3.188073163754109,20.799352149384703,47.70544197612423,31.495205874491067,4682582876
1334842200,6.839099,6.929931,6.622484,6.717433,6.480594375,7.607829299065421,7.351593,3.510798,5.579111,3.510798,7.600758,6.050773,7.255762,5.955774,5.551476344999997,6.038283329999995,6.775556159999997,6.9569486000000085,6.665564182960159,6.852512736959078,6.8532929230769195,7.376513836962888,6.330072009190951,5.551476344999997,6.038283329999995,6.775556159999997,6.9569486000000085,6.756616,15047284,12625815.8,46.75798090976612,1.6925712673085438,1.5,2.75,NaN,NaN,0.23235318014456205,1.1917870685235246,316.57470496281934,-0.047556852695238364,-0.02525882681965541,0.022298025875582952,59.474518117419414,-4.456557559968961,2.874934462890592,81.79277528063675,15.332290256472655,4667535592
1334928600,6.810765,6.872431,6.736599,6.737433,6.489379,7.623973990654206,7.351593,3.510798,5.579111,3.510798,7.600758,6.050773,7.255762,5.955774,5.549184699999996,6.065234729999995,6.782839419999998,6.945448750000009,6.668382567942113,6.841552762010594,6.806049846153842,7.244868593511473,6.367231098796211,5.549184699999996,6.065234729999995,6.782839419999998,6.945448750000009,6.782154333333334,8282048,12372659.4,47.31796300628048,0.612701153981378,1.5,2.75,NaN,NaN,0.2268278101342362,0.6693830107373682,319.8711677135063,-0.04168614449336748,-0.0298096547411264,0.01187648975224108,59.64818796040912,-0.8461896081063932,13.89117248339557,57.78182270596585,28.32700481063858,4675817640
1335187800,6.534101,6.582435,6.434103,6.564101,6.498163624999999,7.640118682242991,7.351593,3.510798,5.579111,3.510798,7.600758,6.050773,7.255762,5.955774,5.544868074999996,6.086942849999996,6.786039379999997,6.921657300000009,6.664293094689481,6.815128784676252,6.750537615384611,7.107526158128181,6.393549072641042,5.544868074999996,6.086942849999996,6.786039379999997,6.921657300000009,6.526879666666667,13202292,12454170.4,43.0882409857737,3.8172781641432647,1.5,2.75,NaN,NaN,0.23229225226750502,1.0600699666033155,315.81659493211976,-0.046991160744414354,-0.04686246117827686,0.00012869956613749227,58.340893968763005,1.9486270073350964,13.785877251374652,57.98303851665685,28.231084231968502,4662615348
1335274200,6.592434,6.6891,6.564934,6.634934,6.50694825,7.656263373831776,7.351593,3.510798,5.579111,3.510798,7.600758,6.050773,7.255762,5.955774,5.541693104999996,6.109034299999996,6.793472639999997,6.887116000000008,6.663141757642834,6.7979673766118465,6.718037999999996,7.031644128668525,6.404431871331468,5.541693104999996,6.109034299999996,6.793472639999997,6.887116000000008,6.629656000000001,10959132,12454692.4,45.24237138181349,2.062618087514093,1.5,2.75,NaN,NaN,0.22462844853411182,0.879919924798785,319.30270181178804,-0.043333664608074605,-0.054038381193955765,-0.01070471658588116,48.96479840262135,0.7338232168341867,15.032125047000655,55.997486110341555,28.970388842657794,4673574480
1335360600,6.816599,6.922432,6.816599,6.91993,6.515732874999999,7.672408065420561,7.351593,3.510798,5.579111,3.510798,7.600758,6.050773,7.255762,5.955774,5.541963929999996,6.128450759999996,6.8040224999999985,6.870032800000007,6.673211884794096,6.809582864553575,6.70951238461538,6.993252323676094,6.425772445554665,5.541963929999996,6.128450759999996,6.8040224999999985,6.870032800000007,6.886320333333334,10179604,12469326.6,52.95757654004757,1.5796416446524877,1.5,2.75,NaN,NaN,0.2291191307816752,0.8163715913897067,323.54665175389516,-0.020484222807908528,-0.03630999509576682,-0.015825772287858295,52.90271689653423,0.7522278188159579,36.368669033026656,30.41916412316715,33.2121668438062,4683754084
1335447000,6.871599,7.089929,6.856598,7.058263,6.5245175,7.688552757009346,7.351593,3.510798,5.579111,3.510798,7.600758,6.050773,7.255762,5.955774,5.543418079999996,6.149258889999996,6.8176223799999995,6.865491250000008,6.688311928527661,6.833266686977044,6.729768692307687,7.067475285564099,6.392062099051274,5.543418079999996,6.149258889999996,6.8176223799999995,6.865491250000008,7.001596666666668,11769764,12475426.8,56.184594598589506,3.2764322673344926,1.5,2.75,NaN,NaN,0.22941997858298407,0.9434357788865387,326.0941178151673,0.0038835508873136144,-0.010971333678716277,-0.014854884566029892,48.615497617520056,6.473925570590275,72.14691064729735,6.398728511620491,21.45436084108217,4695523848
1335533400,7.124096,7.162428,7.00993,7.100763,6.533302125,7.704697448598131,7.351593,3.510798,5.579111,3.510798,7.600758,6.050773,7.255762,5.955774,5.544755569999995,6.170517019999997,6.833888899999998,6.864491300000007,6.704486480350106,6.858742526312564,6.780701538461533,7.127024280047261,6.434378796875804,5.544755569999995,6.170517019999997,6.833888899999998,6.864491300000007,7.091040333333334,10170088,12327629.8,57.156982568565155,3.6974966275812498,1.5,2.75,NaN,NaN,0.2239255515413424,0.8249832421152037,327.1213587219642,0.021800897061768146,0.01239623676118029,-0.009404660300587855,42.10536760630707,7.5612264358297345,73.51774196090622,5.822749221863042,20.65950881723073,4705693936
1335792600,7.057429,7.074096,6.96493,7.006597,6.542086749999999,7.7208421401869165,7.351593,3.510798,5.579111,3.510798,7.600758,6.050773,7.255762,5.955774,5.546338889999995,6.189325179999997,6.843938799999998,6.855741450000008,6.716333951708925,6.872823904758986,6.813008999999994,7.159235915249338,6.466782084750649,5.546338889999995,6.189325179999997,6.843938799999998,6.855741450000008,7.015207666666667,6355512,12251259.2,54.28248252073473,1.914363843609582,1.5,2.75,NaN,NaN,0.21763322643124647,0.518763981419967,324.456195915773,0.025964589840701102,0.023051077000288522,-0.00291351284041258,43.297226372964964,1.570438591506501,85.96653331669663,1.7611296345538798,12.272337048749502,4699338424
1335879000,7.019096,7.289094,6.989097,7.139928,6.550871375,7.289094,7.351593,3.510798,5.579111,3.510798,7.600758,6.050773,7.255762,5.955774,5.547997204999996,6.209416629999998,6.855938659999998,6.845158200000007,6.732945483014457,6.898262390020035,6.833906153846148,7.221297160159167,6.4465151475331295,5.547997204999996,6.209416629999998,6.855938659999998,6.845158200000007,7.139373,6516052,11992425.6,57.53866244457669,3.934424576368347,1.5,2.75,NaN,NaN,0.22351635311472887,0.543347294145398,327.56089803638486,0.035748639981400966,0.041772287136338626,0.006023647154937662,37.21812852593416,4.500519800194167,84.6663809651671,2.0842345834424525,13.249384451390462,4705854476
1335965400,7.019096,7.11243,6.951597,7.091597,6.5596559999999995,7.2828440500000005,7.351593,3.510798,5.579111,3.510798,7.600758,6.050773,7.255762,5.955774,5.550363854999996,6.228624779999998,6.866855239999998,6.8354500500000075,6.747010248386439,6.916675210018127,6.86948284615384,7.260039932037657,6.478925760270023,5.550363854999996,6.228624779999998,6.866855239999998,6.8354500500000075,7.0518746666666665,7033796,11610266.8,55.982142820036024,1.9260771439124622,1.5,2.75,NaN,NaN,0.221003113606534,0.6058255267656726,325.3700078063642,0.03686780233011991,0.052108400067587546,0.015240597737467639,36.89378009784304,5.570044390468806,60.64391556109563,12.212629876704742,27.143454562199622,4698820680
1336051800,7.099929,7.104921,6.872431,6.914098,6.568440624999999,7.2765941000000005,7.351593,3.510798,5.579111,3.510798,7.600758,6.050773,7.255762,5.955774,5.550184694999996,6.249416239999997,6.875588499999997,6.828283500000007,6.753562709234029,6.916429761444972,6.89352107692307,7.252346586173596,6.534695567672545,5.550184694999996,6.249416239999997,6.875588499999997,6.828283500000007,6.963816666666666,9338120,11286689,50.571425475330386,0.6963702049436545,1.5,2.75,NaN,NaN,0.22182360549178157,0.827356898023858,321.9538838459931,0.024170083358849778,0.04545320193602986,0.021283118577180085,38.867696957477634,2.6221411032955704,25.44234980326501,41.96665123501363,32.59099896172136,4689482560
1336138200,6.802432,6.809099,6.559102,6.577433,6.57722525,7.270344150000001,7.351593,3.510798,5.579111,3.510798,7.600758,6.050773,7.255762,5.955774,5.548405539999996,6.264407739999997,6.875571799999998,6.805617000000007,6.746655661813087,6.88414435559307,6.868841769230763,7.26514292312427,6.472540615337256,5.548405539999996,6.264407739999997,6.875571799999998,6.805617000000007,6.648544666666666,12251340,11422379.8,42.23364212037926,4.397615171281533,1.5,2.75,NaN,NaN,0.23133591938522574,1.0725733353744724,317.68745900165555,-0.0067348445241397145,0.01286456292200544,0.019599407446145155,49.25737654161723,0.2031047358960522,3.2977492949026406,80.4559391544842,16.246311550613168,4677231220
1336397400,6.497435,6.650767,6.494101,6.593267,6.586009874999999,7.264094200000001,7.351593,3.510798,5.579111,3.510798,7.600758,6.050773,7.255762,5.955774,5.545309734999995,6.281824229999996,6.875138459999999,6.7955338000000065,6.740640420173357,6.856441750298492,6.850444384615378,7.273125676060318,6.427763093170438,5.545309734999995,6.281824229999996,6.875138459999999,6.7955338000000065,6.5793783333333336,8425032,11310274.8,42.712036588683,4.0308758531073945,1.5,2.75,NaN,NaN,0.2260023537148525,0.7449007339768614,318.90879706569297,-0.024920598082091388,-0.011551340156469081,0.013369257925622307,46.91290741842584,-0.6279941895428099,14.908386854245286,56.16556857797919,28.926044567775524,4685656252
1336483800,6.471602,6.539101,6.264112,6.509102,6.594794499999999,7.257844250000001,7.351593,3.510798,7.351593,3.510798,5.579111,6.050773,7.600758,5.955774,5.541663939999995,6.299924049999996,6.872438499999999,6.799057100000008,6.731560482127343,6.823361774079588,6.834418923076917,7.290532028353675,6.378305817800158,5.541663939999995,6.299924049999996,6.872438499999999,6.799057100000008,6.437438333333333,11108556,10806437.2,40.77885878105735,5.526112536107271,1.5,2.75,NaN,NaN,0.23337039987807734,1.0279572993770787,317.84309809988963,-0.04050579581257819,-0.03726298684010043,0.003242808972477758,46.97184847210854,-5.9368808644018,3.3569517575067227,80.23718673990058,16.405861502592717,4674547696
1336570200,6.296604,6.517436,6.208271,6.396602,6.6035791249999996,7.251594300000001,7.351593,3.510798,7.351593,3.510798,5.579111,6.050773,7.600758,5.955774,5.538097299999995,6.318507179999997,6.866421879999998,6.789557200000007,6.718424855377251,6.782717986072008,6.808201153846148,7.319449654605941,6.296952653086355,5.538097299999995,6.318507179999997,6.866421879999998,6.789557200000007,6.374103000000001,13158020,10748823.4,38.284547141214176,5.718913192750169,1.5,2.75,NaN,NaN,0.23878429988678612,1.2241358435566072,314.52795163579015,-0.055359966315335025,-0.06595714892169102,-0.010597182606355997,38.20155251297446,-9.374275228905477,2.7071162301235456,82.36609667852925,14.926787091347196,4661389676
1336656600,6.539101,6.550768,6.394103,6.435769,6.612363749999999,7.245344350000001,7.351593,3.510798,7.351593,3.510798,5.579111,6.050773,7.600758,5.955774,5.535138994999994,6.3368819999999975,6.8635218999999985,6.7679324000000065,6.707340312029124,6.749675225493721,6.798329461538456,7.332492449071498,6.264166474005414,5.535138994999994,6.3368819999999975,6.8635218999999985,6.7679324000000065,6.460213333333333,8901064,10478913.2,39.668160298222844,3.6709795800426352,1.5,2.75,NaN,NaN,0.23291863560915851,0.8494262553868659,316.8528083362528,-0.059172052771358,-0.0845622485705535,-0.0253901957991955,35.27802699957699,-9.365106256890986,13.006528100895224,59.2446833554454,27.74878854365938,4670290740
1336743000,6.309104,6.558268,6.303087,6.374104,6.621148375,7.239094400000001,7.351593,3.510798,7.351593,3.510798,5.579111,6.050773,7.600758,5.955774,5.5340973399999935,6.354398499999998,6.856671979999999,6.755182600000007,6.694272221361315,6.713906537351463,6.77826561538461,7.35348697169005,6.20304425907917,5.5340973399999935,6.354398499999998,6.856671979999999,6.755182600000007,6.411819666666666,7981540,10110048.6,38.21550208453727,3.7432284671710483,1.5,2.75,NaN,NaN,0.23450880449421865,0.7894660367903672,314.48819465755975,-0.06216333659692722,-0.10309436654535453,-0.04093102994842731,33.92562956635127,-9.027106882271097,15.745597325298045,54.87166360839714,29.382739066304804,4662309200
1337002200,6.205771,6.299938,6.138272,6.175772,6.629932999999999,7.232844450000001,7.351593,3.510798,7.351593,3.510798,5.579111,6.050773,7.600758,5.955774,5.532439024999994,6.371448339999998,6.8471053999999985,6.733891150000007,6.673938879347146,6.662655629032276,6.721022692307686,7.371629677064529,6.070415707550843,5.532439024999994,6.371448339999998,6.8471053999999985,6.733891150000007,6.204660666666666,12617788,10136017.4,33.9138329787764,6.119880318638389,1.5,2.75,NaN,NaN,0.23460331845891735,1.2448467185938334,309.22911729200956,-0.07306343503683269,-0.13226032374446817,-0.05919688870763548,35.97944202924325,-13.503721606156251,2.9537923260507255,81.59016342697049,15.456044246978774,4649691412
1337088600,6.151606,6.263271,6.02744,6.064106,6.638717624999999,7.226594500000001,7.351593,3.510798,7.351593,3.510798,5.579111,6.050773,7.600758,5.955774,5.530797369999995,6.3833732099999985,6.837088839999998,6.6921832500000065,6.650023864470787,6.605650902457773,6.644549076923071,7.350016176618656,5.939081977227486,5.530797369999995,6.3833732099999985,6.837088839999998,6.6921832500000065,6.1182723333333335,16073752,10467520.2,31.74705820707854,6.58011373096287,1.5,2.75,NaN,NaN,0.23469100999756606,1.5355835663923534,306.02531208318493,-0.08265187608594078,-0.16251173381506145,-0.07985985772912067,29.904860151280715,-14.488852087900657,2.5377551453328158,83.01170728614477,14.450537568522412,4633617660
1337175000,6.144105,6.221604,5.983274,5.99244,6.64750225,7.22034455,7.351593,3.510798,7.351593,3.510798,5.579111,6.050773,7.600758,5.955774,5.529243219999994,6.394206429999998,6.8318555599999975,6.650183600000005,6.624236261942522,6.547249864128461,6.559293461538456,7.291013624239015,5.827573298837897,5.529243219999994,6.394206429999998,6.8318555599999975,6.650183600000005,6.065772666666668,15048688,10720973.6,30.404445154738838,6.7981308578119615,1.5,2.75,NaN,NaN,0.2349509378548828,1.4036680399996508,303.0336570228546,-0.08817446687252031,-0.19007794131977107,-0.10190347444725076,29.45068675901417,-13.330126359215619,2.4513201620260405,83.32001467470519,14.228665163268774,4618568972
1337261400,5.995773,6.006539,5.683277,5.695777,6.656286874999999,7.2140946,7.351593,3.510798,7.351593,3.510798,5.579111,6.050773,7.600758,5.955774,5.528680729999993,6.400664699999998,6.817839059999999,6.599100800000005,6.587826094807521,6.466157210401941,6.458461153846149,7.272473818062829,5.644448489629469,5.528680729999993,6.400664699999998,6.817839059999999,6.599100800000005,5.795197666666667,18041796,10870699.2,25.581537729876487,9.822385933773708,1.5,2.75,NaN,NaN,0.2412588708652483,1.6596720843862556,296.9955268161232,-0.10501697360859386,-0.23317469145799308,-0.12815771784939922,35.17952083001251,-13.404256645411673,0,100,0,4600527176
1337347800,5.767443,5.788276,5.511612,5.535777,6.6650715,7.20784465,7.351593,3.510798,7.351593,3.510798,5.579111,6.050773,7.600758,5.955774,5.526839074999994,6.404364639999999,6.796705919999998,6.539018000000004,6.546569267560167,6.377549571316042,6.335064923076918,7.184047446274571,5.486082399879265,5.526839074999994,6.404364639999999,6.796705919999998,6.539018000000004,5.611888333333333,13885588,11150876.2,23.423473243116106,11.44624244597156,1.5,2.75,NaN,NaN,0.24378780866058766,1.2452463601021775,292.40827740685216,-0.11911080400865054,-0.2770462228602124,-0.15793541885156187,30.17993396328824,-16.038937904380326,0,100,0,4586641588
1337607000,5.590777,5.842442,5.559112,5.835775,6.6738561249999995,7.2015947,7.351593,3.510798,7.351593,3.510798,5.579111,6.050773,7.600758,5.955774,5.530851539999993,6.410964569999999,6.779839439999998,6.502601700000005,6.5186949825578075,6.325951993095466,6.238463230769226,7.002690727847522,5.47423573369093,5.530851539999993,6.410964569999999,6.779839439999998,6.502601700000005,5.7457763333333345,10127656,10997144.4,34.56908311633377,7.12511158081174,1.5,2.75,NaN,NaN,0.2482790366134028,0.9209350747454039,297.8217379964894,-0.1011155201167083,-0.28432981899744725,-0.18321429888073895,49.66573891445572,-10.344391591958466,1.9147732878653088,85.39852577804113,12.686700934093556,4596769244
1337693400,5.877441,6.00494,5.758277,5.862442,6.682640749999999,7.19534475,7.351593,3.510798,7.351593,3.510798,5.579111,6.050773,7.600758,5.955774,5.535347329999994,6.419714479999999,6.763839619999998,6.4639771000000055,6.492959571477109,6.281808184229232,6.157566615384611,6.836474365397839,5.478658865371383,5.535347329999994,6.419714479999999,6.763839619999998,6.4639771000000055,5.875219666666667,12433600,11070867.8,35.468212831430534,4.216631993084475,1.5,2.75,NaN,NaN,0.24816360542673124,1.1230917236677687,299.66951658557565,-0.08116362671843785,-0.28466883227878625,-0.2035052055603484,50.577110211740695,-8.350683691122255,12.49213884163636,60.282233331009245,27.22562782735439,4609202844
1337779800,5.743276,5.909108,5.572444,5.884941,6.691425375,7.1890948,7.351593,3.510798,7.351593,3.510798,5.579111,6.050773,7.600758,5.955774,5.544847229999993,6.427306079999999,6.740839839999999,6.4122276500000055,6.469115705928987,6.244011309540734,6.104297999999996,6.750975898081948,5.457620101918043,5.544847229999993,6.427306079999999,6.740839839999999,6.4122276500000055,5.788831000000001,16824504,11403112.8,36.26400172792092,5.281238951169522,1.5,2.75,NaN,NaN,0.2544850621819647,1.4754308139440662,300.2335926603934,-0.06111228330809032,-0.2798955596954613,-0.218783276387371,50.974282239300955,-8.55885287368144,39.56612025416035,27.630388658438033,32.80349108740161,4626027348
1337866200,5.935774,5.960774,5.765776,5.916608,6.700209999999999,7.18284485,7.351593,3.510798,7.351593,3.510798,5.579111,6.050773,7.600758,5.955774,5.551651329999994,6.43577267,6.719106759999999,6.355144900000005,6.447448737069027,6.212830041965426,6.052247307692303,6.6392976321771595,5.465196983207447,5.551651329999994,6.43577267,6.719106759999999,6.355144900000005,5.881052666666666,14044628,11516856,37.43348638279891,3.6803269543895025,1.5,2.75,NaN,NaN,0.25023598631182437,1.2194845537705776,302.3514095823325,-0.04132536351440161,-0.270439980780373,-0.2291146172659714,50.899684765688654,-7.177416622006793,75.18288280742982,5.200143859869368,19.616973332700812,4640071976
1337952600,5.907441,5.9541,5.823275,5.857441,6.708994624999999,7.1765949,7.351593,5.535777,7.351593,3.510798,5.579111,6.050773,7.600758,5.955774,5.561217899999995,6.44139762,6.693956999999998,6.2929788000000055,6.424311178752594,6.1789834665401475,6.002119538461534,6.533187619483523,5.471051457439544,5.561217899999995,6.44139762,6.693956999999998,6.2929788000000055,5.878272,8891968,11452950,36.10063452582847,2.7208745678555073,1.5,2.75,NaN,NaN,0.2417066301466941,0.7763910608183918,303.06462099575157,-0.02844406716531961,-0.2646697012226209,-0.2362256340573013,50.903949965765996,-5.154513476209947,82.74356570524152,2.6275834634135524,14.62885083134493,4631180008
1338298200,6.000772,6.106606,5.94994,6.070773,6.7177792499999995,7.1703449500000005,7.351593,5.535777,7.351593,3.510798,5.579111,6.050773,7.600758,5.955774,5.5690803249999945,6.44905588,6.672157239999998,6.246187600000006,6.410446936448571,6.168677707822038,5.977055769230764,6.45984848766617,5.494263050795359,5.5690803249999945,6.44905588,6.672157239999998,6.246187600000006,6.042439666666667,13477404,11809044.6,43.86202425594956,0.2349509302248923,1.5,2.75,NaN,NaN,0.2422393708505017,1.1412781013630857,307.48915154579134,-0.0031112612917494342,-0.24011471067198809,-0.23700344938023865,54.255761163014775,0.10994200958888582,84.47456413383368,2.1289158518576135,13.3965200143087,4644657412
1338384600,5.915775,5.923274,5.764942,5.803275,6.726563874999999,7.1640950000000005,7.351593,5.535777,7.351593,3.510798,5.579111,6.050773,7.600758,5.955774,5.575130264999995,6.45342251,6.643540859999997,6.179354950000007,6.386636272274117,6.133877449934225,5.928402384615381,6.338485896931545,5.518318872299216,5.575130264999995,6.45342251,6.643540859999997,6.179354950000007,5.830497,11778236,12072153.8,37.68156074835264,3.080148280666083,1.5,2.75,NaN,NaN,0.2467816300754659,0.9756532425887416,301.9213871829613,-0.0019804341180437446,-0.23947899202779332,-0.23749855790974958,59.19086542200069,-3.156727476620542,59.26113158037681,13.005634586861484,27.733233832761726,4632879176
1338471000,5.801609,5.883275,5.601611,5.762442,6.735348499999999,7.157845050000001,7.351593,5.535777,7.351593,3.510798,5.579111,6.050773,7.600758,5.955774,5.579488554999995,6.45774745,6.6156411399999975,6.112897200000006,6.36215806551827,6.098502645178584,5.881351461538457,6.207947537911907,5.554755385165007,5.579488554999995,6.45774745,6.6156411399999975,6.112897200000006,5.749109333333333,16075624,12524245.2,36.82847719293863,3.8276171087922326,1.5,2.75,NaN,NaN,0.24927322792721834,1.2835603058937237,300.95961797987775,-0.0016084735730341193,-0.23950914987604222,-0.2379006763030081,59.0322972840239,1.1704285473255085,24.48390932216458,43.07460132067774,32.441489357157685,4616803552
1338557400,5.479112,5.529936,5.314114,5.322447,6.744133124999999,7.151595100000001,7.351593,5.535777,7.351593,3.510798,5.579111,6.050773,7.600758,5.955774,5.582338529999995,6.457380790000001,6.579458179999998,6.0333146500000066,6.321385082556769,6.024592583733005,5.815711076923072,6.214300668450661,5.417121485395483,5.582338529999995,6.457380790000001,6.579458179999998,6.0333146500000066,5.388832333333333,17887136,12951696,29.16611876482736,9.891254760287767,1.5,2.75,NaN,NaN,0.26349142593241703,1.3810651516218417,294.98563065229126,-0.02720157500375958,-0.27190264505770756,-0.24470107005394798,68.80947896469814,-3.853659567572899,5.043911223514994,75.46618541325319,19.48990336323181,4598916416
1338816600,5.337447,5.387445,5.166615,5.292446,5.166615,7.145345150000001,7.351593,5.535777,7.351593,3.510798,5.579111,6.050773,7.600758,5.955774,5.585046834999995,6.455155810000001,6.5459584999999985,5.969065300000006,6.281034530299641,5.954864337663195,5.7563526153846105,6.214657571139913,5.298047659629308,5.585046834999995,6.455155810000001,6.5459584999999985,5.969065300000006,5.282168666666666,16406156,13159436.8,28.727239293848214,9.767282643702382,1.5,2.75,NaN,NaN,0.26044418122295865,1.2467217442010892,292.4101048160137,-0.04150058443543442,-0.296576800598241,-0.25507621616280657,67.40972445655866,-9.310314396973837,3.8424158412257827,78.90568861675557,17.25189554201864,4582510260
1338903000,5.254114,5.444112,5.254114,5.417445,5.133654815789474,7.139095200000001,7.351593,5.535777,7.351593,3.510798,5.579111,6.050773,7.600758,5.955774,5.591513429999996,6.453947470000002,6.513508799999998,5.910274200000006,6.247168274209459,5.903681543600033,5.712122230769226,6.1815998534410985,5.242644608097353,5.591513429999996,6.453947470000002,6.513508799999998,5.910274200000006,5.371890333333333,11840372,13330203.8,33.23509837588685,6.793555218019801,1.5,2.75,NaN,NaN,0.2554123111356044,0.8882363824024956,296.332218879042,-0.037984771984253096,-0.3025571811431229,-0.2645724091588698,59.984776649101924,-7.590642261364802,2.4914309333559297,83.24028684684025,14.268282219803826,4594350632
1338989400,5.533277,5.791609,5.526612,5.785775,5.100694631578947,7.132845250000001,7.351593,5.535777,7.351593,3.510798,5.579111,6.050773,7.600758,5.955774,5.600871664999996,6.4561057800000015,6.4827090999999974,5.874107850000007,6.229074420318892,5.892452348971458,5.7190451538461495,6.1900063767253855,5.248083930966914,5.600871664999996,6.4561057800000015,6.4827090999999974,5.874107850000007,5.701332000000001,12920684,13420810.2,44.395331011418754,0.7802775029770933,1.5,2.75,NaN,NaN,0.2638945746259184,0.9627350217649304,298.8377682754375,-0.007871888072348454,-0.2744122692493054,-0.26654038117695694,73.24937836374549,-1.6850806150817876,13.010363865982281,59.437490028176384,27.552146105841338,4607271316
1339075800,5.974107,6.008274,5.751609,5.784109,5.067734447368421,7.126595300000001,7.351593,5.535777,7.351593,3.510798,5.579111,6.050773,7.600758,5.955774,5.610225734999996,6.458955740000001,6.453159399999997,5.843483200000007,6.211624795992662,5.882133934783701,5.738147615384611,6.197835427212487,5.278459803556736,5.610225734999996,6.458955740000001,6.453159399999997,5.843483200000007,5.847997333333334,14040824,13464950.4,44.359212366534734,1.6622136100974274,1.5,2.75,NaN,NaN,0.2633781764383528,1.0427683417237095,297.3589805331252,0.01373861910975005,-0.2493671072897694,-0.26310572639951946,73.1817560472998,-2.239441923480483,13.838745600508744,58.07345702964127,28.087797369849984,4593230492
1339162200,5.743276,5.926524,5.678277,5.920632,5.034774263157895,7.120345350000001,7.351593,5.535777,7.351593,3.510798,5.579111,6.050773,7.600758,5.955774,5.618308279999996,6.46277095,6.428590159999998,5.817726350000006,6.200213313796871,5.885800417185253,5.744675076923073,6.212067982867369,5.277282170978777,5.618308279999996,6.46277095,6.428590159999998,5.817726350000006,5.841811,8828152,13461304.8,48.08647646067647,1.9291840286123316,1.5,2.75,NaN,NaN,0.26229737812132764,0.6558169606262834,300.93504475152474,0.03767472883317058,-0.2160123153580562,-0.2536870441912268,74.5291115830813,1.0788158173509672,35.160050979927675,31.740933510739694,33.099015509332624,4602058644
1339421400,6.075773,6.083273,5.66661,5.68911,5.001814078947369,7.114095400000001,7.351593,5.292446,7.351593,3.510798,5.579111,6.050773,7.600758,5.955774,5.624337384999997,6.46233763,6.399957119999998,5.783476650000006,6.180170046589151,5.867067996500944,5.731341846153843,6.194405148608167,5.268278543699518,5.624337384999997,6.46233763,6.399957119999998,5.783476650000006,5.812997666666667,13384344,13731445,42.844843753453745,0.8690475775856606,1.5,2.75,NaN,NaN,0.2733234939698042,0.9747221796395062,295.6788941977385,0.03824007034323945,-0.20588695626217746,-0.2441270266054169,77.89400569773657,-6.286892954159209,40.32817051979626,26.80062442148211,32.87120505872162,4588674300
1339507800,5.734943,5.884941,5.651611,5.879108,4.968853894736842,7.107845450000001,7.351593,5.292446,7.351593,3.510798,5.579111,6.050773,7.600758,5.955774,5.632387304999997,6.462845960000001,6.373907399999997,5.768643450000007,6.168363691820948,5.868214663500853,5.73089315384615,6.19337119181043,5.26841511588187,5.632387304999997,6.462845960000001,6.373907399999997,5.768643450000007,5.805219999999999,12624352,13731773.2,47.86707989847322,0.8327740205395571,1.5,2.75,NaN,NaN,0.270466815829104,0.919353372367088,300.2614698926943,0.05094069576499699,-0.18045115689917068,-0.23139185266416767,77.38060207446473,1.306727666705427,42.123514909716775,25.260879627655132,32.615605462628096,4601298652
1339594200,5.817442,5.924107,5.692443,5.750775,4.935893710526316,7.1015955,7.351593,5.292446,7.351593,3.510798,5.579111,6.050773,7.600758,5.955774,5.6387455699999975,6.462020960000001,6.341891039999997,5.752976900000007,6.151987664690715,5.857029933643629,5.7181367692307665,6.168408189903405,5.267865348558128,5.6387455699999975,6.462020960000001,6.341891039999997,5.752976900000007,5.789108333333334,9421820,13399176.6,44.991370876482875,0.2300303795489987,1.5,2.75,NaN,NaN,0.26769518612702514,0.703164103382293,296.6381833834316,0.05015044938105401,-0.16870379093785015,-0.21885424031890416,73.88428543864894,-0.20246624608109018,18.520504134618477,50.80819510366174,30.671300761719785,4591876832
1339680600,5.791609,5.991606,5.736609,5.925774,4.90293352631579,7.09534555,7.351593,5.292446,7.351593,3.510798,5.579111,6.050773,7.600758,5.955774,5.644024684999998,6.462837620000001,6.314691319999997,5.749643600000008,6.143116540585197,5.863576987582331,5.7233931538461515,6.181572665611067,5.265213642081236,5.644024684999998,6.462837620000001,6.314691319999997,5.749643600000008,5.884663,12552208,13274352.6,49.45103524087454,1.6450126882172944,1.5,2.75,NaN,NaN,0.26678817283223766,0.9455985070036486,299.92677195830913,0.06018944851479052,-0.14361742967541602,-0.20380687819020654,75.78376733940652,11.335519170035875,48.65314186560974,20.088421211397854,31.258436922992402,4604429040
1339767000,6.001607,6.114939,5.96494,6.087439,4.869973342105263,7.0890956,7.351593,5.292446,7.351593,3.510798,5.579111,6.050773,7.600758,5.955774,5.6499329599999975,6.465320920000002,6.2952915199999975,5.769226700000007,6.140933107621072,5.884897179241157,5.724675153846151,6.18681158592578,5.262538721766522,5.6499329599999975,6.465320920000002,6.2952915199999975,5.769226700000007,6.055772666666667,11588152,12951670.4,53.22381355972597,3.7880788691423652,1.5,2.75,NaN,NaN,0.2612436604870778,0.894722583428312,301.9818946825679,0.07550161936082672,-0.10942985398917315,-0.18493147334999988,55.453826767229245,15.021277496265428,51.65817679384668,17.920295129600696,30.421528076552633,4616017192
1340026200,6.02244,6.194021,5.99064,6.155772,4.837013157894737,7.08284565,7.351593,5.292446,7.351593,3.510798,5.579111,6.050773,7.600758,5.955774,5.655741239999998,6.466912560000001,6.277791699999998,5.800226450000007,6.141515024969265,5.910694781218189,5.751790307692305,6.267456064253746,5.236124551130865,5.655741239999998,6.466912560000001,6.277791699999998,5.800226450000007,6.113477666666666,12716092,12893195.6,54.76077626975401,4.327321611366568,1.5,2.75,NaN,NaN,0.2571106133094294,0.9862637932833347,303.6786506731923,0.08718790911754656,-0.07594658695306666,-0.16313449607061323,54.16434176742696,13.628693969205038,82.19691283973911,2.7550808723958875,15.048006287864995,4628733284
1340112600,6.256604,6.407286,6.224938,6.332438,4.804052973684211,7.0765957,7.351593,5.292446,7.351593,3.510798,5.579111,6.050773,7.600758,5.955774,5.663287004999997,6.471287520000001,6.268541839999998,5.825059600000007,6.149002200460666,5.950860802054552,5.795636153846151,6.397238536641578,5.194033771050724,5.663287004999997,6.471287520000001,6.268541839999998,5.825059600000007,6.321554,9780156,12875820.6,58.5525587458924,6.368199318220332,1.5,2.75,NaN,NaN,0.25671085521589876,0.7595753547544768,309.22259278306746,0.10270379232592705,-0.034754755663204406,-0.13745854798913146,54.51226281873088,9.448397146449691,81.47095612376505,2.9711804387235605,15.557863437511388,4638513440
1340199000,6.33077,6.395619,6.169105,6.304644,4.771092789473684,7.07034575,7.351593,5.292446,7.351593,3.510798,5.579111,6.050773,7.600758,5.955774,5.672593774999998,6.475351220000001,6.2658619999999985,5.847169700000007,6.155105800442601,5.984554439954119,5.871189769230766,6.462727560587473,5.279651977874059,5.672593774999998,6.475351220000001,6.2658619999999985,5.847169700000007,6.289789333333334,14738220,12991051.6,57.732711416894,4.611880340685018,1.5,2.75,NaN,NaN,0.2545539369861917,1.1344901439695614,308.6420080332803,0.1065243800199777,-0.004303072964159327,-0.11082745298413703,44.934597409148104,8.999398178699602,69.69906370849206,7.475530319944422,22.825405971563526,4623775220
1340285400,6.324103,6.339104,5.864108,5.882441,4.738132605263158,7.0640958000000005,7.351593,5.292446,7.351593,3.510798,5.579111,6.050773,7.600758,5.955774,5.680268694999998,6.475767880000001,6.251778819999999,5.847044700000007,6.144413063170342,5.974829350434678,5.916573999999997,6.405099532282285,5.428048467717709,5.680268694999998,6.475767880000001,6.251778819999999,5.847044700000007,6.028551,11837240,12741688.4,46.973207074457534,1.560185424615198,1.5,2.75,NaN,NaN,0.27029979863003517,0.9290165972038682,303.3476855321222,0.0774012499626353,-0.014075890530842905,-0.0914771404934782,63.49484255239293,-0.6450493798635062,42.08929884282654,25.287671040332274,32.62303011684118,4611937980
1340371800,5.96744,6.036606,5.894108,5.996608,4.705172421052632,7.0578458500000005,7.351593,5.292446,7.351593,3.510798,5.579111,6.050773,7.600758,5.955774,5.6867103049999965,6.477501210000002,6.234345679999999,5.851044700000007,6.1386167861832694,5.976903507536138,5.9611249999999965,6.356135916188007,5.566114083811986,5.6867103049999965,6.477501210000002,6.234345679999999,5.851044700000007,5.975774,7998052,12439359.6,49.70292038597983,0.2601462186641842,1.5,2.75,NaN,NaN,0.26200445587074694,0.6429633242534447,307.0893429188962,0.06320978568243997,-0.012464908390428242,-0.07567469407286821,63.025799316233226,5.405028203005387,38.14226799293417,28.746285255343405,33.11144675172242,4619936032
1340631000,5.810775,5.830775,5.64621,5.70661,4.672212236842106,7.051595900000001,7.351593,5.292446,7.351593,3.510798,5.579111,6.050773,7.600758,5.955774,5.6923810849999965,6.474601230000001,6.21589588,5.843503150000007,6.121675343587847,5.9511612687231725,5.955035384615381,6.362903182210132,5.54716758702063,5.6923810849999965,6.474601230000001,6.21589588,5.843503150000007,5.727865,9305252,12460023.8,43.567758960049765,4.051265830925105,1.5,2.75,NaN,NaN,0.2683182804514079,0.7468085253577124,302.4582125578447,0.03318420626031254,-0.03419443624747753,-0.06737864250779008,65.52783324756626,-2.9340845584057846,14.72429307949019,56.446515189905305,28.829191730604514,4610630780
1340717400,5.753275,5.854108,5.662443,5.802442,4.639252052631579,7.045345950000001,7.351593,5.292446,7.351593,3.510798,5.579111,6.050773,7.600758,5.955774,5.700343504999996,6.472284590000002,6.199912699999999,5.830086600000007,6.109156388937343,5.936997528844775,5.956445615384611,6.362060254148313,5.55083097662091,5.700343504999996,6.472284590000002,6.199912699999999,5.830086600000007,5.772997666666666,11023152,12337311.2,45.942416292461736,2.6091975683433657,1.5,2.75,NaN,NaN,0.2628430461334502,0.8934809069256517,304.92288837134873,0.019355236425460956,-0.043184596975963885,-0.06253983340142484,63.20818425838217,0.8984354282683661,15.10968683562608,55.84285097683472,29.047462187539193,4621653932
1340803800,5.862442,5.987441,5.840775,5.957441,4.606291868421053,7.039096000000001,7.351593,5.292446,7.351593,3.510798,5.579111,6.050773,7.600758,5.955774,5.708680924999997,6.4689429600000015,6.18109624,5.837794900000008,6.103206765841761,5.938944526097654,5.959277076923073,6.364365734572965,5.554188419273181,5.708680924999997,6.4689429600000015,6.18109624,5.837794900000008,5.928552333333333,7185776,12107688.2,49.63401124514792,0.28633859056761995,1.5,2.75,NaN,NaN,0.257282757123918,0.5934886892776112,309.87761296254934,0.020134710365599384,-0.03737144544442561,-0.057506155810024995,63.497508347731014,0.5343943255345303,41.36093549203925,25.905752289330433,32.733312218630296,4628839708
1340890200,5.829943,5.928957,5.708276,5.908273,4.573331684210527,7.032846050000001,7.351593,5.292446,7.351593,3.510798,5.579111,6.050773,7.600758,5.955774,5.716147509999996,6.465209650000002,6.16261304,5.845086450000006,6.095562304436202,5.936023428374067,5.9761357692307655,6.352037160406821,5.60023437805471,5.716147509999996,6.465209650000002,6.16261304,5.845086450000006,5.848502,8978080,11752811,48.50249746927295,1.904219230004333,1.5,2.75,NaN,NaN,0.2567029173293525,0.7639091618166922,310.6753369977668,0.01695426049293798,-0.03631333019385252,-0.0532675906867905,61.434455851258164,-2.94320813728071,46.4482972810022,21.760117259181552,31.791585459816254,4619861628
1340976600,6.224938,6.35827,6.180354,6.347437,4.540371500000001,7.026596100000001,7.351593,5.292446,7.351593,3.510798,5.579111,6.050773,7.600758,5.955774,5.724864924999996,6.465384640000002,6.155213120000001,5.896335950000006,6.10543974347792,5.975205673290823,6.012161076923073,6.431247831767249,5.593074322078897,5.724864924999996,6.465384640000002,6.155213120000001,5.896335950000006,6.295353666666668,5564164,11136662.4,57.76418670870954,4.9761936028392295,1.5,2.75,NaN,NaN,0.27050963752011303,0.4996258124875905,316.3699459771939,0.042584096746903874,-0.00003746975316065715,-0.04262156650006453,72.95564540123536,3.113581854558623,43.46099450296441,24.145202879999907,32.39380261703568,4625425792
1341235800,6.404103,6.422437,6.266604,6.396602,4.507411315789474,7.020346150000001,7.351593,5.292446,7.351593,3.510798,5.579111,6.050773,7.600758,5.955774,5.732648174999996,6.465617960000002,6.1483965000000005,5.951543750000007,6.116857871184668,6.015338656786935,6.0618400769230725,6.497976136805915,5.62570401704023,5.732648174999996,6.465617960000002,6.1483965000000005,5.951543750000007,6.3618809999999995,5299240,10581316.6,58.66054730053248,4.954913323370998,1.5,2.75,NaN,NaN,0.26231844912581925,0.5008110238379977,320.1282700717871,0.05994222098772849,0.03230620973459608,-0.027636011253132406,72.86195794552778,1.0132590323031965,72.52604455290809,6.2344187609455926,21.239536686146316,4630725032
1341322200,6.405769,6.538685,6.382436,6.528268,4.474451131578948,7.014096200000001,7.351593,5.292446,7.351593,3.510798,5.579111,6.050773,7.600758,5.955774,5.740743924999996,6.466859610000003,6.14767984,6.007084900000007,6.132991601726446,6.064189070426274,6.108185769230764,6.601000505045758,5.61537103341577,5.740743924999996,6.466859610000003,6.14767984,6.007084900000007,6.483129666666667,4031860,10190891,61.04488965778037,6.079277849440818,1.5,2.75,NaN,NaN,0.25474205990254645,0.3956337085736664,324.2135265372185,0.07633425546868969,0.06778180808272971,-0.00855244738595998,72.02820656694293,3.5469726760146973,66.15367818032743,9.201968491673105,24.644353327999465,4634756892
1341495000,6.454102,6.525776,6.369311,6.439102,4.441490947368422,7.007846250000001,7.351593,5.292446,7.351593,3.510798,5.579111,6.050773,7.600758,5.955774,5.749116799999996,6.4686179200000025,6.1437632,6.039751250000007,6.144995931070507,6.099895063719011,6.135236769230764,6.658209917536401,5.612263620925128,5.749116799999996,6.4686179200000025,6.1437632,6.039751250000007,6.444729666666667,3297536,9709733.6,58.580729164426174,4.884754947471192,1.5,2.75,NaN,NaN,0.24790026990950742,0.33961137718546675,323.2841020985286,0.07699450252516427,0.08769068077049536,0.010696178245331086,72.57848563560678,9.4630953374628,42.96753127323865,24.57489312254645,32.45757560421491,4631459356
1341581400,6.254937,6.296596,6.166605,6.264937,4.408530763157895,7.001596300000001,7.351593,5.292446,7.351593,3.510798,5.579111,6.050773,7.600758,5.955774,5.756783389999996,6.467342920000004,6.13066334,6.063792650000007,6.149699502401075,6.115613343364819,6.143634076923073,6.671142511291785,5.616125642554361,5.756783389999996,6.467342920000004,6.13066334,6.063792650000007,6.242712666666667,5142840,9264834.4,53.995865099140495,1.075105591026698,1.5,2.75,NaN,NaN,0.2496571792016855,0.5550924903741399,320.2995480237613,0.0621598351051536,0.08839597212677308,0.026236137021619484,60.49647769109017,4.474679685582243,54.35385387702554,16.099030541365167,29.547115581609283,4626316516
1341840600,6.247438,6.262437,6.149939,6.237438,4.375570578947369,6.995346350000001,7.351593,5.292446,7.351593,3.510798,5.579111,6.050773,7.600758,5.955774,5.766495799999997,6.465934610000002,6.11424684,6.079632950000007,6.1531402277971115,6.127215691615788,6.136326384615381,6.655740183170008,5.616912586060754,5.766495799999997,6.465934610000002,6.11424684,6.079632950000007,6.216604666666666,4759832,9061418.4,53.28672600434716,0.5190931515573829,1.5,2.75,NaN,NaN,0.2400386664015651,0.5252855336643544,318.1675408602052,0.04760911990057743,0.08574753689734127,0.03813841699676384,60.16880585899466,9.301984891205104,22.75333653932872,45.198248439492986,32.04841502117829,4621556684
1341927000,6.327436,6.35827,6.008274,6.072439,4.342610394736843,6.989096400000001,7.351593,5.292446,7.351593,5.292446,5.579111,3.510798,7.600758,6.050773,5.777462354999996,6.463784630000004,6.09368036,6.098799400000007,6.149975473765852,6.121998863842856,6.118464461538458,6.629398118630355,5.60753080444656,5.777462354999996,6.463784630000004,6.09368036,6.098799400000007,6.146327666666667,8063504,8795376.4,49.11837741107467,1.508887096299364,1.5,2.75,NaN,NaN,0.24789276165859617,0.9167889619823433,315.04297903525463,0.025115713388990775,0.0695330587330023,0.04441734534401153,53.86524758371602,4.653161548189539,3.089210584556867,81.09323695399024,15.81755246145288,4613493180
1342013400,6.07994,6.129105,5.968274,6.073273,4.309650210526316,6.982846450000001,7.351593,5.292446,7.351593,5.292446,5.579111,3.510798,7.600758,6.050773,5.788058084999997,6.459476340000004,6.07501388,6.108507650000007,6.146967533618171,6.117358305381632,6.133143846153843,6.626782394645376,5.639505297662309,5.788058084999997,6.459476340000004,6.07501388,6.108507650000007,6.056883999999999,11404792,8734398.4,49.14003402133825,1.6997819694879128,1.5,2.75,NaN,NaN,0.24167406439726788,1.3057329741221788,315.79589269623557,0.009348954232274845,0.05610353813435509,0.046754583902080246,53.52756031596919,1.9443247528594938,14.844553233346508,56.27179192302423,28.883654843629262,4624897972
1342099800,5.96494,6.059939,5.859942,5.992023,4.27669002631579,6.976596500000001,7.351593,5.292446,7.351593,5.292446,5.579111,3.510798,7.600758,6.050773,5.796901749999997,6.453997220000003,6.052055780000001,6.120570050000007,6.14089127739785,6.105421609631001,6.132791153846151,6.626825796869894,5.638756510822408,5.796901749999997,6.453997220000003,6.052055780000001,6.120570050000007,5.970634666666666,9260744,8726344.6,47.03947912881072,2.6838228470113203,1.5,2.75,NaN,NaN,0.23964955979746305,1.0612397773060671,312.87435995889484,-0.006634870385497607,0.03846099592020824,0.04509586630570585,52.46414430167796,1.41750389665473,10.56865731460056,63.5349405523725,25.896402133026946,4615637228
1342186200,6.029107,6.299938,6.02494,6.275771,4.243729842105264,6.97034655,7.351593,5.292446,7.351593,5.292446,5.579111,3.510798,7.600758,6.050773,5.806409984999998,6.451297250000003,6.0357392600000015,6.138069900000006,6.146180678284209,6.121645361094715,6.176572769230767,6.608784368109873,5.744361170351661,5.806409984999998,6.451297250000003,6.0357392600000015,6.138069900000006,6.2002163333333336,7550436,8476256,54.37448527596838,1.7958335191940702,1.5,2.75,NaN,NaN,0.24452566266907286,0.8907748892907434,317.8996126447766,0.001391592939303167,0.046835357479834805,0.04544376454053164,58.11260983849956,-1.129054136338816,28.159031705657462,38.80559385372252,33.03537444062002,4623187664
1342445400,6.232437,6.294104,6.166605,6.238271,4.210769657894738,6.9640966,7.351593,5.292446,7.351593,5.292446,5.579111,3.510798,7.600758,6.050773,5.817184874999998,6.448905610000004,6.022222720000001,6.1456115000000064,6.149792063449534,6.13275256479998,6.2100980769230745,6.5848159617939865,5.835380192052162,5.817184874999998,6.448905610000004,6.022222720000001,6.1456115000000064,6.232993333333333,5433736,8168535.2,53.32337328177618,1.3258249654077958,1.5,2.75,NaN,NaN,0.23616661533556768,0.665203230072388,315.84795421180553,0.0035420105314488276,0.049871277704842676,0.04632926717339385,40.44515876160117,-2.4752360706512544,27.810295961141883,39.18037299850214,33.009331040355974,4617753928
1342531800,6.313269,6.402436,6.116605,6.36327,4.177809473684211,6.9578466500000005,7.351593,5.292446,7.351593,5.292446,5.579111,3.510798,7.600758,6.050773,5.828118099999998,6.446755630000005,6.017939460000001,6.155986400000007,6.158163747235827,6.1547066062476015,6.24131569230769,6.593583457117258,5.889047927498122,5.828118099999998,6.446755630000005,6.017939460000001,6.155986400000007,6.294103666666667,9842304,8024845.8,56.35221120572735,2.638996759118748,1.5,2.75,NaN,NaN,0.2397140713830271,1.2264788938374367,318.77459347746577,0.01225894164694298,0.06165294423207257,0.04939400258512959,42.04442153803557,-2.527439130869011,57.21014398649623,14.243702329317133,28.546153684186656,4627596232
1342618200,6.321603,6.541601,6.31077,6.503267,4.144849289473685,6.9515967000000005,7.351593,5.292446,7.351593,5.292446,5.579111,3.510798,7.600758,6.050773,5.841313794999999,6.4456389600000055,6.016139460000001,6.164527850000008,6.171697208128539,6.187902834224021,6.287084461538459,6.607550366853364,5.966618556223554,5.841313794999999,6.4456389600000055,6.016139460000001,6.164527850000008,6.451879333333334,6039048,7837790.4,59.52039056106947,4.029603948690638,1.5,2.75,NaN,NaN,0.2390795662842395,0.7705038909945844,321.603020602212,0.02556387700544055,0.08134884884193028,0.05578497183648973,42.30286321080402,0.9964898832166352,51.06566396073666,18.335284976398448,30.599051062864895,4633635280
1342704600,6.549935,6.619934,6.484102,6.560768,4.111889105263159,6.945346750000001,7.351593,5.292446,7.351593,5.292446,5.579111,3.510798,7.600758,6.050773,5.856563644999999,6.444805640000006,6.017172780000001,6.177334050000008,6.186954886241145,6.2234138023931616,6.3034945384615355,6.6549877316251855,5.9520013452978855,5.856563644999999,6.444805640000006,6.017172780000001,6.177334050000008,6.554934666666667,8717592,7536759,60.7796081815355,4.167796968578906,1.5,2.75,NaN,NaN,0.2317047401210795,1.156676497152158,322.71550600093695,0.035724050601146334,0.10044003508792265,0.06471598448677632,41.67171367975939,4.7220107720157545,83.9434114501452,2.2656851123827617,13.79090343747203,4642352872
1342791000,6.44577,6.469935,6.356603,6.375353,4.078928921052633,6.939096800000001,7.351593,5.292446,7.351593,5.292446,5.579111,3.510798,7.600758,6.050773,5.869682264999998,6.441584840000006,6.016747800000002,6.201979650000007,6.194343047565022,6.237884202165241,6.301859999999997,6.6518002883235905,5.951919711676403,5.869682264999998,6.441584840000006,6.016747800000002,6.201979650000007,6.400630333333333,7630240,7326409,54.854073873974386,1.633038252638493,1.5,2.75,NaN,NaN,0.22973761582671673,1.0414706577260429,319.27279301155306,0.02779678139783133,0.09946196123406548,0.07166517983623415,41.99669221612592,2.211084102158604,55.903860311033014,15.070412684904547,29.02572700406242,4634722632
1343050200,6.094106,6.233271,6.009107,6.186606,4.045968736842106,6.932846850000001,7.351593,5.292446,7.351593,5.292446,5.579111,3.510798,7.600758,6.050773,5.880782154999999,6.437643220000005,6.0117645400000015,6.211479550000008,6.194039633935021,6.23300056386379,6.275578307692305,6.60422710973287,5.94692950565174,5.880782154999999,6.437643220000005,6.0117645400000015,6.211479550000008,6.142994666666667,8136536,7333333.2,49.55745755786866,2.2277472470340802,1.5,2.75,NaN,NaN,0.23948821469623693,1.1095276565368664,314.0735374817184,0.008672219067559495,0.08250545367068352,0.07383323460312402,45.77132188278177,1.8800847567180194,49.72713500911778,19.29632094224532,30.97654404863688,4626586096
1343136600,6.200771,6.203271,5.900774,6.031606,4.01300855263158,6.926596900000001,7.351593,5.292446,7.351593,5.292446,5.579111,3.510798,7.600758,6.050773,5.889961224999999,6.430793280000006,6.004914580000002,6.227729350000008,6.1876696875061965,6.213820129210096,6.244232461538458,6.582118102669952,5.906346820406965,5.889961224999999,6.430793280000006,6.004914580000002,6.227729350000008,6.045217,10584152,7397278.2,45.658507585302594,4.554181989361003,1.5,2.75,NaN,NaN,0.2439888422179343,1.4308170808014222,309.2792858732973,-0.014334159548488351,0.055915535167513575,0.07024969471600193,45.48019407185815,-0.6860715795255761,18.031397004543877,51.496494378314445,30.47210861714168,4616001944
1343223000,6.066606,6.106606,5.929941,6.020773,3.9800483684210533,6.920346950000001,7.351593,5.292446,7.351593,5.292446,5.579111,3.510798,7.600758,6.050773,5.899627794999998,6.424460000000006,6.001814600000002,6.238645900000008,6.1811247193686985,6.195434688332944,6.225450615384612,6.583204892216792,5.867696338552432,5.899627794999998,6.424460000000006,6.001814600000002,6.238645900000008,6.019106666666667,8102780,7251259.6,45.38972697000239,3.222929554173332,1.5,2.75,NaN,NaN,0.23917999634522472,1.117430687490488,310.83227161240836,-0.02933448143717665,0.03358159291953111,0.06291607435670776,45.48110576186263,0.4798045668382865,5.426756769996098,74.47025631963089,20.102986910373023,4607899164
1343309400,6.289937,6.361645,6.203263,6.315769,3.9470881842105268,6.914097000000001,6.560768,5.292446,7.351593,5.292446,5.579111,3.510798,7.600758,6.050773,5.9086818649999975,6.421968350000006,6.006847860000002,6.256562300000008,6.186404887236592,6.206895098967902,6.231476076923074,6.592458979226439,5.870493174619709,5.9086818649999975,6.421968350000006,6.006847860000002,6.256562300000008,6.293558999999999,9444824,7364212,53.42942756553078,1.229919052286175,1.5,2.75,NaN,NaN,0.24644371089199438,1.2825301607286699,314.8353192318981,-0.0189462688873447,0.03923323824752689,0.05817950713487159,52.33692519093611,0.6373400176647721,5.825017454369202,73.48555008838412,20.689432457246692,4617343988
1343395800,6.421602,6.725767,6.391603,6.6741,3.9141280000000007,6.907847050000001,6.560768,5.292446,7.351593,5.292446,5.579111,3.510798,7.600758,6.050773,5.919452584999997,6.426168310000006,6.020481060000003,6.294853650000008,6.205530185776333,6.251390803828102,6.277757692307689,6.6951785032793465,5.860336881336031,5.919452584999997,6.426168310000006,6.020481060000003,6.294853650000008,6.597156666666667,11626940,7496655,60.94983454497105,5.716030331658137,1.5,2.75,NaN,NaN,0.25812616011399475,1.550950390540848,320.313887099722,0.010895492040458019,0.07179887218544412,0.0609033801449861,55.065545234022295,6.986374910612252,27.76170669062106,39.23491348436253,33.00337982501641,4628970928
1343655000,6.648267,6.764092,6.609935,6.6691,3.8811678157894747,6.901597100000001,6.560768,5.292446,7.351593,5.292446,5.579111,3.510798,7.600758,6.050773,5.929569149999997,6.428893290000006,6.039947520000003,6.310936800000008,6.223709394177262,6.291172632034949,6.323590538461535,6.770909663516991,5.876271413406079,5.929569149999997,6.428893290000006,6.039947520000003,6.310936800000008,6.681042333333332,6236892,7530291.4,60.80229106661282,5.031294080291381,1.5,2.75,NaN,NaN,0.2506997915344237,0.8282404582643376,319.313887099722,0.02815423715187694,0.09609617658483227,0.06794193943295533,54.7242928730879,4.8061766984585015,30.47555594964729,36.30420807094181,33.220235979410894,4622734036
1343741400,6.642434,6.6966,6.541601,6.545768,3.848207631578948,6.895347150000001,6.560768,5.292446,7.351593,5.292446,5.579111,3.510798,7.600758,6.050773,5.939181554999998,6.428426630000005,6.060147340000003,6.318395100000008,6.236339143425212,6.315419809936382,6.3661863076923035,6.783557345887252,5.948815269497355,5.939181554999998,6.428426630000005,6.060147340000003,6.318395100000008,6.594656333333333,7092068,7619932.8,57.12868830642263,3.6543757935338887,1.5,2.75,NaN,NaN,0.24386402071053628,0.9307257932773371,317.313887099722,0.0290056187892911,0.1041989629195692,0.0751933441302781,55.78404647190706,0.6535330626898708,34.43119358729934,32.2752971123172,33.293509300383455,4615641968
1343827800,6.670767,6.673267,6.489143,6.522435,3.8152474473684217,6.889097200000001,6.560768,5.292446,7.351593,5.292446,5.579111,3.510798,7.600758,6.050773,5.947489804999998,6.426859990000005,6.073880540000002,6.318103450000008,6.247558588781086,6.3351355423233935,6.385160461538457,6.806770518983533,5.9635504040933816,5.947489804999998,6.426859990000005,6.073880540000002,6.318103450000008,6.561615000000001,22868580,8561768.8,56.43399591676423,2.7450942988438207,1.5,2.75,NaN,NaN,0.2395968763740694,2.6710111583484943,314.86674473624447,0.0258441449240234,0.10749852528530734,0.08165438036128395,54.52081269147965,-0.5842761091384517,18.201723064252313,51.284404814622775,30.513872121124916,4592773388
1343914200,6.359103,6.508269,6.235771,6.379945,3.7822872631578957,6.882847250000001,6.560768,5.292446,7.351593,5.292446,5.579111,3.510798,7.600758,6.050773,5.956556424999998,6.4240351100000055,6.084230600000003,6.315145600000007,6.252750212750455,6.339403109721165,6.396058461538458,6.809155807349431,5.982961115727485,5.956556424999998,6.4240351100000055,6.084230600000003,6.315145600000007,6.374661666666667,11744072,8984095.6,52.255065196628536,0.8865086522071985,1.5,2.75,NaN,NaN,0.24295881377592157,1.3072069268719715,312.1581226394273,0.012669995254174338,0.09749187442900187,0.08482187917482753,55.62482316309293,0.07202738420916607,4.959143768193375,75.6911525208793,19.34970371092732,4581029316
1344000600,6.649934,6.794931,6.637433,6.753265,3.749327078947369,6.876597300000001,6.560768,5.292446,7.351593,5.292446,5.579111,3.510798,7.600758,6.050773,5.9660688199999985,6.421218460000006,6.101597080000002,6.339562000000008,6.2723782436229865,6.378818527842959,6.4260580769230735,6.879907368592904,5.972208785253243,5.9660688199999985,6.421218460000006,6.101597080000002,6.339562000000008,6.728542999999998,10501436,9252025.4,60.50653259471407,4.638136244826843,1.5,2.75,NaN,NaN,0.25524646993478434,1.1350418471613792,316.78971123333605,0.026799616754450556,0.11832140011789072,0.09152178336344016,62.30529147143341,9.159448654076234,4.247510680426768,77.61831613338688,18.134173186186352,4591530752
1344259800,6.809099,6.874099,6.787432,6.794099,3.7163668947368427,6.870347350000001,6.560768,5.292446,7.351593,5.292446,5.579111,3.510798,7.600758,6.050773,5.976752049999998,6.419126830000006,6.119146900000003,6.367395050000008,6.2928378811279675,6.4183690490007725,6.448429769230766,6.942212291516814,5.9546472469447185,5.976752049999998,6.419126830000006,6.119146900000003,6.367395050000008,6.818543333333333,5475256,9287796.6,61.29448873214648,5.146208242719464,1.5,2.75,NaN,NaN,0.2456455792251569,0.5895107565124758,319.31356998804057,0.03602245343540808,0.13654985015770027,0.10052739672229219,58.020335417577975,12.641624801089462,11.014253083023128,62.77748745942478,26.20825945755208,4597006008
1344346200,6.879931,6.981555,6.875764,6.890764,3.6834067105263166,6.864097400000001,6.560768,5.292446,7.351593,5.292446,5.579111,3.510798,7.600758,6.050773,5.987539439999998,6.416885180000006,6.139813360000002,6.4083113000000065,6.316285964220988,6.463359044334032,6.473814076923075,7.019308011569161,5.928320142276989,5.987539439999998,6.416885180000006,6.139813360000002,6.4083113000000065,6.916027666666667,6435820,9206412.4,63.167908803959556,5.4399968536656695,1.5,2.75,NaN,NaN,0.24148918070907427,0.6990584084632142,322.64747798448195,0.04516723764363542,0.15698644377683646,0.11181920613320104,53.63926799396609,14.449822306869894,22.911495695616534,45.0630281425954,32.02547616178805,4603441828
1344432600,6.831598,6.943265,6.821598,6.912431,3.6504465263157906,6.857847450000001,6.560768,5.292446,7.351593,5.292446,5.579111,3.510798,7.600758,6.050773,5.997143514999998,6.414401880000006,6.156646520000004,6.450269200000006,6.339664200918204,6.506127802016505,6.515127769230767,7.104151303485503,5.92610423497603,5.997143514999998,6.414401880000006,6.156646520000004,6.450269200000006,6.892431333333334,8164484,9044397,63.5932703643788,4.431848145008469,1.5,2.75,NaN,NaN,0.23293045351556899,0.9027118115226477,323.1884797652824,0.04889457295286859,0.17293742232428677,0.12404284937141818,53.20436505104971,9.447178957938444,68.57580772194875,8.032327199033466,23.391865079017787,4611606312
1344519000,6.886598,6.979097,6.869931,6.933264,3.617486342105264,6.8515975000000005,6.560768,5.292446,7.351593,5.292446,5.579111,3.510798,7.600758,6.050773,6.005705934999997,6.411393580000006,6.179246300000004,6.497331250000007,6.362942624411607,6.546807439919695,6.572562999999997,7.167828999437869,5.977297000562125,6.005705934999997,6.411393580000006,6.179246300000004,6.497331250000007,6.927430666666667,6227112,8892715.4,64.02348841432436,4.110950972630289,1.5,2.75,NaN,NaN,0.22409013540731407,0.7002486552082843,325.1168858428501,0.04886629861585989,0.18512572264124305,0.13625942402538316,48.75892114952743,3.883130309704682,100,0,0,4617833424
1344605400,6.857431,6.97743,6.819098,6.96743,3.5845261578947376,6.8453475500000005,6.560768,5.292446,7.351593,5.292446,5.579111,3.510798,7.600758,6.050773,6.015993329999997,6.4094936000000065,6.203346060000004,6.531914200000008,6.386648011689584,6.586866731355914,6.644549461538459,7.184500754566672,6.104598168510245,6.015993329999997,6.4094936000000065,6.203346060000004,6.531914200000008,6.921319333333334,6543340,8842360.6,64.75898784037332,3.3264765234645575,1.5,2.75,NaN,NaN,0.21939312573536304,0.7399992259985416,326.0981926057754,0.04722506783080255,0.19529075881388636,0.1480656909830838,39.04827072873743,4.473317239207689,100,0,0,4624376764
1344864600,6.936598,6.970763,6.852431,6.955764,3.5515659736842116,6.8390976000000006,6.560768,5.292446,7.351593,5.292446,5.579111,3.510798,7.600758,6.050773,6.025509904999996,6.407735290000008,6.2360124000000035,6.567788850000008,6.408966285740973,6.6219998045601125,6.716471846153842,7.141836731654674,6.291106960653011,6.025509904999996,6.407735290000008,6.2360124000000035,6.567788850000008,6.926319333333335,7689748,8955161.2,64.2757919375904,2.9025731725007193,1.5,2.75,NaN,NaN,0.2121744738971228,0.8586945369559624,322.84133171572455,0.041626376571699236,0.20009866169770785,0.1584722851260086,39.09558340475423,6.26352782438975,73.47922566269986,5.82764447402969,20.69312986327043,4616687016
1344951000,7.03743,7.050763,6.902431,6.96493,3.518605789473685,6.832847650000001,6.560768,5.292446,7.351593,5.292446,5.579111,3.510798,7.600758,6.050773,6.032438999999997,6.407710290000007,6.269462080000003,6.597871850000009,6.4307687843393655,6.654659823173435,6.766407307692304,7.14130922637536,6.3915053890092475,6.032438999999997,6.407710290000007,6.269462080000003,6.597871850000009,6.972708,8352944,8880693.2,64.49991941027392,2.972010276757973,1.5,2.75,NaN,NaN,0.20761429719018545,0.9405734228044271,323.63505710904394,0.0350752930437076,0.2023164014306431,0.1672411083869355,36.41364422762614,6.784199459251034,75.11122590646241,5.174449938793762,19.714324154743824,4625039960
1345037400,6.943265,7.023263,6.930764,6.982429,3.4856456052631586,6.826597700000001,6.560768,5.292446,7.351593,5.292446,5.579111,3.510798,7.600758,6.050773,6.039468089999997,6.4071352800000065,6.300761760000004,6.621829950000008,6.452402518286841,6.685875935252155,6.7901249230769185,7.1774725554196435,6.4027772907341935,6.039468089999997,6.4071352800000065,6.300761760000004,6.621829950000008,6.978818666666665,6266760,8892078.8,64.95199786735077,2.7234474393468355,1.5,2.75,NaN,NaN,0.19939177596231508,0.7047575871684807,326.67438269212977,0.02872253602091357,0.20314427841307747,0.1744217423921639,35.98191441247486,9.443404292670229,73.62278000755495,5.768774040493781,20.608445951951275,4631306720
1345123800,7.014097,7.166595,6.966598,7.139928,3.4526854210526325,6.820347750000001,6.560768,5.292446,7.351593,5.292446,5.579111,3.510798,7.600758,6.050773,6.049326319999997,6.405276960000008,6.327844820000004,6.650787950000009,6.479364301883436,6.729118989037664,6.826342461538458,7.248165261132072,6.4045196619448435,6.049326319999997,6.405276960000008,6.327844820000004,6.650787950000009,7.091040333333333,9019096,8907154,68.80278531569627,4.104230454322193,1.5,2.75,NaN,NaN,0.19943500625072114,1.0125676506771972,329.66097071681565,0.0316961166948328,0.21404188826070492,0.18234577156587212,31.70854744899297,5.725571260716119,76.02612649277997,4.823755587848646,19.150117919371386,4640325816
1345210200,7.177428,7.184928,7.120762,7.165428,3.4197252368421065,6.814097800000001,6.560768,5.292446,7.351593,5.292446,5.579111,3.510798,7.600758,6.050773,6.061407859999997,6.404315300000008,6.355471200000004,6.690291700000008,6.506268760633105,6.7706722281769345,6.874008615384612,7.298275297253848,6.449741933515376,6.061407859999997,6.404315300000008,6.355471200000004,6.690291700000008,7.1570393333333335,7824160,8916850,69.3892042225192,3.7075022780967997,1.5,2.75,NaN,NaN,0.18977293437566964,0.8774578466610967,331.9730681179913,0.03186327547564943,0.2221748659104339,0.19031159043478446,12.803836351600706,5.465463485298054,77.06298393779892,4.439860537683937,18.497155524517122,4648149976
1345469400,7.138262,7.172429,7.080763,7.169095,3.38676505263158,6.807847850000001,6.560768,5.292446,7.351593,5.292446,5.579111,3.510798,7.600758,6.050773,6.072391084999997,6.404515310000009,6.380440460000004,6.739416150000008,6.532261946490631,6.8086172540648455,6.923751692307689,7.322330828585454,6.525172556029924,6.072391084999997,6.404515310000009,6.380440460000004,6.739416150000008,7.140762333333334,6128904,8816468.4,69.47805469980112,3.114066946195795,1.5,2.75,NaN,NaN,0.18276529620597895,0.695165424740818,330.79729384498404,0.028796706739570188,0.2263074738592472,0.19751076711967702,13.172558591974308,4.03918926841785,100,0,0,4654278880
1345555800,7.22076,7.301926,7.059097,7.104512,3.3538048684210535,6.801597900000001,6.560768,5.292446,7.351593,5.292446,5.579111,3.510798,7.600758,6.050773,6.081676404999996,6.404352810000009,6.408748500000004,6.793061450000008,6.554703125059626,6.83679770605867,6.9794876153846115,7.235418180042039,6.723557050727184,6.081676404999996,6.404352810000009,6.408748500000004,6.793061450000008,7.155178333333333,8671764,8720849,65.85269829336903,2.8058831533374855,1.5,2.75,NaN,NaN,0.1870555607626947,0.9943715342393843,329.8389789974841,0.01944286576883375,0.2218143493307192,0.20237148356188545,14.207340664741517,2.778776381275993,74.06686895910025,5.642138014913287,20.290993025986474,4645607116
1345642200,7.04993,7.143262,6.99993,7.104096,3.3208446842105275,6.795347950000001,6.560768,5.292446,7.351593,5.292446,5.579111,3.510798,7.600758,6.050773,6.091334639999997,6.403577830000009,6.4332482600000045,6.847227600000008,6.576247943684739,6.862254686434035,7.006474615384611,7.233671024394069,6.779278206375152,6.091334639999997,6.403577830000009,6.4332482600000045,6.847227600000008,7.082429333333332,10162420,8823831,65.8288707503574,1.6509692569858787,1.5,2.75,NaN,NaN,0.18393244927964508,1.1517015681737333,326.78003426814644,0.010689301976507137,0.21573311103251935,0.20504380905601222,14.318190995110577,2.463947716400239,42.929725667244014,24.729240369699482,32.341033963056496,4635444696
1345728600,7.059929,7.061597,6.905773,6.943265,3.287884500000001,6.789098000000001,6.560768,5.292446,7.351593,5.292446,5.579111,3.510798,7.600758,6.050773,6.099800804999997,6.399494550000009,6.457098060000005,6.878602400000008,6.590640769422592,6.869969954392698,7.0179489230769185,7.2140177130092145,6.821880133144623,6.099800804999997,6.399494550000009,6.457098060000005,6.878602400000008,6.970211666666667,9548576,8829018.6,57.21020037416257,0.30313312439552415,1.5,2.75,NaN,NaN,0.18496034575967046,1.0814991374012963,323.42187588552474,-0.00749081705385915,0.19568028773868829,0.20317110479254744,20.50199845355122,-0.3468280269769483,15.78825255978359,54.97021087584799,29.241536564368438,4625896120
1345815000,6.884098,7.105762,6.874099,7.061597,3.2549243157894745,6.782848050000001,6.560768,5.292446,7.351593,5.292446,5.579111,3.510798,7.600758,6.050773,6.107863229999997,6.397252920000009,6.479814520000006,6.897977250000008,6.609109641209941,6.888220149212441,7.031089923076919,7.21374039824817,6.848439447905667,6.107863229999997,6.397252920000009,6.479814520000006,6.897977250000008,7.013819333333333,8547672,8675055.2,61.23194931997889,1.0592468183973198,1.5,2.75,NaN,NaN,0.18829624963397973,0.9853161510718688,326.22564319240155,-0.012793682832280356,0.187179001252197,0.19997268408447735,22.566482658817076,1.521515106032919,16.73202748478964,53.555125803849045,29.71284671136132,4634443792
1346074200,7.120762,7.144095,7.036596,7.064929,3.2219641315789485,6.776598100000001,7.169095,5.292446,7.351593,5.292446,5.579111,3.510798,7.600758,6.050773,6.118988114999996,6.397327920000009,6.499364320000005,6.917768700000008,6.626984910182101,6.905049563573161,7.042820538461535,7.212616918759305,6.873024158163765,6.118988114999996,6.397327920000009,6.499364320000005,6.917768700000008,7.081873333333333,7937560,8760088.6,61.34212864604529,1.2328936292466992,1.5,2.75,NaN,NaN,0.18252501751726685,0.9061049907645912,325.14719825720044,-0.017057222707519443,0.17865115570007806,0.1957083784075975,22.49509886280647,1.4357502516177534,18.60641137017798,50.74078934713234,30.652799282689692,4642381352
1346160600,7.009097,7.109096,6.985763,7.04993,3.1890039473684224,6.770348150000001,7.169095,5.292446,7.351593,5.292446,5.579111,3.510798,7.600758,6.050773,6.129471344999996,6.39751959000001,6.517247480000005,6.9429768000000065,6.643570992135744,6.918847700375717,7.051794846153843,7.20937368866152,6.894216003646166,6.129471344999996,6.39751959000001,6.517247480000005,6.9429768000000065,7.0482629999999995,7726420,8791806.2,60.50847746830742,0.8891260143093752,1.5,2.75,NaN,NaN,0.1782970162660335,0.8788205545295119,327.0401677058005,-0.0215767961708771,0.1687373831940011,0.1903141793648782,22.594814355166463,0.9667266219248349,19.513571363616556,49.4858869535374,31.000541682846038,4634654932
1346247000,7.062429,7.117429,7.006597,7.062429,3.156043763157896,6.764098200000001,7.169095,5.292446,7.351593,5.292446,5.579111,3.510798,7.600758,6.050773,6.138579584999997,6.400194570000009,6.531847300000005,6.969976500000007,6.659996796365714,6.9325221098637435,7.059102461538458,7.208976757099496,6.909228165977421,6.138579584999997,6.400194570000009,6.531847300000005,6.969976500000007,7.062151666666667,6270120,7961883.2,60.9843190203822,0.979708145832067,1.5,2.75,NaN,NaN,0.17347808653274535,0.7875172044724293,329.3706257042975,-0.02421588701521374,0.16004432059586104,0.18426020761107478,22.58331733323782,-1.0854311135910675,44.60866193609668,23.25799296125183,32.13334510265147,4640925052
1346333400,6.964098,6.970763,6.860765,6.905764,3.1230835789473694,6.757848250000001,7.169095,5.292446,7.351593,5.292446,5.579111,3.510798,7.600758,6.050773,6.147562824999997,6.404865850000009,6.543869700000005,6.9962674500000075,6.66963472592,6.9299737184481485,7.0552563076923045,7.217589325319431,6.892923290065178,6.147562824999997,6.404865850000009,6.543869700000005,6.9962674500000075,6.9124306666666655,7705516,7759955.4,52.453100797739566,1.2267654920416347,1.5,2.75,NaN,NaN,0.17549136606612067,0.9929845730814381,326.16687789899197,-0.03627844065917263,0.138912156787109,0.17519059744628163,21.822612871856,-3.6238449398975296,48.61922001766098,20.153285311447405,31.22749467089161,4633219536
1346419800,7.025763,7.100763,6.886598,6.983264,3.0901233947368434,6.751598300000001,7.169095,5.292446,7.351593,5.292446,5.579111,3.510798,7.600758,6.050773,6.1565669049999965,6.408832490000009,6.565886160000004,7.007767400000008,6.681933913138823,6.935048983357849,7.056666615384613,7.216129388385883,6.897203842383344,6.1565669049999965,6.408832490000009,6.565886160000004,7.007767400000008,6.9902083333333325,9834768,7726622,55.750811726068896,0.1295382671815493,1.5,2.75,NaN,NaN,0.17825376848996916,1.272841870613057,330.2764872343046,-0.0385885500761817,0.1269549098510545,0.1655434599272362,23.096085453284783,-2.592112393544796,50.367707338811435,18.873763332127638,30.75852932906092,4643054304
1346765400,6.988263,7.04743,6.849098,6.96993,6.849098,6.745348350000001,7.169095,5.292446,7.351593,5.292446,5.579111,3.510798,7.600758,6.050773,6.1667209699999965,6.409849140000009,6.585352600000005,7.016558950000008,6.693227877329457,6.938370984942815,7.055705153846152,7.217085947208829,6.894324360483476,6.1667209699999965,6.409849140000009,6.585352600000005,7.016558950000008,6.9554860000000005,8530332,7879375.8,55.043453368849114,0.5175629731232825,1.5,2.75,NaN,NaN,0.17968792788354282,1.0826151990364516,332.10122566204444,-0.040373779198994625,0.11507623592849292,0.15545001512748755,23.01951341628735,-1.8943173014557506,22.039685940115312,46.1072889988334,31.853025061051298,4634523972
1346851800,6.994096,7.041596,6.926597,6.961596,6.8753867968749995,6.739098400000001,7.169095,5.292446,7.351593,5.292446,5.579111,3.510798,7.600758,6.050773,6.178062514999997,6.413174100000009,6.610452320000004,7.020100550000009,6.703752117434185,6.940582891138738,7.041987307692306,7.20271539685464,6.881259218529972,6.178062514999997,6.413174100000009,6.610452320000004,7.020100550000009,6.976596333333333,7149128,7915041.2,54.5773540167202,0.2985223874246783,1.5,2.75,NaN,NaN,0.17506729017757547,0.9032332011108167,332.2265934902059,-0.04132533053279966,0.10379335196148798,0.14511868249428764,22.68106516074596,-2.0058850556073575,22.828020078401888,45.107636699394654,32.064343222203455,4627374844
1346938200,7.086595,7.389093,7.086595,7.382426,6.901675593749999,6.732848450000001,7.169095,5.292446,7.351593,5.292446,5.579111,3.510798,7.600758,6.050773,6.1916123749999965,6.42098235000001,6.642052000000004,7.04360030000001,6.730366779495589,6.982663187220763,7.05867946153846,7.294670119959332,6.822688803117587,6.1916123749999965,6.42098235000001,6.642052000000004,7.04360030000001,7.286038000000001,9960384,8004836.2,68.89882217531107,4.339856396400264,1.5,2.75,NaN,NaN,0.19309798373632006,1.244295792086289,336.900991847214,-0.014222034224010666,0.1273411397142743,0.14156317393828496,41.62925832265931,6.324992636749417,29.740237023803278,37.078311705829925,33.1814512703668,4637335228
1347024600,7.424092,7.478259,7.405759,7.478259,6.927964390624999,6.7265985000000015,7.169095,5.292446,7.351593,5.292446,5.579111,3.510798,7.600758,6.050773,6.206916394999996,6.426782300000009,6.672468360000003,7.0708500500000095,6.759695886182037,7.029862788437833,7.082461307692305,7.404713276751764,6.760209338632846,6.206916394999996,6.426782300000009,6.672468360000003,7.0708500500000095,7.454092333333334,6431236,8015042.4,71.13105314118604,4.6846886944078285,1.5,2.75,NaN,NaN,0.18615048489801153,0.802395755261382,339.86151644301674,0.00833656310092562,0.151983877814442,0.14364731471351638,38.145962754596596,5.900393352948356,53.32187959732895,16.784805750403866,29.893314652267176,4643766464
1347283800,7.454092,7.489925,7.34076,7.349927,6.9542531875,6.720348550000001,7.169095,5.292446,7.351593,5.292446,5.579111,3.510798,7.600758,6.050773,6.221862079999997,6.431957240000008,6.7013014400000035,7.08997490000001,6.782842204370977,7.060345094300897,7.101339384615382,7.453877119796291,6.748801649434472,6.221862079999997,6.431957240000008,6.7013014400000035,7.08997490000001,7.393537333333334,4384936,7907122.2,64.4591263914821,3.5433200606891724,1.5,2.75,NaN,NaN,0.18350866454815357,0.5545552337612791,337.9855154182406,0.012539384876839532,0.1593215458095658,0.14678216093272628,40.036125736134935,4.033982507113658,30.86534644323431,36.05038622755868,33.084267329207,4639381528
1347370200,7.366592,7.479092,7.357426,7.41326,6.980541984375,6.714098600000001,7.169095,5.292446,7.351593,5.292446,5.579111,3.510798,7.600758,6.050773,6.238599419999996,6.438915510000008,6.722617900000002,7.112849700000011,6.807564470866232,7.093956037700812,7.125121230769228,7.514935252915216,6.735307208623239,6.238599419999996,6.438915510000008,6.722617900000002,7.112849700000011,7.416592666666666,5783060,7811787.8,66.14673737200967,3.2734101070342914,1.5,2.75,NaN,NaN,0.1796269742232854,0.7402991668565293,341.46993451912215,0.01721987602778685,0.16830700596745984,0.151087129939673,40.04488421125387,5.1536681924501435,59.73789047432982,12.81748381003736,27.44462571563283,4645164588
1347456600,7.481592,7.507425,7.404926,7.474925,7.00683078125,6.707848650000001,7.169095,5.292446,7.351593,5.292446,5.579111,3.510798,7.600758,6.050773,6.255762579999996,6.446290430000008,6.744184360000003,7.138349450000011,6.833735472008733,7.13023879601502,7.166018153846151,7.581636835859694,6.750399471832608,6.255762579999996,6.446290430000008,6.744184360000003,7.138349450000011,7.462425333333333,6892376,7738759.4,67.7523320353678,3.219022546245056,1.5,2.75,NaN,NaN,0.17411783320733645,0.890630609345472,344.79227927599857,0.02180870656479622,0.17834801314566828,0.15653930658087206,39.83046579659202,5.840710044660272,86.45087574161359,1.66167471459338,11.887449543793032,4652056964
1347543000,7.480759,7.894922,7.447426,7.833255,7.0331195781249995,6.701598700000001,7.169095,5.292446,7.351593,5.292446,5.579111,3.510798,7.600758,6.050773,6.272962409999995,6.458981970000008,6.770284100000002,7.180890750000012,6.872932316243685,7.197192720204066,7.225376461538458,7.766002397119181,6.6847505259577344,6.272962409999995,6.458981970000008,6.770284100000002,7.180890750000012,7.725201000000001,15951636,8223003.2,75.13289816074496,6.253407563776625,1.5,2.75,NaN,NaN,0.19364484512109814,1.9398795807351747,349.1978542565307,0.04498229270807469,0.21276717246596544,0.16778487975789075,46.03234916392218,13.430679067515205,88.99910069090949,1.1160685977630416,9.884830711327478,4668008600
1347629400,7.869921,8.069086,7.853256,7.932421,7.059408374999999,8.069086,7.169095,5.292446,7.351593,5.292446,5.579111,3.510798,7.600758,6.050773,6.290495569999996,6.471956840000007,6.800150480000002,7.2205154000000125,6.9144808920772665,7.267214461137012,7.292106615384611,7.940460513061603,6.64375271770762,6.290495569999996,6.471956840000007,6.800150480000002,7.2205154000000125,7.951587666666667,17302108,8637153.8,76.72080024434605,6.976357784061483,1.5,2.75,NaN,NaN,0.19665814189816258,2.0032186991969505,352.76000092516875,0.06194788117094485,0.2452197312215718,0.18327185005062696,41.031136550581195,13.591881962360288,91.71350262615326,0.6469108856703595,7.639586488176391,4685310708
1347888600,7.879921,7.920754,7.789089,7.853256,7.085697171874999,8.077296442105263,7.169095,5.292446,7.351593,5.292446,5.579111,3.510798,7.600758,6.050773,6.304870429999997,6.481290100000007,6.831916860000002,7.254906800000012,6.951295602191883,7.323027941028725,7.353900923076919,8.049552730067683,6.658249116086155,6.304870429999997,6.481290100000007,6.831916860000002,7.254906800000012,7.854366333333334,6691996,8580545.6,72.72819425300851,4.9809126535205,1.5,2.75,NaN,NaN,0.19284913176257953,0.7799033199007765,348.69040096502323,0.06261119321688308,0.2615358415717308,0.19892464835484774,43.27615184416746,12.673384094244854,86.8701065074643,1.5756876365715766,11.554205855964131,4678618712
1347975000,7.814089,7.858255,7.769923,7.828255,7.11198596875,8.085506884210528,7.169095,5.292446,7.351593,5.292446,5.579111,3.510798,7.600758,6.050773,6.319124454999995,6.488990020000006,6.863733200000002,7.287864800000013,6.985686166811809,7.371144803787894,7.412810615384611,8.129151424514557,6.696469806254664,6.319124454999995,6.488990020000006,6.863733200000002,7.287864800000013,7.818810999999999,6072576,8577729.2,71.4633543029507,3.876446704742059,1.5,2.75,NaN,NaN,0.18538362235096667,0.7079468071806231,346.5977207828579,0.05633569868748167,0.26934427171419983,0.21300857302671816,43.429157644401464,12.449142409298101,72.83656625911584,6.191427327003512,20.972006413880628,4672546136
1348061400,7.854088,7.914487,7.792421,7.844088,7.138274765625,8.09371732631579,7.169095,5.292446,7.351593,5.292446,5.579111,3.510798,7.600758,6.050773,6.333470144999995,6.496423270000007,6.8991661800000035,7.324843600000013,7.019348983799581,7.416187012950952,7.48498938461538,8.17086789909468,6.79911087013608,6.333470144999995,6.496423270000007,6.8991661800000035,7.324843600000013,7.850332,6080316,8448156.8,71.7978613930631,4.106600211657055,1.5,2.75,NaN,NaN,0.18086093504018336,0.7197210165417384,348.773793878516,0.04851759644815612,0.2736555685869133,0.2251379721387572,43.12086646177381,6.25352695712765,72.5372139764184,6.319150838424227,21.143635185157372,4678626452
1348147800,7.731589,7.853921,7.670757,7.836587,7.1645635625,8.101927768421053,7.169095,5.292446,7.351593,5.292446,5.579111,3.510798,7.600758,6.050773,6.347024174999996,6.504723170000006,6.934432460000003,7.361468150000013,7.0513975334545,7.456225106955624,7.55062961538461,8.193884690276265,6.907374540492953,6.347024174999996,6.504723170000006,6.934432460000003,7.361468150000013,7.787088333333333,9291836,8404627.6,71.37102154741105,2.7477847443380825,1.5,2.75,NaN,NaN,0.18102543968017024,1.10556189306948,345.97972548604275,0.038542752635785854,0.2733164129334895,0.23477366029770366,31.49891919011208,4.791596546736337,38.854595632124415,28.36174010468278,32.78366426319278,4669334616
1348234200,7.955754,7.960754,7.823255,7.825755,7.190852359375,8.110138210526316,7.932421,5.292446,7.351593,5.292446,5.579111,3.510798,7.600758,6.050773,6.360499034999996,6.511581440000006,6.971107100000003,7.405592650000012,7.081764492926872,7.491418430102708,7.616462307692302,8.17857815039947,7.054346464985134,6.360499034999996,6.511581440000006,6.971107100000003,7.405592650000012,7.869921333333333,8557848,8355091.2,70.71720978133008,3.020637623828568,1.5,2.75,NaN,NaN,0.1779164082744438,1.024267455033884,348.91598528749455,0.02743857941592126,0.2690718845676052,0.24163330515168396,31.41587153016055,6.4739146388800854,3.750477209169287,79.22608658144634,17.02343620938437,4660776768
1348493400,7.715756,7.844922,7.69609,7.794089,7.217141156249999,8.11834865263158,7.932421,5.292446,7.351593,5.292446,5.579111,3.510798,7.600758,6.050773,6.373615569999996,6.518606360000006,7.001473460000002,7.442217250000013,7.109698787321897,7.520244198664354,7.680500230769225,8.101600056389382,7.25940040514907,6.373615569999996,6.518606360000006,7.001473460000002,7.442217250000013,7.778367,9326696,8394042.4,68.73487409207446,1.8123276453930932,1.5,2.75,NaN,NaN,0.175838950540555,1.1111089932068963,346.277073500093,0.014816548230426246,0.26015399043971676,0.24533744220929052,28.865769984754962,5.137132651492047,3.0504590871074577,81.27496612302514,15.674574789867407,4651450072
1348579800,7.842422,7.884921,7.539225,7.561592,7.243429953124999,8.126559094736843,7.932421,5.292446,7.351593,5.292446,5.579111,3.510798,7.600758,6.050773,6.387248769999997,6.525081300000006,7.027939880000003,7.467050400000012,7.1274200897798625,7.524182084505845,7.694282230769226,8.08617236830988,7.302392093228572,6.387248769999997,6.525081300000006,7.027939880000003,7.467050400000012,7.661912666666667,10604984,8527413.6,56.26412640409711,0.2778904132182872,1.5,2.75,NaN,NaN,0.18797159693051538,1.243634294928535,343.1936377933568,-0.010945514343130347,0.23165554928037757,0.24260106362350792,35.38990199436897,1.1594363823048428,2.4667522194645635,83.26626692338871,14.266980857146734,4640845088
1348666200,7.542424,7.543258,7.364594,7.420759,7.269718749999999,8.134769536842105,7.932421,5.292446,7.351593,5.292446,5.579111,3.510798,7.600758,6.050773,6.398961149999996,6.533514560000006,7.049089660000002,7.485591850000013,7.138923576455162,7.5143322669338595,7.689859153846149,8.092551135503324,7.287167172188975,6.398961149999996,6.533514560000006,7.049089660000002,7.485591850000013,7.442870333333334,12507124,8766448.8,50.309713393634375,2.2924078147527185,1.5,2.75,NaN,NaN,0.18861634000690713,1.4267035929075407,340.4651868693993,-0.03771827475869788,0.19545322017513556,0.23317149493383343,36.99736504143115,-5.265959042569149,0,100,0,4628337964
1348752600,7.512424,7.674924,7.454926,7.629924,7.296007546875,8.142979978947368,7.932421,5.292446,7.351593,5.292446,5.579111,3.510798,7.600758,6.050773,6.412852679999998,6.543881130000005,7.071622800000003,7.513966600000012,7.158178495025548,7.525341003416349,7.711397384615381,8.06615859043095,7.356636178799813,6.412852679999998,6.543881130000005,7.071622800000003,7.513966600000012,7.586591333333334,8101808,8858033.2,57.503106961584955,0.6527708378298125,1.5,2.75,NaN,NaN,0.19329838714927086,0.9146283172657335,344.49524633674525,-0.04129902638164071,0.18154771195678254,0.22284673833842325,28.76187620509657,-3.813425938940959,3.4841494957573342,79.90575298247114,16.610097521771515,4636439772
1348839000,7.538259,7.609925,7.440758,7.518258,7.32229634375,8.151190421052632,7.932421,5.292446,7.351593,5.292446,5.579111,3.510798,7.600758,6.050773,6.426948369999998,6.5539726900000055,7.090772600000003,7.544591300000012,7.172299259926507,7.5246664316624114,7.719474153846151,8.050718565078746,7.388229742613556,6.426948369999998,6.5539726900000055,7.090772600000003,7.544591300000012,7.522980333333333,17721308,9358822.8,53.084863405488676,1.02709717962528,1.5,2.75,NaN,NaN,0.19300321663860867,1.8935402858573194,341.626637673534,-0.050536323345481804,0.159676334156571,0.2102126575020528,27.73284912396222,-4.265721122550947,2.4714371126135255,83.2494800102298,14.279082877156672,4618718464
1349098200,7.604923,7.785755,7.526592,7.566591,7.348585140625,8.159400863157895,7.932421,5.292446,7.351593,5.292446,5.579111,3.510798,7.600758,6.050773,6.4420898799999975,6.565672580000005,7.114597360000002,7.573757650000012,7.18776168110586,7.528659247694563,7.726525384615382,8.040076708778809,7.412974060451954,6.4420898799999975,6.565672580000005,7.114597360000002,7.573757650000012,7.626312666666666,15245924,9629380.6,54.70703419798259,0.40855683210756866,1.5,2.75,NaN,NaN,0.19832420116442231,1.5832715138500186,344.4277363590775,-0.0525088540762359,0.14457658990675792,0.19708544398299382,28.31722079927772,-3.3425584629013816,17.52461558081991,52.223295723766356,30.252088695413736,4633964388
1349184600,7.667422,7.699922,7.494925,7.600758,7.374873937499999,8.167611305263158,7.932421,5.292446,7.351593,5.292446,5.579111,3.510798,7.600758,6.050773,6.457102234999997,6.577322470000005,7.142880400000003,7.605299050000012,7.20395761518014,7.535525795533176,7.708640999999998,8.02232387039767,7.394958129602326,6.457102234999997,6.577322470000005,7.142880400000003,7.605299050000012,7.598534999999999,9663264,9686027.2,55.868691888272245,0.562916916713747,1.5,2.75,NaN,NaN,0.19880082965267784,0.9976498930335443,345.5551351516009,-0.050608929479394466,0.13382428213375075,0.18443321161314521,28.71041076198802,-3.102081465684733,36.86983028702148,29.91782410528951,33.212345607689016,4643627652
1349271000,7.659923,7.744088,7.540759,7.68909,7.401162734374999,8.175821747368422,7.932421,5.292446,7.351593,5.292446,5.579111,3.510798,7.600758,6.050773,6.472435414999998,6.590472330000004,7.176030080000003,7.641673750000012,7.22298241458484,7.55015095786335,7.689923230769228,7.975763533162181,7.404082928376275,6.472435414999998,6.590472330000004,7.176030080000003,7.641673750000012,7.657979,8552640,9756202.8,58.80996575945628,0.8483709716461033,1.5,2.75,NaN,NaN,0.19912427039177222,0.8766361437259176,345.00835450804726,-0.04280939034388506,0.13092147368328888,0.17373086402717394,29.811658579435573,-1.882158648911823,62.59891762997595,11.073116019954789,26.327966350069268,4652180292
1349357400,7.783255,7.883255,7.749173,7.868255,7.42745153125,8.184032189473685,7.932421,5.292446,7.351593,5.292446,5.579111,3.510798,7.600758,6.050773,6.4894227499999975,6.607397160000004,7.212979720000002,7.665965200000012,7.248287221856023,7.580446580923983,7.691076999999997,7.979653093717461,7.402500906282533,6.4894227499999975,6.607397160000004,7.212979720000002,7.665965200000012,7.8335609999999996,6705352,9593451.2,64.0444552339236,2.6132133409147875,1.5,2.75,NaN,NaN,0.1987700367923599,0.6989509677184786,348.6173282344721,-0.025826630722082716,0.14144757562457055,0.16727420634665327,33.10588487954223,0.5430785911391351,61.71143669572775,11.568989712723322,26.71957359154893,4658885644
1349443800,7.979919,8.020736,7.789089,7.853256,7.453740328125,8.020736,7.932421,5.292446,7.351593,5.292446,5.579111,3.510798,7.600758,6.050773,6.504330934999998,6.625288660000003,7.243729460000002,7.684715050000011,7.272011487665591,7.606428430359794,7.693000153846151,7.985513753608725,7.400486554083578,6.504330934999998,6.625288660000003,7.243729460000002,7.684715050000011,7.887693666666666,6667132,9605246,63.319000955319865,2.6960986875557484,1.5,2.75,NaN,NaN,0.2011183913071913,0.6941136124988365,351.0646221097204,-0.01631049949195912,0.1468860819817044,0.1631965814736635,33.11758829201795,0.7591265637331113,83.39551763091916,2.414482741393772,14.189999627687062,4652218512
1349703000,7.765756,7.815754,7.725757,7.775748,7.480029125,8.017512666666667,7.932421,5.292446,7.351593,5.292446,5.579111,3.510798,7.600758,6.050773,6.518664084999998,6.643121740000003,7.265762420000002,7.70600610000001,7.2917658606983125,7.622554103658861,7.687743230769229,7.971533012291943,7.403953449246514,6.518664084999998,6.643121740000003,7.265762420000002,7.70600610000001,7.772419666666667,3975948,9584796.6,59.564234053615905,1.1462577339950724,1.5,2.75,NaN,NaN,0.19585986335667765,0.4148181923860544,348.5169987828951,-0.015925161028814777,0.14329013018764503,0.1592152912164598,33.56975828240599,2.832154921873595,62.158796280576,11.322559121637155,26.518644597786842,4648242564
1349789400,7.759922,7.777422,7.538259,7.547425,7.506317921875,8.014289333333332,7.932421,5.292446,7.351593,5.292446,5.579111,3.510798,7.600758,6.050773,6.531151459999998,6.661638220000003,7.2833289200000015,7.71271435000001,7.301791709298379,7.615398950929445,7.665499999999999,7.944424815602285,7.386575184397713,6.531151459999998,6.661638220000003,7.2833289200000015,7.71271435000001,7.621035333333333,6396744,9615480.8,50.133147811791055,1.1301285634000557,1.5,2.75,NaN,NaN,0.19895294454548634,0.6652547213239716,344.2743580957758,-0.030871390963489176,0.12062605251209835,0.15149744347558752,33.413487183335114,1.7069143466321879,30.448622676638387,36.31285277901073,33.23852454435089,4641845820
1349875800,7.546591,7.558258,7.374176,7.406593,7.532606718749999,8.011066,7.932421,5.292446,7.351593,5.292446,5.579111,3.510798,7.600758,6.050773,6.5423555099999975,6.680346380000003,7.300545420000001,7.709297750000009,7.305901563835698,7.595512669888546,7.633256769230768,7.927134270656792,7.339379267804745,6.5423555099999975,6.680346380000003,7.300545420000001,7.709297750000009,7.446342333333334,6572944,9599509.2,45.36218045802805,2.98914032856896,1.5,2.75,NaN,NaN,0.19789073422080874,0.684716672806564,343.1040738493676,-0.04898981150771156,0.09026017909094808,0.13924999059865964,33.42070829278,-2.9270409508666133,6.386959842658231,72.15422656101548,21.458813596326284,4635272876
1349962200,7.557424,7.588257,7.41326,7.41326,7.558895515624999,8.007842666666665,7.932421,5.292446,7.351593,5.292446,5.579111,3.510798,7.600758,6.050773,6.553542899999997,6.696121230000004,7.318361920000001,7.6882980000000085,7.310111698587239,7.5781552727563035,7.603962230769229,7.903735640697105,7.304188820841352,6.553542899999997,6.696121230000004,7.318361920000001,7.6882980000000085,7.471592333333334,6951248,9149489.8,45.62598765746058,2.077901696456524,1.5,2.75,NaN,NaN,0.19673168177646524,0.7597415978320452,346.1603230768782,-0.05862200284076817,0.06597248704769942,0.1245944898884676,28.37367684998765,-1.3965735147689817,6.141823423207521,72.73122482785737,21.126951748935117,4642224124
1350048600,7.423259,7.499925,7.292426,7.334092,7.585184312499999,8.004619333333332,7.932421,5.292446,7.351593,5.292446,5.579111,3.510798,7.600758,6.050773,6.565276104999998,6.710837730000004,7.337444860000001,7.6583815500000085,7.31105210256421,7.554911151541417,7.586462230769229,7.918871511036009,7.254052950502448,6.565276104999998,6.710837730000004,7.337444860000001,7.6583815500000085,7.375481000000001,6472960,8608032.4,42.9726684057537,2.943391053947013,1.5,2.75,NaN,NaN,0.19750077593528917,0.751967429862369,343.8158822314531,-0.06777443249502889,0.03987644926968148,0.10765088176471037,27.85034788583328,-3.0727047358579287,6.4286744770899755,72.05705184276442,21.514273680145596,4635751164
1350307800,7.393259,7.541591,7.324926,7.517008,7.611473109375,8.001396,7.932421,5.292446,7.351593,5.292446,5.579111,3.510798,7.600758,6.050773,6.577232239999998,6.727158400000004,7.35271972,7.641569150000009,7.3191288044244365,7.551301327585092,7.593865999999998,7.9152885569242,7.272443443075795,6.577232239999998,6.727158400000004,7.35271972,7.641569150000009,7.461175000000001,6551296,8600997.4,50.18135067259896,1.2650796310588568,1.5,2.75,NaN,NaN,0.19886964908276858,0.7616902662939998,346.81761784050775,-0.05926631109239561,0.03356799289921586,0.09283430399161147,31.670661481754923,-1.1018637877959043,21.971961328424257,46.18039096169709,31.847647709878654,4642302460
1350394200,7.62659,7.765756,7.612425,7.749923,7.63776190625,7.998172666666665,7.932421,5.292446,7.351593,5.292446,5.579111,3.510798,7.600758,6.050773,6.590632109999999,6.745491550000004,7.371836200000001,7.637652550000008,7.336022694447007,7.570217677338893,7.603096692307689,7.934857231233802,7.271336153381577,6.590632109999999,6.745491550000004,7.371836200000001,7.637652550000008,7.709368000000001,5924732,8593605.2,57.541229919359736,1.8656425117105475,1.5,2.75,NaN,NaN,0.20243238843399938,0.6894349766033003,351.28828245611726,-0.03680900892742059,0.04682304283233574,0.08363205175975633,36.376944469238865,0.7911599422038198,47.560799654379224,20.90988496639475,31.529315379226027,4648227192
1350480600,7.770756,7.874089,7.729922,7.850756,7.664050703125,7.994949333333333,7.932421,5.292446,7.351593,5.292446,5.579111,3.510798,7.600758,6.050773,6.603411159999999,6.765424700000004,7.39103604,7.637985950000008,7.356208314272615,7.596935612830427,7.628673461538459,7.980960378573743,7.2763865445031755,6.603411159999999,6.765424700000004,7.39103604,7.637985950000008,7.818255666666666,7185032,8648841,60.277183281343234,2.870558762157751,1.5,2.75,NaN,NaN,0.19827057497442796,0.8307508485819083,354.57584702705435,-0.015131148884890533,0.06471811565364316,0.07984926453853369,36.51753115432616,-0.22240001118419292,77.38161035869017,4.325921007303923,18.292468634005917,4655412224
1350567000,7.794921,7.904921,7.717423,7.795755,7.690339499999999,7.991725999999999,7.932421,5.292446,7.351593,5.292446,5.579111,3.510798,7.600758,6.050773,6.615865199999999,6.782674520000004,7.408702519999999,7.635944350000008,7.373445439203101,7.615870792560862,7.646301461538458,8.007226358560297,7.2853765645166195,6.615865199999999,6.782674520000004,7.408702519999999,7.635944350000008,7.806032999999999,8878264,8628162.4,58.078760577061644,2.0416949310385974,1.5,2.75,NaN,NaN,0.19750110533339735,1.0289866588510201,353.71353052855176,-0.004988692183138091,0.07361339930961108,0.07860209149274917,34.21391449818014,-0.7321931183702689,41.92856884798882,25.426651128761502,32.64478002324967,4646533960
1350653400,7.74659,7.74659,7.350761,7.400759,7.716628296874999,7.988502666666665,7.932421,5.292446,7.932421,5.292446,7.351593,3.510798,5.579111,6.050773,6.626035935,6.798649360000004,7.418052419999999,7.614694550000008,7.374516559234352,7.595383955174114,7.63091692307692,8.014626364597824,7.247207481556016,6.626035935,6.798649360000004,7.418052419999999,7.614694550000008,7.499370000000001,8950360,8647788,45.30058487637204,2.6123971281911116,1.5,2.75,NaN,NaN,0.21517916923815464,1.034988369280098,348.76811418034174,-0.024294403528498307,0.04823408708212629,0.0725284906106246,45.063060282895925,-4.822545689495084,36.75161184906787,30.032390969114477,33.215997181817656,4637583600
1350912600,7.367426,7.444092,7.229094,7.405759,7.742917093749999,7.985279333333332,7.932421,5.292446,7.932421,5.292446,7.351593,3.510798,5.579111,6.050773,6.63641499,6.815082530000004,7.426818999999999,7.595278050000007,7.3757417529898675,7.577324435633722,7.609122230769229,8.008985250350957,7.209259211187501,6.63641499,6.815082530000004,7.426818999999999,7.595278050000007,7.359648333333333,8801080,8621507.2,45.464151834643424,3.5261721023333763,1.5,2.75,NaN,NaN,0.2151662285782865,1.0208284695279266,348.04753748821884,-0.035463436693766226,0.02819919474341681,0.06366263143718304,45.13022191067326,-1.8770110335644257,39.66101647338923,27.407123222497635,32.93186030411313,4646384680
1350999000,7.167427,7.191595,7.005764,7.089929,7.769205890624999,7.982055999999998,7.932421,5.292446,7.932421,5.292446,7.351593,3.510798,5.579111,6.050773,6.64506907,6.832757350000004,7.429502299999999,7.571694900000009,7.364533409735363,7.530905822716225,7.549250999999997,8.005137758922228,7.093364241077768,6.64506907,6.832757350000004,7.429502299999999,7.571694900000009,7.095762666666667,11017380,8642127,37.77930937605641,5.870129998606625,1.5,2.75,NaN,NaN,0.22836828367983744,1.2748458799552471,343.33331638638083,-0.06134085117180823,-0.013013432527577251,0.04832741864423098,48.4753553982536,-4.275434062598016,16.49110189834334,53.76610535015305,29.742792751503607,4635367300
1351085400,7.174095,7.197428,7.00243,7.038264,7.7954946875,7.978832666666666,7.932421,5.292446,7.932421,5.292446,7.351593,3.510798,5.579111,6.050773,6.652685669999999,6.850215530000003,7.43096898,7.552570150000008,7.351738530922211,7.483987553886108,7.486559307692304,7.980539015020377,6.992579600364231,6.652685669999999,6.850215530000003,7.43096898,7.552570150000008,7.0793740000000005,8468928,8440217.2,36.6868530783627,5.440443915610489,1.5,2.75,NaN,NaN,0.2259846919884205,1.003401666013998,341.71247751589806,-0.07808245591046738,-0.04927565124385325,0.02880680466661413,47.82923627667759,-5.05844931919291,4.190113729816622,77.77789769444094,18.031988575742453,4626898372
1351171800,7.187428,7.22326,6.970763,7.101596,7.821783484375,7.975609333333332,7.932421,5.292446,7.932421,5.292446,7.351593,3.510798,5.579111,6.050773,6.660502254999999,6.867057040000003,7.433352319999999,7.526153750000009,7.3419290199056535,7.447569310658859,7.434701461538459,7.937817419843601,6.9315855032333165,6.660502254999999,6.867057040000003,7.433352319999999,7.526153750000009,7.0985396666666665,12289524,8649603,39.014866550764935,4.642947867985297,1.5,2.75,NaN,NaN,0.2278784282749619,1.4208194295160137,343.79255748389625,-0.0807034839124203,-0.07207255022391124,0.008630933688509056,48.41762186393398,-3.170072041637878,23.446247807428996,44.34566793231005,32.20808426026094,4639187896
1351258200,7.078263,7.156263,6.939931,7.08243,7.8480722812499994,7.972385999999998,7.932421,5.292446,7.932421,5.292446,7.351593,3.510798,5.579111,6.050773,6.668064684999998,6.880023590000004,7.432202359999999,7.504362350000008,7.331752587752491,7.412794138215158,7.398932615384613,7.930234259753082,6.867630971016144,6.668064684999998,6.880023590000004,7.432202359999999,7.504362350000008,7.059541333333334,9555584,8241316.8,38.552867336463905,4.109964715178744,1.5,2.75,NaN,NaN,0.22705368339817894,1.1594729618936626,341.4432531678846,-0.07941749942308804,-0.090640940590351,-0.011223441167262958,48.24614467330379,-5.781262970586171,23.24767044245293,44.591982395171925,32.16034716237514,4629632312
1351690200,7.162428,7.183262,6.983264,7.051596,7.874361078124999,7.969162666666665,7.932421,5.292446,7.932421,5.292446,7.351593,3.510798,5.579111,6.050773,6.675827099999998,6.8926984600000045,7.429925719999999,7.478612600000008,7.320766054899452,7.378394315528,7.371625153846152,7.934120869309819,6.8091294383824845,6.675827099999998,6.8926984600000045,7.429925719999999,7.478612600000008,7.072707333333334,5455828,7751812,37.77781502705733,3.33542507971664,1.5,2.75,NaN,NaN,0.2251211345840233,0.7038132503729451,343.79088253308765,-0.07631370458327848,-0.10661557189636106,-0.03030186731308258,44.81662862482221,-9.010760494007487,8.632902023979959,67.26888366854025,24.098214307479807,4624176484
1351776600,7.131595,7.32826,7.108262,7.307427,7.900649874999999,7.965939333333331,7.932421,5.292446,7.932421,5.292446,7.351593,3.510798,5.579111,6.050773,6.684668679999998,6.906566410000005,7.432692359999999,7.463946050000007,7.320242954707316,7.3716355235729525,7.363484153846152,7.926397182601638,6.800571125090666,6.684668679999998,6.906566410000005,7.432692359999999,7.463946050000007,7.2479830000000005,6125772,7574937.4,47.252859098503684,0.8191161618872136,1.5,2.75,NaN,NaN,0.22880276782802164,0.8086894553082379,346.2808624526854,-0.05376502251919801,-0.09750814546208009,-0.04374312294288208,46.4236877601518,-6.920722029827446,26.131113075237167,41.09797577689702,32.7709111478658,4630302256
1351863000,7.429926,7.433177,7.087429,7.099929,7.926938671875,7.962715999999999,7.932421,5.292446,7.932421,5.292446,7.351593,3.510798,5.579111,6.050773,6.6915061149999975,6.920674600000004,7.432600699999998,7.434488000000007,7.311603191777618,7.3457587118041,7.345471615384614,7.925713091292195,6.765230139477033,6.6915061149999975,6.920674600000004,7.432600699999998,7.434488000000007,7.206845,7907320,7542671.4,41.70563006034706,1.5767717695349717,1.5,2.75,NaN,NaN,0.2371559986974486,1.0483447548835283,343.1433873531826,-0.04965673402384682,-0.10581404047269061,-0.056157306448843786,46.41513055900133,-8.925703796489236,26.769686572437994,40.36039140738239,32.86992202017961,4622394936
1352125800,7.072429,7.194095,7.014097,7.150762,7.953227468749999,7.959492666666665,7.932421,5.292446,7.932421,5.292446,7.351593,3.510798,5.579111,6.050773,6.698118549999997,6.933391140000005,7.433534019999997,7.398613350000007,7.305295694060848,7.327187596394186,7.317298846153845,7.897054628350158,6.737543063957531,6.698118549999997,6.933391140000005,7.433534019999997,7.398613350000007,7.1196513333333336,4682540,7441530.8,43.4568649472529,1.9618882538987903,1.5,2.75,NaN,NaN,0.23307328450477374,0.6292441872309391,342.26582542230324,-0.0407226315860911,-0.10706059593145767,-0.06633796434536657,47.45020214745598,-3.3779913654802107,13.990152612116526,57.63418399107556,28.375663396807926,4627077476
1352212200,7.214095,7.401176,7.195762,7.315759,7.979516265625,7.956269333333331,7.932421,5.292446,7.932421,5.292446,7.351593,3.510798,5.579111,6.050773,6.705530969999997,6.949040980000004,7.440983899999997,7.371738500000006,7.305706019783952,7.326099158642359,7.283901615384614,7.807415873526519,6.760387357242708,6.705530969999997,6.949040980000004,7.440983899999997,7.371738500000006,7.304232333333334,7316436,7473996,48.83022883838445,0.8584870442794977,1.5,2.75,NaN,NaN,0.23431190704014707,0.9789189076365574,346.0945097301839,-0.021853647986673136,-0.09365502432870798,-0.07180137634203484,41.496667316387615,-1.2152704402074097,45.54034777518756,22.483558029530048,31.97609419528239,4634393912
1352298600,7.118262,7.120762,6.718266,6.811599,8.005805062499999,7.953045999999998,7.932421,5.292446,7.932421,5.292446,7.351593,3.510798,5.579111,6.050773,6.710368424999997,6.957899230000004,7.435983939999997,7.323531050000007,7.286329273910072,7.277099143533563,7.20396646153846,7.6711672987773145,6.736765624299606,6.710368424999997,6.957899230000004,7.435983939999997,7.323531050000007,6.883542333333334,15550460,8052721.6,37.19799913991047,4.687477576514229,1.5,2.75,NaN,NaN,0.26025341368013655,1.931081288095195,340.7832993950644,-0.040401044228493374,-0.12230268162765157,-0.08190163739915819,57.72650540137865,-3.9257092701492433,27.387614678951934,39.672793199591695,32.93959212145638,4618843452
1352385000,6.816599,6.919097,6.555768,6.555768,8.032093859375,7.949822666666664,7.932421,5.292446,7.932421,5.292446,7.351593,3.510798,5.579111,6.050773,6.713951719999996,6.962582520000003,7.425800719999997,7.273948200000007,7.257679812188108,7.208400939387509,7.108582846153845,7.559589293566635,6.657576398741055,6.713951719999996,6.962582520000003,7.425800719999997,7.273948200000007,6.676877666666666,11436076,8304688.2,32.913345638527886,6.897908898474903,1.5,2.75,NaN,NaN,0.2676159555601268,1.3770626572108993,336.90298778620894,-0.0654881585296866,-0.16376183556126644,-0.09827367703157984,56.61528626364772,-6.855326824910238,9.283680137402694,65.98355527260317,24.732764589994137,4607407376
1352471400,6.510768,6.768266,6.500767,6.574933,8.05838265625,7.946599333333332,7.932421,5.292446,7.932421,5.292446,7.351593,3.510798,5.579111,6.050773,6.716843344999997,6.966774130000004,7.416300779999997,7.2323652000000065,7.230905427396418,7.148070659445842,7.045057769230768,7.543679483088635,6.546436055372901,6.716843344999997,6.966774130000004,7.416300779999997,7.2323652000000065,6.614655333333334,10028416,8477461.8,33.531014228593605,6.3752360416594005,1.5,2.75,NaN,NaN,0.26760760159154634,1.1829503024124508,336.3123633629903,-0.0756602703895589,-0.19284901501852847,-0.11718874462896957,56.95232390786675,-7.41612167180448,28.60173703775483,38.31675546346521,33.08150749877998,4617435792
1352730600,6.652433,6.678267,6.562434,6.603268,8.084671453124999,7.943375999999998,7.932421,5.292446,7.932421,5.292446,7.351593,3.510798,5.579111,6.050773,6.720384974999998,6.969482430000003,7.407117559999997,7.191865600000007,7.2062921949495,7.096184691879571,6.983327692307691,7.486719796745259,6.4799355878701235,6.720384974999998,6.969482430000003,7.407117559999997,7.191865600000007,6.6146563333333335,4646804,8362239.6,34.49133693127504,5.416388752297497,1.5,2.75,NaN,NaN,0.2567665586207216,0.5556889329026162,335.1673257605025,-0.0751930557205889,-0.2111800642797057,-0.1359870085591168,56.542740671734876,-6.765502800592447,26.218669162738685,41.04660073486958,32.73473010239173,4622082596
1352817000,6.495768,6.739933,6.473935,6.535767,8.11096025,7.940152666666664,7.932421,5.292446,7.932421,5.292446,7.351593,3.510798,5.579111,6.050773,6.723572439999999,6.971793660000002,7.399717619999998,7.151949350000007,7.179997089265205,7.042811578367231,6.940699846153844,7.4923088875115775,6.389090804796111,6.723572439999999,6.971793660000002,7.399717619999998,7.151949350000007,6.583211666666666,7149092,8396046.2,33.2585907654485,4.9992500055020175,1.5,2.75,NaN,NaN,0.25742594729067003,0.8514831659692392,331.55822046616134,-0.07402645891198054,-0.22852008219909248,-0.15449362328711194,56.4857447110197,-7.31506739750831,10.607703490172224,63.495452470216705,25.896844039611082,4614933504
1352903400,6.598267,6.623267,6.226604,6.296604,8.137249046874999,7.936929333333331,7.932421,5.292446,7.932421,5.292446,7.351593,3.510798,5.579111,6.050773,6.725851584999999,6.9759352900000025,7.385984419999997,7.090929150000006,7.145354223019511,6.971744189951305,6.883649076923076,7.528609220845861,6.238688933000291,6.725851584999999,6.9759352900000025,7.385984419999997,7.090929150000006,6.382158333333334,10384756,8587719.2,29.267288734862134,7.574603003079829,1.5,2.75,NaN,NaN,0.26737145105562216,1.2092565858464492,326.01699964353315,-0.08326900439234225,-0.25857987877753974,-0.1753108743851975,58.808023357136534,-13.83281694090135,14.183835218187118,57.35528063705629,28.46088414475661,4604548748
1352989800,6.271603,6.345769,6.164105,6.233271,8.16353784375,7.933705999999997,7.932421,5.292446,7.932421,5.292446,7.351593,3.510798,5.579111,6.050773,6.727901565,6.978301920000002,7.371251239999998,7.015096550000007,7.109586253489334,6.901413409955942,6.816854846153845,7.533557947388871,6.1001517449188185,6.727901565,6.978301920000002,7.371251239999998,7.015096550000007,6.2477149999999995,10091116,8796038.4,28.29878933219983,8.203291376378516,1.5,2.75,NaN,NaN,0.26124949026593486,1.1472341912468231,322.2356372833908,-0.08714044236051294,-0.28423642733583865,-0.1970959849753257,50.76976777252111,-12.206572769953054,15.586505661668767,55.156081097779705,29.257413240551525,4594457632
1353076200,6.264104,6.362437,6.104938,6.315769,6.104938,7.930482666666665,7.932421,5.292446,7.932421,5.292446,7.351593,3.510798,5.579111,6.050773,6.729497370000001,6.984393510000002,7.358334699999998,6.938347200000007,7.078456165117203,6.8456377518649,6.757880923076922,7.5030705625079595,6.012691283645884,6.729497370000001,6.984393510000002,7.358334699999998,6.938347200000007,6.261048,11835140,9028543.8,31.47957885131649,6.599140478626593,1.5,2.75,NaN,NaN,0.2609815981040824,1.3108581253158453,323.77027145504746,-0.07793722259311447,-0.2945175132167188,-0.21658029062360434,52.54026192979651,-11.67697932052556,17.568142617970512,52.21089245265193,30.22096492937755,4606292772
1353335400,6.541601,6.710766,6.531601,6.710766,6.09034662745098,7.927259333333331,7.932421,5.292446,7.932421,5.292446,7.351593,3.510798,5.579111,6.050773,6.732880669999999,6.993476750000002,7.344901499999997,6.884097750000007,7.0640369429557435,6.832792823115862,6.731663230769229,7.457402151683166,6.005924309855292,6.732880669999999,6.993476750000002,7.344901499999997,6.884097750000007,6.651044333333334,10777928,9123527,44.235248773963185,0.46931512387271923,1.5,2.75,NaN,NaN,0.2705541268109336,1.1813334908747462,331.5492701382213,-0.0409009178223545,-0.26770643790154747,-0.22680552007919297,66.61736449450964,-8.269722936471805,27.489756523520995,39.54314843711785,32.967095039361155,4617070700
1353421800,6.681599,6.752432,6.561602,6.730766,6.075755254901961,7.924035999999997,7.932421,5.292446,7.932421,5.292446,7.351593,3.510798,5.579111,6.050773,6.735076479999999,7.001210000000002,7.329951639999998,6.850598100000006,7.050967494212381,6.823075982819113,6.68730469230769,7.332924784749956,6.041684599865425,6.735076479999999,7.001210000000002,7.329951639999998,6.850598100000006,6.6815999999999995,10529108,9202464.4,44.79562235085189,0.15644593165216608,1.5,2.75,NaN,NaN,0.26485954632443837,1.144161774752424,333.3229198593707,-0.012199089897135279,-0.24205438245061206,-0.22985529255347678,64.38048348111214,-1.1866963983053047,51.40819666031281,18.09497064623836,30.496832693448848,4627599808
1353508200,6.739933,6.773266,6.698266,6.769099,6.061163882352941,7.920812666666664,7.932421,5.292446,7.932421,5.292446,7.351593,3.510798,5.579111,6.050773,6.737513955,7.009818260000002,7.318335079999998,6.818765100000007,7.03991382777268,6.817935317788722,6.661856230769228,7.26510247776659,6.058609983771866,6.737513955,7.009818260000002,7.318335079999998,6.818765100000007,6.7468770000000005,5341180,9029469.4,45.91739027284425,0.8524621698020463,1.5,2.75,NaN,NaN,0.251298150158407,0.5915275597478629,334.75199421752245,0.010972025583852185,-0.21614026057366154,-0.22711228615751372,50.47528242147079,3.254096240135407,76.23541709783416,4.745654262916088,19.018928639249747,4632940988
1353681000,6.859932,7.035762,6.843265,7.012429,6.046572509803921,7.91758933333333,7.932421,6.233271,7.932421,5.292446,7.351593,3.510798,5.579111,6.050773,6.740926409999999,7.016468180000001,7.310318459999999,6.814890100000007,7.038835991389438,6.836458525618367,6.651215230769228,7.223684921216963,6.078745540321494,6.740926409999999,7.016468180000001,7.310318459999999,6.814890100000007,6.963818666666668,5184120,8737806.4,52.51375762873047,3.115776731986577,1.5,2.75,NaN,NaN,0.2523956394328065,0.5932976496251965,336.60990167713385,0.0425193516544454,-0.17396309658945697,-0.21648244824390236,48.00012476872692,6.653999363947896,100,0,0,4638125108
1353940200,6.925764,7.001597,6.862432,6.998263,6.031981137254902,7.914365999999998,7.932421,6.233271,7.932421,5.292446,7.351593,3.510798,5.579111,6.050773,6.744051374999999,7.022484790000001,7.300785219999999,6.812890050000007,7.037244893687891,6.851868475559475,6.626792461538458,7.102725432717329,6.150859490359587,6.744051374999999,7.022484790000001,7.300785219999999,6.812890050000007,6.954097333333333,7350036,8681861.8,52.11523939621891,2.4668491107983215,1.5,2.75,NaN,NaN,0.24508145090189176,0.8465967518626015,334.1536917852543,0.061133257920739814,-0.14006587584297758,-0.2011991337637174,48.22647764246039,5.981810824579584,77.83367602330033,4.171378539732606,17.994945436967065,4630775072
1354026600,6.960764,7.033271,6.867765,6.891598,6.017389764705882,7.911142666666664,7.932421,6.233271,7.932421,5.292446,7.351593,3.510798,5.579111,6.050773,6.746488849999999,7.026118090000001,7.281952079999999,6.802390150000006,7.03153325079817,6.8556522397919055,6.632946230769227,7.1202120241624955,6.145680437375959,6.746488849999999,7.026118090000001,7.281952079999999,6.802390150000006,6.930878,8377556,8486263.4,49.09414572515639,1.9398020843039943,1.5,2.75,NaN,NaN,0.2393974901231852,0.9871901925646097,332.9547339044261,0.06462257034491975,-0.12042092083256772,-0.18504349117748747,49.80550195458253,5.444364831243223,43.769941001431796,23.917434267640722,32.31262473092748,4622397516
1354113000,6.795765,7.055763,6.687433,7.044929,6.002798392156863,7.90791933333333,7.932421,6.233271,7.932421,5.292446,7.351593,3.510798,5.579111,6.050773,6.750397139999998,7.032176360000001,7.2642022399999995,6.800515100000007,7.032058574296281,6.873678597906962,6.670573999999997,7.201757912580766,6.139390087419227,6.750397139999998,7.032176360000001,7.2642022399999995,6.800515100000007,6.929375,12245928,8620780.6,53.28629272246153,2.3374648567972938,1.5,2.75,NaN,NaN,0.2486069551143862,1.4205126621596194,334.43963735974063,0.07489421425016407,-0.09142572336478239,-0.16631993761494646,49.80011296087049,11.884580958243514,47.34433392701068,21.094809936470966,31.560856136518368,4634643444
1354199400,7.125761,7.203261,7.031596,7.147429,5.9882070196078425,7.904695999999997,7.932421,6.233271,7.932421,5.292446,7.351593,3.510798,5.579111,6.050773,6.754172099999998,7.041001280000001,7.2500857,6.805306750000007,7.036582904716035,6.899750064772966,6.714612153846151,7.2990355929116415,6.13018871478066,6.754172099999998,7.041001280000001,7.2500857,6.805306750000007,7.127428666666667,9115432,8803760.8,55.90073299312136,3.7467046450586237,1.5,2.75,NaN,NaN,0.24311110117764434,1.0354020522683895,337.51643222886446,0.0854638208522113,-0.05949016154968234,-0.14495398240189364,40.84167845067142,14.665783021466572,53.127640311192245,16.925255193784988,29.94710449502278,4643758876
1354285800,7.148262,7.187428,7.077404,7.127429,5.973615647058823,7.901472666666663,7.932421,6.233271,7.932421,5.292446,7.351593,3.510798,5.579111,6.050773,6.757917899999998,7.049901190000001,7.236069179999999,6.796306850000008,7.040145496687955,6.921433772889826,6.754932230769228,7.374342862170576,6.1355215993678796,6.757917899999998,7.049901190000001,7.236069179999999,6.796306850000008,7.130753666666666,5974400,8796192.2,55.250955009270484,3.051529192706159,1.5,2.75,NaN,NaN,0.23360487966495547,0.6792029851280421,338.8668134386585,0.08765365530365259,-0.0353869132723279,-0.12304056857598049,39.548095303186436,12.851324993045182,34.266980515944184,32.437359513844875,33.29565997021094,4637784476
1354545000,7.243261,7.262427,7.023263,7.044096,5.959024274509804,7.898249333333331,7.932421,6.233271,7.932421,5.292446,7.351593,3.510798,5.579111,6.050773,6.761701194999998,7.05961776,7.22006934,6.793515200000007,7.040300418386466,6.933115889757462,6.794034461538458,7.417333738376017,6.170735184700899,6.761701194999998,7.05961776,7.22006934,6.793515200000007,7.109928666666666,7425264,8772089.4,52.512042826838986,2.5266470904207106,1.5,2.75,NaN,NaN,0.2340019596888872,0.8464646974528098,337.3668134386585,0.08023487166027075,-0.022746979000642042,-0.1029818506609128,42.10154336043756,4.967093175354351,31.82554728237014,34.9143840206834,33.26006869694646,4630359212
1354631400,7.039096,7.099929,6.951597,7.00493,5.944432901960784,7.895025999999997,7.932421,6.233271,7.932421,5.292446,7.351593,3.510798,5.579111,6.050773,6.764205334999998,7.068934329999999,7.2034362,6.7862236000000085,7.038913343155624,6.93995532882818,6.848521076923073,7.409036510154068,6.288005643692078,6.764205334999998,7.068934329999999,7.2034362,6.7862236000000085,7.018818666666665,8492316,8962578.2,51.22672134684156,1.0975083509089303,1.5,2.75,NaN,NaN,0.22788267685396676,0.9475304773351937,336.79498817952407,0.0698182604979399,-0.015709025038487923,-0.08552728553642783,28.429854159245505,4.073295669467633,31.451617262161573,35.301492272399,33.246890465439435,4621866896
1354717800,7.030763,7.141595,6.877431,7.03743,5.929841529411765,7.891802666666663,7.932421,6.233271,7.932421,5.292446,7.351593,3.510798,5.579111,6.050773,6.766692809999999,7.079388399999999,7.187669699999999,6.7723071500000085,7.038855172835795,6.949238630844544,6.910379461538458,7.350130085885145,6.470628837191771,6.766692809999999,7.079388399999999,7.187669699999999,6.7723071500000085,7.018818666666667,8349416,9014227.2,52.270712051823104,1.840444346182201,1.5,2.75,NaN,NaN,0.23047419993582627,0.9262486749834751,338.3342637784242,0.06248315185076521,-0.0074233457229713196,-0.06990649757373653,28.41774632748126,3.964057845807838,25.201726114664634,42.24277401576005,32.55549986957533,4630216312
1354804200,7.025763,7.124096,6.998263,7.121596,5.9152501568627445,7.88857933333333,7.932421,6.233271,7.932421,5.292446,7.351593,3.510798,5.579111,6.050773,6.769571949999999,7.0878466499999995,7.174219839999999,6.78780700000001,7.04209991115596,6.9656536183831586,6.972366153846149,7.260376443507256,6.684355864185043,6.769571949999999,7.0878466499999995,7.174219839999999,6.78780700000001,7.081318333333333,6757648,8574586.6,54.95949615268864,1.5933489349630614,1.5,2.75,NaN,NaN,0.22299982851183867,0.7881019010292578,339.3493022162693,0.060618779474137394,0.005866976768935217,-0.05475180270520218,28.736432661424928,1.556764424994538,21.05113158077313,47.423098841324105,31.525769577902768,4636973960
1354890600,7.200761,7.222428,7.069929,7.172429,5.900658784313725,7.885355999999996,7.932421,6.233271,7.932421,5.292446,7.351593,3.510798,5.579111,6.050773,6.773046919999998,7.097188229999998,7.166436579999999,6.818640050000009,7.047210855816511,6.9853465118704765,7.007878692307687,7.270869151020118,6.744888233595255,6.773046919999998,7.097188229999998,7.166436579999999,6.818640050000009,7.154928666666667,9136132,8459589.4,56.55148368944792,2.082773808759022,1.5,2.75,NaN,NaN,0.2179640550467073,1.0799734559221041,340.1876518978934,0.06001569543845155,0.020267816592862253,-0.03974787884558929,21.552032622650696,2.4887032682252794,47.02932231487515,21.352295055416896,31.61838262970794,4646110092
1355149800,7.149929,7.241593,7.142429,7.193262,5.886067411764706,7.882132666666664,7.932421,6.233271,7.932421,5.292446,7.351593,3.510798,5.579111,6.050773,6.776121889999998,7.1054881499999984,7.1618866400000005,6.84955650000001,7.052938351666843,7.005147986930431,7.0434553076923025,7.269392278950129,6.8175183364344765,6.776121889999998,7.1054881499999984,7.1618866400000005,6.84955650000001,7.192428,6477772,8282057.2,57.21887323338251,2.33162206827209,1.5,2.75,NaN,NaN,0.20947833682908534,0.7821452863184765,341.94310985895686,0.05818345933699113,0.032981445325649617,-0.025202014011341513,21.379350695481865,4.377272150813203,75.6566731263601,4.9947574303247295,19.348569443315156,4652587864
1355236200,7.284094,7.437426,7.269094,7.324093,5.871476039215686,7.87890933333333,7.932421,6.233271,7.932421,5.292446,7.351593,3.510798,5.579111,6.050773,6.779667684999998,7.1136964099999975,7.15577002,6.885597750000011,7.063571867287751,7.035523702460866,7.08614715384615,7.297877632737587,6.874416674954712,6.779667684999998,7.1136964099999975,7.15577002,6.885597750000011,7.343537666666667,7950400,8447237,61.24490152774505,3.6634174899453975,1.5,2.75,NaN,NaN,0.21195588419843642,0.9411834899387812,345.73919421132,0.06256406688888412,0.05300306959976364,-0.009560997289120483,19.5423484045522,3.9626233280704555,100,0,0,4660538264
1355322600,7.424927,7.507425,7.320761,7.346593,5.856884666666667,7.875685999999996,7.932421,6.233271,7.932421,5.292446,7.351593,3.510798,5.579111,6.050773,6.783180149999998,7.1215546599999975,7.152336719999999,6.926139050000012,7.074670735237252,7.065149349845545,7.111852076923072,7.359614275973771,6.864089877872374,6.783180149999998,7.1215546599999975,7.152336719999999,6.926139050000012,7.391593,9641568,8571860.8,61.9088062050767,3.790310983791597,1.5,2.75,NaN,NaN,0.2101493210414052,1.1247928804443488,346.09001741904285,0.06355309829055453,0.06988037557407267,0.006327277283518149,16.722757399148446,2.786512464831768,100,0,0,4670179832
1355409000,7.334927,7.397418,7.15827,7.216595,5.842293294117647,7.872462666666663,7.932421,6.233271,7.932421,5.292446,7.351593,3.510798,5.579111,6.050773,6.785775959999999,7.129967079999997,7.145336799999999,6.9721386000000125,7.080236392678928,7.079572745098351,7.128646846153842,7.3729081278475945,6.884385564460089,6.785775959999999,7.129967079999997,7.145336799999999,6.9721386000000125,7.2574276666666675,6400588,8372652.4,55.94557731458836,1.7844676645510815,1.5,2.75,NaN,NaN,0.21222065525273343,0.7644636005670079,342.45865222303,0.05248759234330042,0.07193676771264368,0.019449175369343256,19.509437530635683,1.2510261414038586,82.4311476868451,2.7053108392985785,14.863541473856339,4663779244
1355495400,7.163263,7.204078,7.098262,7.118262,5.827701921568627,7.869239333333329,7.932421,6.233271,7.932421,5.292446,7.351593,3.510798,5.579111,6.050773,6.788463429999998,7.139283639999997,7.13568688,7.016388150000012,7.081727592966029,7.083257436041365,7.146082538461534,7.34903782754548,6.9431272493775875,6.788463429999998,7.139283639999997,7.13568688,7.016388150000012,7.140200666666668,5061168,8121155,51.87518725546237,0.1831175166199904,1.5,2.75,NaN,NaN,0.20551439416325246,0.6232079057720238,341.40364346559676,0.03634776451226256,0.06488388100967146,0.0285361164974089,21.208027229927875,1.052881732446576,61.098218348596724,11.976878940237754,26.924902711165515,4658718076
1355754600,7.189095,7.393267,7.184096,7.385759,5.8131105490196076,7.866015999999997,7.932421,6.233271,7.932421,5.292446,7.351593,3.510798,5.579111,6.050773,6.791809224999998,7.152825169999996,7.129620259999999,7.0698876500000125,7.093650393241871,7.112067108799331,7.172300230769226,7.402448846464729,6.942151615073723,6.791809224999998,7.152825169999996,7.129620259999999,7.0698876500000125,7.321040666666667,9218144,7990305.2,60.3305261581387,2.1248041076116695,1.5,2.75,NaN,NaN,0.21047800886587728,1.1536660702272048,342.62549832315113,0.04113709852181845,0.07995748964968197,0.038820391127863514,28.534098044880157,5.436585376299268,63.765234414774646,10.452288611155288,25.782476974070065,4667936220
1355841000,7.419092,7.649915,7.384926,7.627424,5.798519176470588,7.862792666666663,7.932421,6.233271,7.932421,5.292446,7.351593,3.510798,5.579111,6.050773,6.796675839999998,7.168891679999997,7.12480364,7.115720550000011,7.1145826915461114,7.161148717485109,7.2092229230769185,7.542478940046513,6.875966906107324,6.796675839999998,7.168891679999997,7.12480364,7.115720550000011,7.5540883333333335,13091960,8106006.8,66.12166012673126,4.749544348024251,1.5,2.75,NaN,NaN,0.21437165108974318,1.6150936364869568,347.00321274527187,0.05705106324458686,0.11013422018359709,0.05308315693901023,31.59962922346488,8.38365710209552,69.17608453071892,7.73006130049822,23.09385416878286,4681028180
1355927400,7.659923,7.663258,7.453259,7.453259,5.783927803921569,7.859569333333329,7.932421,6.233271,7.932421,5.292446,7.351593,3.510798,5.579111,6.050773,6.801117464999997,7.180266579999997,7.1168037,7.151845200000013,7.127864115407048,7.188968744391289,7.234286769230764,7.58757480588785,6.880998732573679,6.801117464999997,7.180266579999997,7.1168037,7.151845200000013,7.523258666666667,9445640,8051833.4,59.39236463905531,3.5033129634660862,1.5,2.75,NaN,NaN,0.21405931886904722,1.1731042522563866,348.35161247019835,0.05243616459246141,0.11862836267958698,0.06619219808712558,36.4654142461152,4.657144269346363,37.602153155341355,29.267492709154254,33.13035413550438,4671582540
1356013800,7.474925,7.587424,7.410758,7.581591,5.769336431372549,7.856345999999996,7.932421,6.233271,7.932421,5.292446,7.351593,3.510798,5.579111,6.050773,6.807754899999996,7.189341489999997,7.11292056,7.192469800000012,7.145657326567556,7.226361340163547,7.275632538461535,7.6550511120806295,6.89621396484244,6.807754899999996,7.189341489999997,7.11292056,7.192469800000012,7.526591,9216500,8245599.4,62.42670241577363,3.1699930757849146,1.5,2.75,NaN,NaN,0.21138836752125814,1.11774772856416,351.26570503631064,0.05438123192622854,0.13416873799491125,0.0797875060686827,36.90273062994147,5.704650405044096,61.62792635494211,11.632563264211203,26.739510380846685,4680799040
1356100200,7.25326,7.425759,7.244928,7.387425,5.754745058823529,7.853122666666662,7.932421,6.233271,7.932421,6.233271,7.351593,5.292446,5.579111,3.510798,6.812709014999996,7.196524739999997,7.10972056,7.211219600000012,7.155138411800201,7.241700736338447,7.305055230769227,7.654044378917157,6.956066082621297,6.812709014999996,7.196524739999997,7.10972056,7.211219600000012,7.352704,14845864,8728686.6,55.651030921791076,0.4923139877906307,1.5,2.75,NaN,NaN,0.22033655555545403,1.7008130409906115,347.9596499853473,0.039630980434964755,0.12932623161238865,0.0896952511774239,41.23320978691695,2.6992343668282976,43.965784471597914,23.757703163945234,32.27651236445686,4665953176
1356359400,7.332428,7.341594,7.286594,7.30576,5.7401536862745095,7.84989933333333,7.932421,6.233271,7.932421,6.233271,7.351593,5.292446,5.579111,3.510798,6.816275644999996,7.204124659999998,7.1077039000000015,7.226594450000012,7.161045140749213,7.247801618591928,7.325695999999997,7.638827738265097,7.012564261734897,6.816275644999996,7.204124659999998,7.1077039000000015,7.226594450000012,7.3113160000000015,5689700,8645669.8,53.04331618797701,0.15185782910911003,1.5,2.75,NaN,NaN,0.2118004444443502,0.6580982308623444,345.7886790610606,0.02227888307926923,0.11754385502651044,0.0952649719472412,42.01498688772027,-0.25031085760380367,24.577343251171502,42.942709872990996,32.47994687583751,4660263476
1356532200,7.357426,7.364093,7.157428,7.212428,5.72556231372549,7.846675999999996,7.932421,6.233271,7.932421,6.233271,7.351593,5.292446,5.579111,3.510798,6.818942289999996,7.211024589999998,7.103687260000002,7.242635950000012,7.163060154837479,7.244432702535554,7.332683076923074,7.630988809381428,7.034377344464721,6.818942289999996,7.211024589999998,7.103687260000002,7.242635950000012,7.244649666666667,6443056,8548944.8,50.15100009383634,0.9706197317795557,1.5,2.75,NaN,NaN,0.21143362698403947,0.7536668151138372,342.7937854477411,0.0034102859933923535,0.09952782943898164,0.09611754344558929,41.31815326383313,-1.8262206712689855,5.00778104242211,75.54614476103312,19.446074196544767,4653820420
1356618600,7.224928,7.261594,6.938231,7.184928,5.710970941176471,7.843452666666662,7.932421,6.233271,7.932421,6.233271,7.351593,5.292446,5.579111,3.510798,6.821554764999997,7.219074419999998,7.100703980000002,7.249635900000013,7.163917717392872,7.238765588008358,7.333644538461536,7.6299519068557204,7.037337170067352,6.821554764999997,7.219074419999998,7.100703980000002,7.249635900000013,7.128251,10004692,8436883,49.29803453393875,2.4089389835459465,1.5,2.75,NaN,NaN,0.2194285821994652,1.185827988843747,341.7026959965611,-0.011226228992924692,0.08208475720443342,0.09331098619735811,41.22652262784848,-0.43880805282823365,4.960896081448355,75.66859546446005,19.370508454091574,4643815728
1356705000,7.052429,7.164086,6.934931,6.935764,5.696379568627451,7.840229333333329,7.932421,6.233271,7.932421,6.233271,7.351593,5.292446,5.579111,3.510798,6.821058934999996,7.220899409999998,7.089079100000003,7.239052650000014,7.15497051278923,7.209908293912324,7.313836999999998,7.6728291567936875,6.954844843206308,6.821058934999996,7.220899409999998,7.089079100000003,7.239052650000014,7.011593666666666,7457544,8353988.6,42.28126580512905,3.2289331939156964,1.5,2.75,NaN,NaN,0.22161204061378914,0.8926926234972359,337.8043395353596,-0.03656337839278612,0.04760676320637547,0.08417014159916159,44.70489149722333,-2.5637999837600787,0,100,0,4636358184
1356964200,6.900764,7.32576,6.879931,7.304093,6.879931,7.837005999999995,7.932421,6.233271,7.932421,6.233271,7.351593,5.292446,5.579111,3.510798,6.8225630899999965,7.225999349999998,7.080162500000003,7.247885850000013,7.160818453464162,7.218878265920674,7.312298538461535,7.671273120311745,6.953323956611325,6.8225630899999965,7.225999349999998,7.080162500000003,7.247885850000013,7.1699280000000005,15812976,8845917.4,52.94378552583457,1.0324272320150323,1.5,2.75,NaN,NaN,0.23762753771280418,1.7876015889544705,342.4867247376679,-0.02778896687899568,0.049433933000416985,0.07722289987941267,54.22489908949538,-1.1057225127437849,15.663185303322987,55.00638431978327,29.330430376893734,4652171160
1357137000,7.727423,7.864088,7.662598,7.860755,6.906654896551724,7.833782666666663,7.932421,6.233271,7.932421,6.233271,7.351593,5.292446,5.579111,3.510798,6.826292219999996,7.235699259999998,7.0803624800000025,7.288718800000014,7.188266945485175,7.280009383452039,7.351849461538459,7.815313587524571,6.888385335552346,6.826292219999996,7.235699259999998,7.0803624800000025,7.288718800000014,7.7958136666666675,13598664,9154587.4,63.82142867058958,5.884414765983398,1.5,2.75,NaN,NaN,0.2606537850190324,1.4854480497941391,352.3570376467441,0.013988249770557099,0.09470821209260905,0.08071996232205195,65.53687734924898,3.0591061936506967,41.785476737149146,25.559008910337944,32.655514352512924,4665769824
1357223400,7.847422,7.911588,7.748256,7.822422,6.933378793103448,7.830559333333329,7.932421,6.233271,7.932421,6.233271,7.351593,5.292446,5.579111,3.510798,6.829600524999995,7.244799169999998,7.080895820000003,7.329593400000013,7.213135771152423,7.331667727885178,7.3984515384615355,7.916735299580639,6.880167777342432,6.829600524999995,7.244799169999998,7.080895820000003,7.329593400000013,7.827422,8955916,9177767.4,62.745785320447425,5.423980610073134,1.5,2.75,NaN,NaN,0.2537022289462444,0.9758273019645278,354.60137207749125,0.03625788164432649,0.12604231437746005,0.08978443273313357,63.59229035021535,4.953041347415947,37.27198808633612,29.56020075235045,33.16781116131343,4656813908
1357309800,7.844088,7.951587,7.802422,7.922422,6.960102689655172,7.827335999999995,7.932421,6.233271,7.932421,6.233271,7.351593,5.292446,5.579111,3.510798,6.833042164999996,7.254690749999997,7.091329080000003,7.373843000000013,7.24095091738174,7.387930039515162,7.460309999999997,8.020338420171688,6.900281579828306,6.833042164999996,7.254690749999997,7.091329080000003,7.373843000000013,7.892143666666667,6977336,9109163.4,64.43000024404722,5.459804919104256,1.5,2.75,NaN,NaN,0.24623528402151265,0.7659689143352066,358.4756334251676,0.05387857624611461,0.15713265304077684,0.10325407679466223,61.606566101349664,4.4955076051979015,60.629657788037605,12.197063475264631,27.17327873669777,4663791244
1357569000,7.826588,7.869921,7.760856,7.834087,6.986826586206897,7.824112666666662,7.932421,6.233271,7.932421,6.233271,7.351593,5.292446,5.579111,3.510798,6.836425459999996,7.263357319999996,7.099895640000003,7.409467550000014,7.264211155915789,7.430421178608956,7.494796769230766,8.086533057142434,6.903060481319099,6.836425459999996,7.263357319999996,7.099895640000003,7.409467550000014,7.821621333333333,5496484,9046105.2,61.77331265711647,3.85545738990503,1.5,2.75,NaN,NaN,0.240187478019976,0.6076077912514217,356.74057819069617,0.05551980121398306,0.17265382831214104,0.11713402709815798,61.900932588550596,6.04624750843494,65.05292109992935,9.794797752332997,25.152281147737636,4658294760
1357655400,7.803255,7.837422,7.69159,7.787422,7.013550482758621,7.820889333333328,7.932421,6.233271,7.932421,6.233271,7.351593,5.292446,5.579111,3.510798,6.839704594999996,7.271673899999996,7.113845500000004,7.4402172000000135,7.284729228232817,7.464421256836674,7.507104307692305,8.115775956879734,6.898432658504876,6.839704594999996,7.271673899999996,7.113845500000004,7.4402172000000135,7.772144666666667,6899540,8934275.6,60.35743327809153,2.6560682942064977,1.5,2.75,NaN,NaN,0.23344780101854917,0.7722551115392053,356.49701704047243,0.04959210965808475,0.17912416417076393,0.12953205451267918,59.47070798015012,6.592907514071089,34.050897682219215,32.69977282811405,33.24932948966673,4651395220
1357741800,7.837422,7.899096,7.794921,7.839922,7.040274379310345,7.817665999999996,7.932421,6.233271,7.932421,6.233271,7.351593,5.292446,5.579111,3.510798,6.844067054999996,7.280423819999997,7.129878660000003,7.472550200000013,7.3065014937923145,7.500183232376038,7.5368476153846125,8.16940809866484,6.904287132104384,6.844067054999996,7.280423819999997,7.129878660000003,7.472550200000013,7.844646333333333,6077628,8914268.4,61.428567392835454,3.062657681327706,1.5,2.75,NaN,NaN,0.22474967237436708,0.6817865165468879,358.21164234646204,0.04544655542889148,0.18634024879879352,0.14089369336990204,58.54807000761302,8.700176972303911,20.31420347667074,48.431479757737904,31.254316765591376,4657472848
1357828200,7.97492,8.026911,7.844922,8.023253,7.066998275862069,7.814442666666662,7.932421,6.233271,7.932421,6.233271,7.351593,5.292446,5.579111,3.510798,6.848983669999996,7.290832059999996,7.148311800000004,7.5075082000000135,7.334609395996537,7.549999400721178,7.570821615384612,8.254705251281173,6.886937979488051,6.848983669999996,7.290832059999996,7.148311800000004,7.5075082000000135,7.965028666666666,5522524,8792874.6,64.98636005018614,3.96737871583311,1.5,2.75,NaN,NaN,0.22205248149048376,0.6280680950459592,361.013584029114,0.050881074035449864,0.20449503591421436,0.1536139618787645,57.706341646184576,11.667827429864296,49.602801405413715,19.44849969954849,30.9486988950378,4662995372
1357914600,8.020753,8.03242,7.949078,8.030753,7.093722172413793,7.811219333333328,7.932421,6.233271,7.932421,6.233271,7.351593,5.292446,5.579111,3.510798,6.852508634999997,7.299740309999995,7.167278260000004,7.541716200000013,7.3619091451731435,7.595785457795351,7.620308384615383,8.33629743157653,6.904319337654235,6.852508634999997,7.299740309999995,7.167278260000004,7.541716200000013,8.004083666666666,6086184,8615105.4,65.12807017688533,3.5785908237888595,1.5,2.75,NaN,NaN,0.21214458995544921,0.7064549668771318,361.6193665619294,0.050698218346499624,0.21698673481188901,0.1662885164653894,57.334210086396446,15.787575817170262,48.057930118676964,20.59447873201623,31.347591149306794,4669081556
1358173800,7.994086,8.019086,7.916588,8.001587,7.120446068965517,7.807995999999995,7.932421,6.233271,7.932421,6.233271,7.351593,5.292446,5.579111,3.510798,6.856208599999997,7.308101899999994,7.186278080000005,7.580965800000013,7.386994551244785,7.634433223719603,7.673833538461536,8.391794213195023,6.955872863728049,6.856208599999997,7.308101899999994,7.186278080000005,7.580965800000013,7.979087000000001,4748780,8532515,64.04256319353439,2.9069791734009147,1.5,2.75,NaN,NaN,0.2051460478157743,0.556551028624034,361.12362195846464,0.0445485969167741,0.221974262611357,0.1774256656945829,50.434186581594226,9.54935814754824,51.0587973013997,18.499045351287467,30.44215734731283,4664332776
1358260200,7.895754,8.04157,7.879088,8.00992,7.147169965517241,7.804772666666661,7.932421,6.233271,7.932421,6.233271,7.351593,5.292446,5.579111,3.510798,6.8605127299999955,7.316510149999995,7.200327940000005,7.625548700000013,7.411423000215578,7.670193869079641,7.735179076923074,8.420498976746376,7.04985917709977,6.8605127299999955,7.316510149999995,7.200327940000005,7.625548700000013,7.9768593333333335,4553384,8507125.8,64.22602295720694,2.5669948587403764,1.5,2.75,NaN,NaN,0.20209861582893326,0.5352435249047334,362.8840224529516,0.03727305894517524,0.22401698937605197,0.18674393043087673,44.74385392477987,1.8975912619080368,80.94534294415777,3.1750819186264314,15.879575137215783,4668886160
1358346600,7.97492,8.051586,7.946587,8.013253,7.173893862068965,7.801549333333329,7.932421,6.233271,7.932421,6.233271,7.351593,5.292446,5.579111,3.510798,6.864975184999996,7.325597559999994,7.218594420000005,7.656923400000013,7.435024176677712,7.702866167262533,7.798896384615381,8.418617452566012,7.17917531666475,6.864975184999996,7.325597559999994,7.218594420000005,7.656923400000013,8.003808666666666,5180400,8305238.6,64.30447143775129,2.568384093498453,1.5,2.75,NaN,NaN,0.1951629289840095,0.62375089380334,361.63755852792843,0.029269172860498183,0.22333039650649944,0.19406122364600126,18.170570372136186,2.4395385470126794,80.30212493860898,3.3797386925191386,16.318136368871894,4674066560
1358433000,8.124919,8.239918,8.079086,8.167417,7.20061775862069,7.798325999999995,7.932421,6.233271,7.932421,6.233271,7.351593,5.292446,5.579111,3.510798,6.869904299999997,7.336230769999994,7.238927520000005,7.683923050000013,7.463745463866821,7.74710910371372,7.89363892307692,8.294521087067565,7.492756759086275,6.869904299999997,7.336230769999994,7.238927520000005,7.683923050000013,8.162140333333333,8245676,8062924.4,67.81959910009765,3.96244308566308,1.5,2.75,NaN,NaN,0.197413076913723,1.0226656720234162,365.44122648245036,0.030787320909132332,0.23254537478241666,0.20175805387328433,19.986925059276395,3.092425523406861,82.52193711592896,2.6980466440464594,14.780016240024558,4682312236
1358519400,8.169917,8.248251,8.076586,8.224918,7.227341655172414,7.795102666666661,7.932421,6.233271,7.932421,6.233271,7.351593,5.292446,5.579111,3.510798,6.874270924999996,7.349047299999994,7.2571107000000055,7.7225060000000125,7.493595367244593,7.792614712883842,7.964471615384612,8.224207026948042,7.7047362038211835,6.874270924999996,7.349047299999994,7.2571107000000055,7.7225060000000125,8.183251666666669,5388532,7860069,69.04406941280291,3.2374641115258793,1.5,2.75,NaN,NaN,0.19557392856274272,0.6855578494285482,367.9199358240231,0.03195513428114727,0.2417019717247184,0.20974683744357114,19.37222123669744,4.988851923651095,82.12257927408302,2.8155549612783823,15.061865764638581,4687700768
1358865000,8.225752,8.354083,8.169085,8.352416,7.254065551724138,7.791879333333328,7.932421,6.233271,7.932421,6.233271,7.351593,5.292446,5.579111,3.510798,6.879604204999996,7.3619554899999935,7.287927040000005,7.761047250000013,7.527274607744805,7.845929121180619,8.00229169230769,8.32592592339285,7.67865746122253,6.879604204999996,7.3619554899999935,7.287927040000005,7.761047250000013,8.291861333333332,5756180,7687053,71.62243553865437,4.0229099171366824,1.5,2.75,NaN,NaN,0.19481850509397527,0.7488149229620246,370.9576392783489,0.03723635875764461,0.2562922858906269,0.2190559271329823,17.809993843755795,7.255212315449189,100,0,0,4693456948
1358951400,8.362417,8.417415,8.315749,8.395749,7.280789448275862,7.788655999999994,7.932421,6.233271,7.932421,6.233271,7.351593,5.292446,5.579111,3.510798,6.886295804999996,7.3752636899999935,7.324726660000006,7.811463450000012,7.561332427048931,7.898292919163417,8.046393769230766,8.413323970424948,7.679463568036585,6.886295804999996,7.3752636899999935,7.324726660000006,7.811463450000012,8.376304333333335,4612508,7175385.2,72.46196086725847,4.187979328396547,1.5,2.75,NaN,NaN,0.1881647547301199,0.6428237469397462,369.2924884525294,0.039362856241586,0.2682594974349648,0.2288966411933788,16.039362470821384,7.089700637327779,100,0,0,4698069456
1359037800,8.356583,8.526582,8.33575,8.400749,7.307513344827586,7.785432666666662,7.932421,6.233271,7.932421,6.233271,7.351593,5.292446,5.579111,3.510798,6.893145734999996,7.388771879999994,7.361242980000006,7.866212900000012,7.594250724027404,7.946145879243091,8.083188153846152,8.487081377808849,7.679294929883453,6.893145734999996,7.388771879999994,7.361242980000006,7.866212900000012,8.421027,8372768,7309538.6,72.56282436365676,3.8831495227559762,1.5,2.75,NaN,NaN,0.18835527224939694,1.1454577994840878,370.9733801282173,0.036864519033046356,0.27497728998468673,0.23811277095164038,16.527771114377757,4.705024258863567,100,0,0,4706442224
1359124200,8.484916,8.541581,8.414083,8.535747,7.33423724137931,7.782209333333328,7.932421,6.233271,7.932421,6.233271,7.351593,5.292446,5.579111,3.510798,6.901849814999996,7.403505059999994,7.399892560000007,7.932378850000012,7.631172146614564,8.002298366934225,8.137161999999998,8.579205672980569,7.695118327019427,6.901849814999996,7.403505059999994,7.399892560000007,7.932378850000012,8.497137,6725380,7323654.8,75.2036008156969,4.129549318433886,1.5,2.75,NaN,NaN,0.18496075280301152,0.9183092572850375,372.58852583439176,0.039810538967144316,0.28787594466057076,0.24806540569342644,14.325157400408456,6.288252172616938,100,0,0,4713167604
1359383400,8.553248,8.553248,8.421575,8.512414,7.360961137931034,7.778985999999994,7.932421,6.233271,7.932421,6.233271,7.351593,5.292446,5.579111,3.510798,6.9122187049999955,7.419571559999995,7.439425500000006,7.998753150000011,7.665730650668895,8.050880808178585,8.192930615384613,8.627272796892758,7.758588433876469,6.9122187049999955,7.419571559999995,7.439425500000006,7.998753150000011,8.495745666666666,4352296,7041035,73.88002986263132,3.510234434883211,1.5,2.75,NaN,NaN,0.1811544847456535,0.6181329875508359,370.82937984994516,0.03581949044944355,0.2928397687552309,0.25702027830578733,14.95762296543014,6.384071059903479,83.70156774623749,2.336558344969747,13.961873908792768,4708815308
1359469800,8.467415,8.642414,8.450749,8.617414,7.387685034482759,7.775762666666661,7.932421,6.233271,7.932421,6.233271,7.351593,5.292446,5.579111,3.510798,6.922372774999996,7.435913059999995,7.485841700000005,8.08283565000001,7.703051566328938,8.104836350256814,8.25273769230769,8.690281259192975,7.815194125422405,6.922372774999996,7.435913059999995,7.485841700000005,8.08283565000001,8.570192333333333,5544292,6945372.4,75.93278797672798,4.027394656603329,1.5,2.75,NaN,NaN,0.1819052358352497,0.7982713785080839,372.9616349068994,0.035797911564136864,0.3017676677609584,0.26596975619682156,14.03326484406632,7.58427050457434,83.6796886657835,2.342506030394822,13.9778053038217,4714359600
1359556200,8.609081,8.659913,8.489082,8.517416,7.414408931034483,7.772539333333327,7.932421,6.233271,7.932421,6.233271,7.351593,5.292446,5.579111,3.510798,6.930618529999995,7.451387919999997,7.531524600000006,8.143501800000012,7.734987426472901,8.144129650232356,8.290750230769229,8.727803723187687,7.85369673835077,6.930618529999995,7.451387919999997,7.531524600000006,8.143501800000012,8.555470333333334,8108492,6560148.2,70.26889638261322,2.967988774977753,1.5,2.75,NaN,NaN,0.1811142189898747,1.2360226861948027,369.973892363676,0.025101366414915005,0.2973464642154653,0.2722450978005503,17.583347086085002,6.291614653874027,51.91764031917013,17.763594918897063,30.318764761932815,4706251108
1359642600,8.479082,8.557414,8.429999,8.446582,7.441132827586207,7.769315999999995,7.932421,6.233271,7.932421,6.233271,7.351593,5.292446,5.579111,3.510798,6.939705939999994,7.466237779999997,7.574140860000005,8.172793150000011,7.762893096022983,8.172934635924513,8.322737076923074,8.739384918099038,7.9060892357471095,6.939705939999994,7.466237779999997,7.574140860000005,8.172793150000011,8.477998333333334,6123900,6186410,66.48578173725937,1.930951702452799,1.5,2.75,NaN,NaN,0.1772785604905979,0.9898955937288346,371.1089965608586,0.010078657047891237,0.28484341911041433,0.2747647620625231,19.263383532897162,3.418032898283496,21.941686382932986,46.253333907992555,31.804979709074463,4700127208
1359729000,8.604081,8.734913,8.562414,8.705746,7.467856724137931,7.766092666666661,7.932421,6.233271,7.932421,6.233271,7.351593,5.292446,5.579111,3.510798,6.950226664999994,7.479470979999997,7.614040460000005,8.216959350000012,7.799867719708357,8.223678575360273,8.376903153846152,8.795546405405535,7.958259902286769,6.950226664999994,7.479470979999997,7.614040460000005,8.216959350000012,8.667691,7562328,6116730.6,72.35099120637358,3.7254039441369047,1.5,2.75,NaN,NaN,0.18521087759841243,1.2363349793433767,375.63878544575954,0.014168637136135587,0.2924755584826926,0.278306921346557,22.90035662705103,5.845991412923495,24.103457970085653,43.55029890198403,32.34624312793031,4707689536
1359988200,8.546581,8.592405,8.398083,8.419915,7.494580620689655,7.762869333333327,7.932421,6.233271,7.932421,6.233271,7.351593,5.292446,5.579111,3.510798,6.9578349199999945,7.488887539999996,7.647823440000005,8.241834000000011,7.824183299327637,8.242367758659295,8.40844123076923,8.769569799011496,8.047312662526963,6.9578349199999945,7.488887539999996,7.647823440000005,8.241834000000011,8.470134333333332,6824288,6109078.2,59.900079108344016,1.0243758565444177,1.5,2.75,NaN,NaN,0.19395745776995438,1.1170732762923217,370.8473611816317,-0.004788923696344205,0.2723207667261267,0.2771096904224709,32.278681152326534,0.808137429936437,20.582198586712163,48.015236472233894,31.402564941053946,4700865248
1360074600,8.558248,8.740746,8.541581,8.664913,7.521304517241379,7.759645999999994,7.932421,6.233271,7.932421,6.233271,7.351593,5.292446,5.579111,3.510798,6.966997319999995,7.502037399999995,7.685739720000006,8.283375300000012,7.857153091510867,8.282610162596505,8.458568923076921,8.762786865099223,8.15435098105462,6.966997319999995,7.502037399999995,7.685739720000006,8.283375300000012,8.64908,6935540,6181031,65.3968781252493,3.1532976731607225,1.5,2.75,NaN,NaN,0.20301985364352906,1.122068470454201,374.24522147091,-0.0033112684156736405,0.27297060490287883,0.2762818733185525,35.02305336380311,3.205955775952806,23.39041291128032,44.413333793141014,32.19625329557866,4707800788
1360161000,8.578248,8.703246,8.560748,8.689913,7.548028413793103,7.75642266666666,7.932421,6.233271,7.932421,6.233271,7.351593,5.292446,5.579111,3.510798,6.976859719999994,7.514803929999996,7.719289400000005,8.32849985000001,7.889810342824166,8.321400909015885,8.498760923076922,8.775296239052699,8.222225607101146,6.976859719999994,7.514803929999996,7.719289400000005,8.32849985000001,8.651302333333334,5612864,6116697.2,65.91039004283138,2.2043386871317368,1.5,2.75,NaN,NaN,0.19869686409756268,0.9176298607686514,375.5893307798035,-0.003134888056766205,0.27236326324759474,0.27549815130436095,35.011830484608026,3.4421216489148923,50.55792665675861,18.715075738280913,30.72699760496047,4713413652
1360247400,8.693247,8.71658,8.464083,8.658246,7.574752310344827,7.753199333333328,7.932421,6.233271,7.932421,6.233271,7.351593,5.292446,5.579111,3.510798,6.986463784999994,7.526637139999996,7.752489060000006,8.36941605000001,7.919945074478121,8.353481393871515,8.532093846153845,8.770379222923086,8.293808469384604,6.986463784999994,7.526637139999996,7.752489060000006,8.36941605000001,8.612969666666666,5927300,6109180.8,64.60260350613686,1.4571052930912887,1.5,2.75,NaN,NaN,0.20253973094773678,0.9702282833076409,373.11306986223684,-0.00739257827035622,0.26625742846641565,0.27365000673677187,35.221868881172256,1.4351292277055478,50.686254049469234,18.623302986310758,30.690442964220004,4707486352
1360333800,8.699912,8.809079,8.69658,8.791579,7.601476206896552,7.749975999999994,7.932421,6.233271,7.932421,6.233271,7.351593,5.292446,5.579111,3.510798,6.9976011749999945,7.536220379999995,7.790488680000006,8.40783235000001,7.954126797047606,8.395204975407562,8.565875615384615,8.816872064080961,8.314879166688268,6.9976011749999945,7.536220379999995,7.790488680000006,8.40783235000001,8.765746,4687580,6067433.6,67.52443464302401,2.789903250056563,1.5,2.75,NaN,NaN,0.19884639302289847,0.772580354237416,376.23478382082044,-0.0036594991489116713,0.2690756328006323,0.27273513194954396,35.1354290769609,3.279504497784069,45.398272789059405,22.603012605959258,31.99871460498133,4712173932
1360593000,8.789079,8.810745,8.724913,8.787412,7.628200103448276,7.74675266666666,7.932421,6.233271,7.932421,6.233271,7.351593,5.292446,5.579111,3.510798,7.008363564999994,7.544770289999995,7.825338340000006,8.44566530000001,7.986804648143779,8.432558025368747,8.596003538461538,8.852058080607561,8.339948996315515,7.008363564999994,7.544770289999995,7.825338340000006,8.44566530000001,8.774356666666668,4230460,5974647.4,67.3373619391237,2.4133596681220717,1.5,2.75,NaN,NaN,0.19077393637840573,0.708068563175795,374.2427785230406,-0.0038802428274879452,0.267884828415184,0.27176507124267196,35.02541266694162,1.972726388682262,52.492624141078814,17.35403645885653,30.15333940006465,4707943472
1360679400,8.791579,8.879078,8.761579,8.834912,7.654924,7.743529333333327,7.932421,6.233271,7.932421,6.233271,7.351593,5.292446,5.579111,3.510798,7.017938474999994,7.554586849999996,7.859088000000006,8.487331550000011,8.020063759981278,8.470877451524105,8.62940069230769,8.888116977364252,8.37068440725113,7.017938474999994,7.554586849999996,7.859088000000006,8.487331550000011,8.825189666666665,5225704,5998493.6,68.41167500312314,2.611373100882252,1.5,2.75,NaN,NaN,0.1855400123513768,0.8711693882610795,377.21232088141534,-0.003261483195687309,0.2676882172480628,0.2709497004437501,34.59406908627744,3.7276094064208958,49.14294051557805,19.740335972534588,31.116723511887354,4713169176
1360765800,8.888244,8.934911,8.778246,8.854078,7.681647896551724,7.740305999999993,7.932421,6.233271,7.932421,6.233271,7.351593,5.292446,5.579111,3.510798,7.026917549999995,7.564845079999995,7.893620980000006,8.52953945000001,8.052770200766327,8.507372741855143,8.653887692307691,8.932040823796733,8.37573456081865,7.026917549999995,7.564845079999995,7.893620980000006,8.52953945000001,8.855744999999999,3920220,5966835.4,68.85678323335512,2.4071234233133354,1.5,2.75,NaN,NaN,0.1834775114691356,0.6570015321689617,379.50429918780526,-0.003949751661850409,0.26601251086643707,0.2699622625282875,33.41504671968887,4.824389321029502,45.33683304055371,22.649262534169413,32.01390442527688,4717089396
1360852200,8.769913,8.910743,8.743246,8.881578,7.708371793103448,7.737082666666661,7.932421,6.233271,7.932421,6.233271,7.351593,5.292446,5.579111,3.510798,7.035821624999995,7.575219979999995,7.930370620000006,8.57295570000001,8.085272467402941,8.543011337868938,8.682284923076923,8.972003417806878,8.392566428346967,7.035821624999995,7.575219979999995,7.930370620000006,8.57295570000001,8.845189,3390908,5877360.8,69.52042517447514,2.3111855918716873,1.5,2.75,NaN,NaN,0.1823360463641974,0.5769439915956835,378.89099111759026,-0.004880301154921718,0.26386188608463534,0.26874218723955706,32.51806383956464,2.0197235251292627,77.24028483424557,4.381280975421619,18.378434190332808,4720480304
1360938600,8.903244,8.929069,8.749913,8.841746,7.735095689655172,7.733859333333327,7.932421,6.233271,7.932421,6.233271,7.351593,5.292446,5.579111,3.510798,7.0449973699999955,7.585271569999995,7.967106940000005,8.60667215000001,8.114938096132237,8.571462258071897,8.69954123076923,8.998330107345371,8.400752354193088,7.0449973699999955,7.585271569999995,7.967106940000005,8.60667215000001,8.840242666666667,4575848,5693869.4,67.28394074554734,1.5824766532049148,1.5,2.75,NaN,NaN,0.18210890019532622,0.8036447060060773,377.51032099044187,-0.010199774506465309,0.25599246910647544,0.26619224361294075,28.543073366930376,5.009919933871078,46.58622172489132,21.670607350807384,31.74317092430129,4715904456
1361284200,8.888244,9.044076,8.888244,9.029077,7.761819586206897,7.730635999999993,7.932421,6.233271,7.932421,6.233271,7.351593,5.292446,5.579111,3.510798,7.054443114999994,7.597304789999996,8.006939880000006,8.64688010000001,8.150786680597639,8.615044614446001,8.738899769230768,9.064914903782858,8.412884634678678,7.054443114999994,7.597304789999996,8.006939880000006,8.64688010000001,8.987132333333333,3421088,5595497.2,71.86769202349274,2.9821201456080146,1.5,2.75,NaN,NaN,0.1835532644670886,0.6114001808454126,380.77875980854634,-0.003471025406698691,0.26185346185456737,0.26532448726126606,19.976330054054916,4.202742716516586,73.92527400003246,5.655724061003284,20.41900193896426,4719325544
1361370600,9.021576,9.03241,8.698246,8.70158,7.788543482758621,7.72741266666666,7.932421,6.233271,7.932421,6.233271,7.351593,5.292446,5.579111,3.510798,7.0624930299999935,7.606379699999996,8.038539560000006,8.66433830000001,8.172386418613417,8.623286079736857,8.758515,9.039376484180368,8.47765351581963,7.0624930299999935,7.606379699999996,8.038539560000006,8.66433830000001,8.810745333333333,5341144,5574745.4,56.86723397908541,0.8042948700280236,1.5,2.75,NaN,NaN,0.19431117414801094,0.9580964899311813,376.44230064826587,-0.022390625092750194,0.23733620589532833,0.2597268309880785,27.82860373813939,0.13425911168499852,37.650985185249205,29.224201865069574,33.12481294968122,4713984400
1361457000,8.628246,8.632414,8.458258,8.537415,7.815267379310345,7.724189333333326,7.932421,6.233271,7.932421,6.233271,7.351593,5.292446,5.579111,3.510798,7.070609614999994,7.616137929999996,8.065839280000004,8.671421600000011,8.186701264942302,8.615107881666681,8.745566461538461,9.04953574916886,8.441597173908061,7.070609614999994,7.616137929999996,8.065839280000004,8.671421600000011,8.542695666666667,7554084,5721824.2,51.10856114985753,1.9796878362980923,1.5,2.75,NaN,NaN,0.19781194742315297,1.320223015590028,373.02360206547155,-0.04591981679755547,0.2023270599911342,0.24824687678868967,29.883439052950237,-1.3955597935193895,10.867853695665556,63.00194263335257,26.13020367098188,4706430316
1361543400,8.66408,8.793245,8.601581,8.793245,7.841991275862069,7.720965999999994,7.932421,6.233271,7.932421,6.233271,7.351593,5.292446,5.579111,3.510798,7.081688674999994,7.629862789999996,8.097838940000004,8.691046400000012,8.210487293768095,8.63207332150795,8.774284153846152,9.013381499957402,8.5351868077349,7.081688674999994,7.629862789999996,8.097838940000004,8.691046400000012,8.729357,6161604,5611266,58.210585686150004,0.08810301748375726,1.5,2.75,NaN,NaN,0.201956094035785,1.0980773322811643,376.9682743662387,-0.04419701210156152,0.19300061166173776,0.23719762376329928,34.77140762590138,0.018949951993836003,17.526905317631805,52.25265740450595,30.220437277862253,4712591920
1361802600,8.924077,8.953244,8.294916,8.29825,7.868715172413793,7.71774266666666,7.932421,6.233271,7.932421,6.233271,7.351593,5.292446,5.579111,3.510798,7.090213589999995,7.636546049999997,8.117322080000005,8.679171550000012,8.213928968522287,8.600280624221478,8.746079307692305,9.092533567437544,8.399625047947067,7.090213589999995,7.636546049999997,8.117322080000005,8.679171550000012,8.515469999999999,8309516,5690472.8,44.68526162295508,1.7733623419283584,1.5,2.75,NaN,NaN,0.23455408731894314,1.4602505436806588,371.95056379718045,-0.07455222104815706,0.14400734745310295,0.21855956850126002,47.287431233014146,-5.56662189049518,13.67245114522939,58.156221907378836,28.171326947391766,4704282404
1361889000,8.406583,8.487416,8.245984,8.459915,8.245984,7.714519333333326,9.029077,6.233271,7.932421,6.233271,7.351593,5.292446,5.579111,3.510798,7.099967654999995,7.645962619999998,8.139588520000006,8.676546600000012,8.22357547956063,8.586912469533718,8.728387153846151,9.106546866823736,8.350227440868567,7.099967654999995,7.645962619999998,8.139588520000006,8.676546600000012,8.397771666666666,6908912,5818303.6,48.8642415955533,2.7884129814674057,1.5,2.75,NaN,NaN,0.23504536679616145,1.1874443953045009,375.0602992433968,-0.0813456105643075,0.11687755529587562,0.19822316586018313,49.40622405734171,-4.2444904940762145,20.068775413552075,48.69880611850025,31.232418467947696,4711191316
1361975400,8.444916,8.850577,8.420749,8.773246,8.281932763157895,7.711295999999993,9.029077,6.233271,7.932421,6.233271,7.351593,5.292446,5.579111,3.510798,7.111850874999995,7.658029169999997,8.170721540000006,8.684338200000012,8.245131186244526,8.604658520054317,8.737233307692305,9.113792925859313,8.360673689525298,7.111850874999995,7.658029169999997,8.170721540000006,8.684338200000012,8.681524000000001,7512384,5916708.2,55.82945222140967,1.52426809307547,1.5,2.75,NaN,NaN,0.248958412025007,1.2696897913606757,379.2710399239246,-0.06315041452420203,0.1192851477049306,0.18243556222913263,54.442481925138814,-0.9129352598881457,44.259646634882614,23.512146968223743,32.228206396893654,4718703700
1362061800,8.778246,8.939077,8.699912,8.699912,8.317881526315789,7.708072666666659,9.029077,6.233271,7.932421,6.233271,7.351593,5.292446,5.579111,3.510798,7.123171589999995,7.669020709999997,8.202354540000005,8.693463000000012,8.262965727960427,8.613730280049143,8.730181999999997,9.105838872127496,8.354525127872499,7.123171589999995,7.669020709999997,8.202354540000005,8.693463000000012,8.779633666666667,6231336,5822850.4,53.97634842465988,2.2588376317232832,1.5,2.75,NaN,NaN,0.24825888259464932,1.0701521715206697,380.22287126716924,-0.05477880382068048,0.11396205745328203,0.1687408612739625,54.575784421239455,-2.045424810771238,47.067606049972014,21.29979864550957,31.632595304518432,4712472364
1362148200,8.635747,8.849912,8.515748,8.818246,8.353830289473684,7.7048493333333266,9.029077,6.233271,7.932421,6.233271,7.351593,5.292446,5.579111,3.510798,7.135392299999995,7.680312269999998,8.231004280000006,8.712046200000012,8.284741424903157,8.63320796766351,8.732553846153843,9.110011185491963,8.355096506815723,7.135392299999995,7.680312269999998,8.231004280000006,8.712046200000012,8.727968666666667,7052756,5869293.2,56.486222977222525,1.4222463166978525,1.5,2.75,NaN,NaN,0.2543949624093172,1.2016363401303585,380.9198615501327,-0.040646623795044357,0.11793258153015707,0.15857920532520142,55.23603027910516,-0.2657846086055887,48.59797189428567,20.143741702668613,31.25828640304572,4719525120
1362407400,8.750745,8.949077,8.713246,8.949077,8.389779052631578,7.701625999999993,9.029077,6.233271,7.932421,6.233271,7.351593,5.292446,5.579111,3.510798,7.149258824999995,7.6911204899999985,8.257437340000005,8.72421275000001,8.31079380039715,8.663290732647939,8.741335769230766,9.132956911136802,8.34971462732473,7.149258824999995,7.6911204899999985,8.257437340000005,8.72421275000001,8.870466666666667,4770800,5729716.8,59.13937277031138,1.8807007411306782,1.5,2.75,NaN,NaN,0.25306896509436605,0.832641501583464,382.1721322150378,-0.022754491526017967,0.13013609091767897,0.15289058244369694,55.85129508681642,-0.8860263346962076,76.59345833185768,4.6256639044677375,18.78087776367459,4724295920
1362493800,9.084909,9.265741,9.084909,9.196575,8.425727815789473,7.698402666666659,9.029077,6.233271,7.932421,6.233271,7.351593,5.292446,5.579111,3.510798,7.164921169999994,7.704553679999999,8.292303660000005,8.76304575000001,8.345530318028635,8.714079710490992,8.767681692307688,9.226426361721872,8.308937022893504,7.164921169999994,7.704553679999999,8.292303660000005,8.76304575000001,9.182408333333333,6763828,5726693.8,63.654142681306624,4.50234072005066,1.5,2.75,NaN,NaN,0.2576114675876256,1.181105230386161,386.25647037217146,0.00405364830145849,0.15795764282052005,0.15390399451906156,56.77636357489585,5.688564605508418,76.94014512271576,4.498029821343542,18.561825055940698,4731059748
1362580200,9.294906,9.299082,9.173676,9.235741,8.461676578947369,7.695179333333326,9.029077,6.233271,7.932421,6.233271,7.351593,5.292446,5.579111,3.510798,7.181137674999994,7.7191536099999984,8.325386660000005,8.791587150000009,8.38044054085104,8.763761738063279,8.794924999999996,9.315401189688453,8.274448810311538,7.181137674999994,7.7191536099999984,8.325386660000005,8.791587150000009,9.236166333333333,6073512,5683592.4,64.32589001166076,4.1799092508980795,1.5,2.75,NaN,NaN,0.2481682199027952,1.068604427016969,388.428155481992,0.021740341323786716,0.18107942117379494,0.15933907985000823,51.13427462257513,8.179595345898045,76.01236524107887,4.843217977697431,19.14441678122371,4737133260
1362666600,9.268241,9.317407,9.241573,9.284907,8.497625342105263,7.691955999999992,9.029077,6.233271,7.932421,6.233271,7.351593,5.292446,5.579111,3.510798,7.199083324999995,7.736528429999998,8.363336300000004,8.82133685000001,8.415909813758843,8.81339462015249,8.829014307692304,9.411632631284576,8.246395984100033,7.199083324999995,7.736528429999998,8.363336300000004,8.82133685000001,9.281295666666667,2675580,5536728.2,65.19550439950267,4.0226525071381385,1.5,2.75,NaN,NaN,0.23627520419545256,0.48324207065103897,390.8695743964328,0.03337134852901352,0.20105326551127511,0.1676819169822616,48.631452482490026,5.591360186142883,100.00000000000001,0,0,4739808840
1362753000,9.404073,9.436564,9.261574,9.404073,8.533574105263158,7.6887326666666596,9.029077,6.233271,7.932421,6.233271,7.351593,5.292446,5.579111,3.510798,7.218424804999994,7.756503229999998,8.405302560000003,8.85862820000001,8.454661311258496,8.869649703947491,8.85786015384615,9.510203551504798,8.205516756187503,7.218424804999994,7.756503229999998,8.405302560000003,8.85862820000001,9.367403666666666,7254132,5603069.8,67.27755592091255,4.359285436909762,1.5,2.75,NaN,NaN,0.23189768961006316,1.294671003384609,394.27475252616966,0.04498822897879298,0.2239172032057528,0.17892897422695983,46.89015166529165,13.325978368933221,100.00000000000001,0,0,4747062972
1363008600,9.38324,9.508239,9.345739,9.499073,8.569522868421053,7.685509333333326,9.029077,6.233271,7.932421,6.233271,7.351593,5.292446,5.579111,3.510798,7.236741294999994,7.777361359999998,8.451035460000003,8.894002900000011,8.495618632385614,8.929594779762017,8.919205769230766,9.6468682927127,8.191543245748832,7.236741294999994,7.777361359999998,8.451035460000003,8.894002900000011,9.451017,3633180,5550349.8,68.8760350577433,4.430156706880531,1.5,2.75,NaN,NaN,0.2269407117807729,0.6545857704319825,395.52528432793804,0.05434252404493495,0.24685712928312853,0.19251460523819358,22.543659443576185,12.28331490328211,100,0,0,4750696152
1363095000,9.488238,9.516572,9.356573,9.446572,8.605471631578947,7.682285999999992,9.029077,6.233271,7.932421,6.233271,7.351593,5.292446,5.579111,3.510798,7.254661944999993,7.798486159999997,8.496268340000004,8.926960900000012,8.532910921311668,8.978830705498968,8.98914092307692,9.731200499055712,8.24708134709813,7.254661944999993,7.798486159999997,8.496268340000004,8.926960900000012,9.439905666666666,8630472,5770350.4,66.93017391663119,3.4562182291018715,1.5,2.75,NaN,NaN,0.2221591609392892,1.4956582186066203,393.1566293687282,0.052251279986136934,0.25782870522086476,0.20557742523472783,24.618472294615707,7.674764847583202,61.58774307320447,11.64678913752097,26.765467789274553,4742065680
1363181400,9.459905,9.520738,9.364073,9.475739,8.641420394736842,7.679062666666659,9.029077,6.233271,7.932421,6.233271,7.351593,5.292446,5.579111,3.510798,7.272615934999993,7.818073469999996,8.547067840000004,8.959002250000012,8.569884571456308,9.026155304975257,9.04164046153846,9.816672411701752,8.266608511375168,7.272615934999993,7.818073469999996,8.547067840000004,8.959002250000012,9.453516666666667,7592124,5888671.4,67.47984785344147,3.368612758784985,1.5,2.75,NaN,NaN,0.21748100658648287,1.2892762194202243,395.1849104268247,0.04818858994217226,0.26581316266244315,0.2176245727202709,18.825107351605617,8.917641925573516,64.08898470185216,10.270885308174162,25.640129989973687,4749657804
1363267800,9.552404,9.64157,9.542404,9.633238,8.677369157894736,7.675839333333325,9.029077,6.233271,7.932421,6.233271,7.351593,5.292446,5.579111,3.510798,7.291199084999993,7.836906619999996,8.593650740000003,8.997960250000013,8.611584705909001,9.083972704501424,9.144331846153845,9.848704716226703,8.439958976080987,7.291199084999993,7.836906619999996,8.593650740000003,8.997960250000013,9.605737333333332,6496300,6017475.4,70.3461685002584,3.911458377916239,1.5,2.75,NaN,NaN,0.21379172040173403,1.079572340254187,398.64711234255157,0.05118322556236249,0.281603604673224,0.2304203791108615,16.290153945983995,9.242110052271167,68.97663932420535,7.817244754025776,23.20611592176889,4756154104
1363354200,9.599071,9.63157,9.499905,9.594904,8.713317921052631,7.6726159999999926,9.029077,6.233271,7.932421,6.233271,7.351593,5.292446,5.579111,3.510798,7.309886399999993,7.854348099999997,8.628333720000002,9.033626550000013,8.650146246853746,9.13263282788224,9.23163869230769,9.851304915570298,8.611972469045083,7.309886399999993,7.854348099999997,8.628333720000002,9.033626550000013,9.575459666666667,6586648,6177262.4,68.7576786996552,3.0389334010009406,1.5,2.75,NaN,NaN,0.20804466894446733,1.0662729820251766,396.9804456758849,0.04583001095535261,0.28770789280505227,0.24187788184969966,17.987291261394876,7.216688380265347,39.341834166601444,27.67959864481081,32.978567188587746,4749567456
1363613400,9.319907,9.557404,9.292406,9.430739,8.749266684210527,7.669392666666659,9.029077,6.233271,7.932421,6.233271,7.351593,5.292446,5.579111,3.510798,7.326686229999992,7.870697939999997,8.660500060000002,9.063076200000014,8.680757727369285,9.161023891893455,9.282215076923073,9.849046674525836,8.71538347932031,7.326686229999992,7.870697939999997,8.660500060000002,9.063076200000014,9.426849666666667,7954924,6346216.2,62.272507407931954,1.755841675282312,1.5,2.75,NaN,NaN,0.21479133544843393,1.253490859640111,394.32169305158124,0.027390453584869995,0.27611594883078716,0.24872549524591717,22.645724357726213,2.5462087788116947,19.903537471354607,48.95832942690177,31.13813310174361,4741612532
1363699800,9.494905,9.527405,9.186576,9.377406,8.78521544736842,7.666169333333325,9.029077,6.233271,7.932421,6.233271,7.351593,5.292446,5.579111,3.510798,7.344556884999992,7.890464409999996,8.689599740000004,9.080492650000014,8.70807726747245,9.181631711713127,9.334329999999998,9.791375894305524,8.877284105694471,7.344556884999992,7.890464409999996,8.689599740000004,9.080492650000014,9.363795666666666,11726876,6761505.6,60.2832231945551,0.5444822925861506,1.5,2.75,NaN,NaN,0.22379402577354576,1.7343586907626019,392.11942149702674,0.008725873094114656,0.2596328366135605,0.25090696351944586,18.422659954407305,1.5338780071896743,16.93600479665409,53.13941811161785,29.92457709172806,4729885656
1363786200,9.532405,9.613237,9.486572,9.55407,8.821164210526316,7.662945999999992,9.029077,6.233271,7.932421,6.233271,7.351593,5.292446,5.579111,3.510798,7.363515024999993,7.9119475199999965,8.723999400000004,9.123117150000013,8.741253453061766,9.217102024883305,9.390931846153844,9.750071656761053,9.031792035546635,7.363515024999993,7.9119475199999965,8.723999400000004,9.123117150000013,9.551293,6928748,6840885.8,64.34618902623967,2.2227591530028463,1.5,2.75,NaN,NaN,0.22465380964686385,1.0128436875820965,396.19898730025346,0.005556663817306351,0.2578527932910788,0.25229612947377245,20.781628249392547,2.8989304900953656,15.950264589656774,54.60998548277612,29.43974992756711,4736814404
1363872600,9.391573,9.491571,9.271573,9.322407,8.85711297368421,7.659722666666658,9.633238,6.233271,7.932421,6.233271,7.351593,5.292446,5.579111,3.510798,7.383514824999993,7.934272299999996,8.754699100000003,9.162366750000013,8.764043788235815,9.227131070132513,9.419649538461538,9.678599093977505,9.160699982945571,7.383514824999993,7.934272299999996,8.754699100000003,9.162366750000013,9.361850333333335,9888972,6957630.2,56.22381826534405,0.1967243110283179,1.5,2.75,NaN,NaN,0.22878546610065922,1.421313251169917,393.2981090988078,-0.013805351765179108,0.23503943976729857,0.24884479153247768,26.130982045929574,-0.8684109534241199,3.3009090057517527,80.44439636133734,16.25469463291091,4726925432
1363959000,9.402406,9.534905,9.385389,9.528238,8.893061736842105,7.6564993333333256,9.633238,6.233271,7.932421,6.233271,7.351593,5.292446,5.579111,3.510798,7.404693784999994,7.959172039999996,8.788465420000003,9.199116400000012,8.794012188697156,9.255807920596084,9.445162076923076,9.674874923894395,9.215449229951757,7.404693784999994,7.959172039999996,8.788465420000003,9.199116400000012,9.482843999999998,7126520,7005876,60.94136132827062,1.202548504342078,1.5,2.75,NaN,NaN,0.22762207566489787,1.0172204018455364,395.959003148344,-0.014350405578773595,0.2309067845590107,0.2452571901377843,28.140073571879878,0.3070299596602824,14.455931179866914,56.928517724005616,28.61555109612747,4734051952
1364218200,9.619904,9.66657,9.324073,9.438238,8.9290105,7.653275999999992,9.633238,6.233271,7.932421,6.233271,7.351593,5.292446,5.579111,3.510798,7.4247977499999935,7.982538459999996,8.816765120000003,9.256115800000012,8.81927594600315,9.273182213872648,9.460738769230769,9.65648782060979,9.264989717851748,7.4247977499999935,7.982538459999996,8.816765120000003,9.256115800000012,9.476293666666665,9195016,7050151,57.99823321419248,1.0083793537998424,1.5,2.75,NaN,NaN,0.23582742740311943,1.3042296540882599,393.59209108253486,-0.02191931550692705,0.21785804575412548,0.23977736126105254,28.15380598407153,-0.08822247901142996,13.250308176233698,58.84657323737594,27.903118586390356,4724856936
1364304600,9.543238,9.652403,9.509122,9.642404,8.964959263157894,7.650052666666658,9.633238,6.233271,7.932421,6.233271,7.351593,5.292446,5.579111,3.510798,7.444080894999993,8.008138199999996,8.848998140000003,9.315240250000013,8.85155547753244,9.308346193503825,9.48823853846154,9.677802293618747,9.298674783304332,7.444080894999993,8.008138199999996,8.848998140000003,9.315240250000013,9.601309666666666,5843768,6996893.8,62.430793330628916,2.0661970867722954,1.5,2.75,NaN,NaN,0.23428011116003944,0.8351946116432409,397.0735393340117,-0.014670922159069205,0.22143870856221604,0.23610963072128524,30.57348864728027,1.7588601796651433,36.188978022528495,30.57294134003132,33.238080637440184,4730700704
1364391000,9.472405,9.65307,9.426572,9.64157,9.00090802631579,7.646829333333325,9.633238,6.233271,7.932421,6.233271,7.351593,5.292446,5.579111,3.510798,7.4633681999999935,8.034037939999996,8.881797800000005,9.358656450000012,8.882536439197834,9.340081794122508,9.50650753846154,9.705640059211092,9.307375017711987,7.4633681999999935,8.034037939999996,8.881797800000005,9.358656450000012,9.573737333333334,8600568,7051303,62.40182311904031,1.7602928587769466,1.5,2.75,NaN,NaN,0.23372424607717943,1.2197132927063268,397.39379564162186,-0.01156448601676871,0.22165402320032435,0.23321850921709306,30.588439060358514,0.08649220542458662,13.679617878140155,58.13964560880466,28.180736513055184,4722100136
1364477400,9.632404,9.763968,9.584904,9.69907,9.036856789473685,7.643605999999991,9.633238,6.233271,7.932421,6.233271,7.351593,5.292446,5.579111,3.510798,7.482260389999992,8.057954369999997,8.915580800000004,9.408614350000011,8.914557363150859,9.374271147063222,9.521891923076923,9.745720787048365,9.298063059105482,7.482260389999992,8.057954369999997,8.915580800000004,9.408614350000011,9.682647333333334,7930396,7136256,63.654084266008006,2.4257108353401398,1.5,2.75,NaN,NaN,0.22981994278595236,1.1112824427823218,400.5182956016155,-0.007467895519561341,0.22388363981764137,0.2313515353372027,29.30296908694342,1.0856387932594334,39.91534050019825,27.174505698049803,32.91015380175197,4730030532
1364823000,9.719903,9.77907,9.548238,9.620737,9.072805552631579,7.6403826666666586,9.633238,6.233271,7.932421,6.233271,7.351593,5.292446,5.579111,3.510798,7.501918524999992,8.083162449999996,8.947730480000004,9.448738900000013,8.942250682242982,9.397744085438154,9.535289230769232,9.760327236073845,9.310251225464619,7.501918524999992,8.083162449999996,8.947730480000004,9.448738900000013,9.649348333333334,6032244,7085230.4,60.6885921055721,1.4990829266985577,1.5,2.75,NaN,NaN,0.22989223258695585,0.8513828992773473,396.945347596563,-0.011616969383189651,0.21683032360821564,0.2284472929914053,29.635989779909725,2.014667143264162,18.430916776085102,50.957403255028325,30.611679968886566,4723998288
1364909400,9.724998,9.830003,9.676103,9.755,9.108754315789474,7.637159333333325,9.633238,6.233271,7.932421,6.233271,7.351593,5.292446,5.579111,3.510798,7.521297984999992,8.109204829999996,8.979482140000004,9.489035050000012,8.974123204507963,9.431768458253568,9.556770846153846,9.80688740494483,9.306654287362862,7.521297984999992,8.109204829999996,8.979482140000004,9.489035050000012,9.753701999999999,4053624,7049371.6,63.801441127447,2.182266903034942,1.5,2.75,NaN,NaN,0.2284189302593161,0.5750333831174399,396.2448186958453,-0.007122907135097611,0.21954365907253326,0.22666656620763087,28.253203661957315,4.026635937486339,41.27750655866626,25.9996733621028,32.722820079230935,4728051912
1364995800,9.78,9.7925,9.38625,9.439998,9.144703078947368,7.633935999999991,9.633238,6.233271,7.932421,6.233271,7.351593,5.292446,5.579111,3.510798,7.539744099999992,8.130447219999997,9.003783740000003,9.501206200000013,8.99239280433118,9.43255222413418,9.54190623076923,9.795028691793872,9.288783769744589,7.539744099999992,8.130447219999997,9.003783740000003,9.501206200000013,9.539582666666666,5488036,6985582,53.16478398443852,0.6365664792347878,1.5,2.75,NaN,NaN,0.2411211495265078,0.7856233023962785,391.21988088528485,-0.026101888975549825,0.1940392049881936,0.22014109396374343,34.926530710943574,-1.1939623636837513,19.2223998600462,49.855423353295905,30.922176786657904,4722563876
1365082200,9.495,9.627498,9.4375,9.572498,9.180651842105263,7.630712666666658,9.633238,6.233271,7.932421,6.233271,7.351593,5.292446,5.579111,3.510798,7.557977719999992,8.158056209999996,9.028185380000004,9.518044050000013,9.015142027690741,9.44588039326426,9.540182692307692,9.79214066260785,9.288224722007534,7.557977719999992,8.158056209999996,9.028185380000004,9.518044050000013,9.545831999999999,2979268,6830869.8,56.45342117245467,0.13403766986319068,1.5,2.75,NaN,NaN,0.23746949598890005,0.436147677708628,393.5943136669156,-0.0301803868343328,0.18241561042082743,0.21259599725516024,34.13367490830666,2.6826869927476817,43.86457940590858,23.83648801629272,32.298932577798695,4725543144
1365168600,9.224998,9.474998,9.1875,9.447498,9.216600605263158,7.627489333333324,9.633238,6.233271,7.932421,6.233271,7.351593,5.292446,5.579111,3.510798,7.574778014999993,8.186973509999996,9.049220360000003,9.526173600000012,9.032097163859731,9.446034451048616,9.541471846153847,9.791339556731753,9.291604135575941,7.574778014999993,8.186973509999996,9.049220360000003,9.526173600000012,9.369998666666666,4610024,6927592,52.69430348614592,1.5960609944890507,1.5,2.75,NaN,NaN,0.24800724627540713,0.6654583584021692,391.75432938201675,-0.041070009633184884,0.16125848521367914,0.20232849484686402,31.652779479510187,-0.8473759786436955,12.50160249235122,60.11515464669021,27.383242860958596,4720933120
1365427800,9.4675,9.6375,9.372503,9.6375,9.252549368421052,7.6242659999999915,9.633238,6.233271,7.932421,6.233271,7.351593,5.292446,5.579111,3.510798,7.592186654999993,8.217599179999997,9.073955380000003,9.53784495000001,9.055838451551507,9.464269265234462,9.561479076923076,9.796825061408063,9.32613309243809,7.592186654999993,8.217599179999997,9.073955380000003,9.53784495000001,9.549167666666666,3557404,6742755.6,57.34384572643336,0.17501139244623234,1.5,2.75,NaN,NaN,0.24922080011287798,0.527589046828273,394.93610739756184,-0.035461562972236405,0.1580015411315685,0.1934631041038049,31.213299036548197,2.1112203358296235,35.70739171238787,31.014361127483042,33.278247160129084,4724490524
1365514200,9.689998,9.837503,9.595,9.7175,9.288498131578947,7.621042666666658,9.755,6.233271,7.932421,6.233271,7.351593,5.292446,5.579111,3.510798,7.609111964999993,8.248741499999998,9.097590440000001,9.548766300000011,9.081785963255369,9.488386478069275,9.574050615384616,9.82350737768041,9.324593853088821,7.609111964999993,8.248741499999998,9.097590440000001,9.548766300000011,9.716667666666666,3930076,6757600.4,59.16379237715907,2.1549133891525027,1.5,2.75,NaN,NaN,0.24874095724767237,0.5815786325572018,397.05328857553195,-0.026745696616209236,0.16003098333354338,0.1867766799497526,30.66021448264744,0.7788099316311419,35.25542211353033,31.44750703522822,33.29707085124146,4728420600
1365600600,9.814998,10.122503,9.805,10.0975,9.324446894736841,7.617819333333324,9.755,6.233271,7.932421,6.233271,7.351593,5.292446,5.579111,3.510798,7.628076244999993,8.284358829999997,9.129292160000002,9.58131270000001,9.121617886264962,9.546397289681725,9.633673153846154,9.969578330354091,9.297767977338216,7.628076244999993,8.284358829999997,9.129292160000002,9.58131270000001,10.008334333333334,4165052,6534329.4,66.47962997386387,4.43913285321548,1.5,2.75,NaN,NaN,0.2599025317299815,0.6374107800564813,401.2696587890898,0.0026671980852874255,0.1901106775563619,0.18744347947107448,35.54377786954782,4.728794169414321,71.56770867717945,6.6373467440610145,21.794944578759527,4732585652
1365687000,10.105,10.287498,10.072498,10.1925,9.360395657894736,10.287498,9.755,6.233271,7.932421,6.233271,7.351593,5.292446,5.579111,3.510798,7.649626539999994,8.323317789999997,9.160793880000002,9.617150750000011,9.16361326327418,9.607930881140607,9.68477023076923,10.126422359980692,9.243118101557767,7.649626539999994,8.323317789999997,9.160793880000002,9.617150750000011,10.184165333333333,3612628,6335354.6,68.02202055307374,4.824383580716176,1.5,2.75,NaN,NaN,0.2566952080349828,0.5702329590201628,403.9776715906351,0.025316603370906382,0.21908923368470745,0.19377263031380107,35.50052675959978,5.087394977044191,72.95666892225849,6.044190346812261,20.999140730929238,4736198280
1365773400,10.085,10.1575,9.947498,10.115003,9.396344421052632,10.305488174603173,9.755,6.233271,7.932421,6.233271,7.351593,5.292446,5.579111,3.510798,7.670218514999993,8.362135109999999,9.192745620000002,9.64123900000001,9.200922664714408,9.656223463889122,9.736829076923076,10.208495337817505,9.265162816028647,7.670218514999993,8.362135109999999,9.192745620000002,9.64123900000001,10.073333666666668,4759560,6248517.6,65.37917979092768,3.0041640416421607,1.5,2.75,NaN,NaN,0.25585997888962697,0.7617102654876095,401.85635124707545,0.03147340805411797,0.23311439038144854,0.20164098232733058,36.29044102505132,5.137506617216536,70.4527836894329,7.131763739659084,22.41545257090803,4731438720
1366032600,9.9575,9.982498,9.412498,9.43,9.432293184210526,10.323478349206349,9.755,6.233271,7.932421,6.233271,7.351593,5.292446,5.579111,3.510798,7.688835464999994,8.393277419999997,9.212413980000003,9.632993800000012,9.20990608962757,9.634678372090157,9.720490307692305,10.218109877480858,9.222870737903753,7.688835464999994,8.393277419999997,9.212413980000003,9.632993800000012,9.608331999999999,7365328,6287451.6,47.727607403028244,1.6353081456817793,1.5,2.75,NaN,NaN,0.2877631946832251,1.1714329538536727,396.0897464103207,-0.011871127619204946,0.1868020728033244,0.19867320042252934,56.01373047930725,-3.331624807790887,32.02370550349638,34.70345509813422,33.2728393983694,4724073392
1366119000,9.627498,9.8425,9.5551,9.825,9.468241947368421,10.341468523809523,9.755,6.233271,7.932421,6.233271,7.351593,5.292446,5.579111,3.510798,7.708948254999995,8.424419759999997,9.234799060000002,9.652706850000012,9.234027419446097,9.652804241414904,9.734600307692306,10.232870447981925,9.236330167402686,7.708948254999995,8.424419759999997,9.234799060000002,9.652706850000012,9.740866666666665,4727308,6126070.8,55.2332636417188,0.2751533809821057,1.5,2.75,NaN,NaN,0.2966729664915661,0.7716704808569956,400.7436792535288,-0.015019627167040805,0.17989866646372832,0.19491829363076912,60.784749271060534,4.078411881019467,34.2914280022874,32.42649080636363,33.282081191348965,4728800700
1366205400,9.62,9.62,9.245,9.377498,9.504190710526316,10.359458698412698,9.755,6.233271,7.932421,6.233271,7.351593,5.292446,5.579111,3.510798,7.7260485399999945,8.450887079999996,9.253950720000002,9.65271145000001,9.23965371672272,9.62658459937539,9.709863999999998,10.243413170899926,9.17631482910007,7.7260485399999945,8.450887079999996,9.253950720000002,9.65271145000001,9.414166,6444480,5861951,46.999601620871864,3.1218121224260935,1.5,2.75,NaN,NaN,0.31691061174216856,1.09937459388521,396.6949111242719,-0.046541257082336196,0.13674172227784887,0.18328297936018506,63.99205674936208,-2.037085826500045,12.314028878993383,60.45393647736974,27.23203464363689,4722356220
1366291800,9.439998,9.45,9.115003,9.23,9.115003,10.377448873015872,10.1925,6.233271,7.932421,6.233271,7.351593,5.292446,5.579111,3.510798,7.742657174999994,8.475496089999996,9.265252460000003,9.636507950000011,9.239275139596339,9.588814637530115,9.679807307692304,10.270966379693629,9.088648235690979,7.742657174999994,8.475496089999996,9.265252460000003,9.636507950000011,9.265001,4934124,5762219.8,44.63765780359117,4.331599686758613,1.5,2.75,NaN,NaN,0.31820249661772787,0.8562887517758347,395.0338093034135,-0.07494256815071973,0.08960476917178539,0.16454733732250512,63.78847213609604,-2.3021756659805495,3.2400788309183444,80.62792047293011,16.13200069615155,4717422096
1366378200,9.287498,9.47,9.2175,9.445,9.139142416666667,10.395439047619046,10.1925,6.233271,7.932421,6.233271,7.351593,5.292446,5.579111,3.510798,7.758144989999995,8.499821799999998,9.280354200000003,9.642637600000011,9.247342781180796,9.57511800538439,9.655961153846151,10.257973837179879,9.053948470512424,7.758144989999995,8.499821799999998,9.280354200000003,9.642637600000011,9.3775,4045380,5470040.2,48.685749901203145,2.327868595692071,1.5,2.75,NaN,NaN,0.3135094611450331,0.7395521517373858,398.5981832883878,-0.0765946953886188,0.06880396808673162,0.1453986634753504,65.17583109046979,-1.9974059662775514,12.894089350532619,59.46802530642231,27.637885343045053,4721467476
1366637400,9.5075,9.6475,9.322498,9.572498,9.163281833333333,10.413429222222222,10.1925,6.233271,7.932421,6.233271,7.351593,5.292446,5.579111,3.510798,7.774024469999995,8.525564149999997,9.298639240000002,9.64485060000001,9.26009396623253,9.574868481062067,9.666153461538459,10.257589305999723,9.074717617077194,7.774024469999995,8.525564149999997,9.298639240000002,9.64485060000001,9.514165333333333,4348024,5331115.4,50.97504978460941,0.8320619577421088,1.5,2.75,NaN,NaN,0.3143303567775308,0.8155936748245967,399.8811152417225,-0.0668039435946263,0.061893733982067545,0.12869767757669384,64.55330559774774,-1.4921739130434768,38.50858920043925,28.43078984513294,33.0606209544278,4725815500
1366723800,9.732498,9.900003,9.587503,9.89,9.18742125,10.431419396825396,10.1925,6.233271,7.932421,6.233271,7.351593,5.292446,5.579111,3.510798,7.790833129999995,8.555548169999998,9.320607660000002,9.66743870000001,9.284796163635177,9.604881006675203,9.69057669230769,10.290684289470008,9.090469095145373,7.790833129999995,8.555548169999998,9.320607660000002,9.66743870000001,9.792502,4979608,5120345,56.21382198684451,2.225406698056133,1.5,2.75,NaN,NaN,0.3152714027219929,0.9725141567609213,404.49946060819855,-0.038076393199828584,0.08110218607690811,0.1191785792767367,67.23970166519355,-2.0549641000247543,39.27002278170024,27.747644082179388,32.98233313612037,4730795108
1366810200,9.884998,9.97375,9.830003,9.915,9.211560666666667,10.449409571428571,10.1925,6.233271,7.932421,6.233271,7.351593,5.292446,5.579111,3.510798,7.808212619999995,8.584248879999997,9.343159420000001,9.681068500000011,9.309510039571052,9.634416148896612,9.726538384615383,10.320063984831343,9.133012784399423,7.808212619999995,8.584248879999997,9.343159420000001,9.681068500000011,9.906251,3147300,4985521.6,56.60701887068446,2.5318993339879654,1.5,2.75,NaN,NaN,0.30301965967042205,0.6312880080591768,407.14667649247855,-0.01756558047035109,0.09722160368879784,0.11478718415914893,63.131474909802684,-2.7225901398086987,72.71186088649387,6.15338116317187,21.134757950334254,4733942408
1366896600,9.974998,10.155498,9.9375,10.0275,9.235700083333333,10.467399746031745,10.1925,6.233271,7.932421,6.233271,7.351593,5.292446,5.579111,3.510798,7.827025434999995,8.613049589999997,9.367011180000002,9.70036500000001,9.337666508607482,9.671852706144554,9.756538384615382,10.368178332463806,9.144898436766958,7.827025434999995,8.613049589999997,9.367011180000002,9.70036500000001,10.040166000000001,3620888,4736537.6,58.41664856788213,3.2709763292723673,1.5,2.75,NaN,NaN,0.2985538268368205,0.7644588317001855,410.04395638389923,0.0023440106744651856,0.11771719750223042,0.11537318682776523,63.26499165142432,-0.8650813054627852,99.99999999999999,0,0,4737563296
1366983000,9.982498,10.0295,9.865003,9.985,9.2598395,10.48538992063492,10.1925,6.233271,7.932421,6.233271,7.351593,5.292446,5.579111,3.510798,7.8457632449999934,8.641625299999998,9.389629620000001,9.71466150000001,9.363052135720913,9.70167625794031,9.777115307692306,10.400012390479544,9.154218224905067,7.8457632449999934,8.641625299999998,9.389629620000001,9.71466150000001,9.959834333333333,2917900,4485912.8,57.4420599741097,2.17254363671741,1.5,2.75,NaN,NaN,0.28897833920561905,0.6504584752516812,407.63563746814077,0.010935993744550718,0.12904317900845363,0.11810718526390292,63.17749649396636,5.88547189819724,81.7224765767229,2.8988257953617187,15.37869762791537,4734645396
1367242200,10.044998,10.23,10,10.1675,9.283978916666666,10.503380095238095,10.1925,6.233271,7.932421,6.233271,7.351593,5.292446,5.579111,3.510798,7.866238549999994,8.672859339999997,9.415348060000003,9.741999650000011,9.394599110790681,9.746040423850756,9.78249992307692,10.417475259973358,9.14752458618048,7.866238549999994,8.672859339999997,9.415348060000003,9.741999650000011,10.1325,4093660,4388983.6,60.49028618353722,3.5608043793839297,1.5,2.75,NaN,NaN,0.2858370292623606,0.9327125305275692,411.5712607268868,0.026317962398895514,0.1510046382625223,0.12468667586362679,45.99413391461728,3.486005089058536,82.58414273634594,2.647014868695633,14.76884239495842,4738739056
1367328600,10.162498,10.2425,10.03,10.235,9.308118333333333,10.521370269841269,10.1925,6.233271,7.932421,6.233271,7.351593,5.292446,5.579111,3.510798,7.887047184999993,8.705160039999999,9.443213140000003,9.765999650000012,9.427556008406732,9.792608002531637,9.785769153846152,10.42953135773291,9.142006949959393,7.887047184999993,8.705160039999999,9.443213140000003,9.765999650000012,10.169166666666667,3918720,4382238.4,61.586207485027735,3.2196837350372953,1.5,2.75,NaN,NaN,0.28059867002933486,0.8942279361159355,414.72701149122133,0.03775039896029864,0.17187467456400007,0.13412427560370144,40.77755440307065,9.14425148371133,81.57373293920051,2.944693012363382,15.481574048436116,4742657776
1367415000,10.1675,10.18,9.927503,9.9725,9.33225775,10.539360444444444,10.1925,6.233271,7.932421,6.233271,7.351593,5.292446,5.579111,3.510798,7.906949569999994,8.734510739999997,9.462081600000003,9.792624750000012,9.448926361018232,9.8097405737191,9.774807384615382,10.400367605586357,9.149247163644407,7.906949569999994,8.734510739999997,9.462081600000003,9.792624750000012,10.026667666666667,5047068,4360190,55.176478303053464,1.33756392068472,1.5,2.75,NaN,NaN,0.28251997931295375,1.1575339606760255,411.1473850455994,0.024962168250063227,0.16532698591628048,0.14036481766621725,32.23158240774867,8.044420368364026,47.98906988750833,20.60230173338452,31.40862837910715,4737610708
1367501400,10.0425,10.2625,10.015,10.232498,9.356397166666666,10.557350619047618,10.1925,6.233271,7.932421,6.233271,7.351593,5.292446,5.579111,3.510798,7.9267332049999935,8.765619759999998,9.492699960000005,9.825624750000012,9.479654660586144,9.850003185745853,9.836537999999997,10.472113581474108,9.200962418525886,7.9267332049999935,8.765619759999998,9.492699960000005,9.825624750000012,10.169999333333333,3540328,4388243,59.65534009612659,2.8919003872929783,1.5,2.75,NaN,NaN,0.2830542665048856,0.8067757414527864,415.3591111007502,0.0309509805902764,0.17905354340406276,0.14810256281378636,30.643031072164515,8.337723663313916,47.96483685091341,20.620557175394723,31.414605973691874,4741151036
1367587800,10.5075,10.6475,10.490003,10.5325,9.380536583333333,10.575340793650794,10.1925,6.233271,7.932421,6.233271,7.351593,5.292446,5.579111,3.510798,7.948204349999994,8.79922047,9.532601660000005,9.87987485000001,9.520942713112177,9.915002882341486,9.890961076923075,10.626557892141204,9.155364261704946,7.948204349999994,8.79922047,9.532601660000005,9.87987485000001,10.556667666666668,5347356,4425109.6,64.11145484358185,5.183743811030009,1.5,2.75,NaN,NaN,0.29247910461167953,1.2084121035103854,419.14229758835563,0.050877354581678025,0.2116992560408839,0.16082190145920588,31.6987146274395,10.028751115957416,73.54180975581282,5.810117060152589,20.64807318403458,4746498392
1367847000,10.575,10.674978,10.560003,10.6375,9.404676,10.593330968253968,10.1925,6.233271,7.932421,6.233271,7.351593,5.292446,5.579111,3.510798,7.969575499999994,8.83366285,9.569486760000004,9.929874850000012,9.564729273382287,9.983812131642297,9.987884307692305,10.758525650991562,9.217242964393048,7.969575499999994,8.83366285,9.569486760000004,9.929874850000012,10.624160333333332,2822320,4388355.4,65.54582739018323,4.976364561828193,1.5,2.75,NaN,NaN,0.2817647399965595,0.6431384294900089,421.5268886454981,0.06593441688690863,0.24323992256784166,0.17730550568093303,31.66090225167871,7.558139534883708,71.83807387476737,6.528179493221574,21.63374663201105,4749320712
1367933400,10.7,10.7975,10.6125,10.785,9.428815416666666,10.611321142857141,10.1925,6.233271,7.932421,6.233271,7.351593,5.292446,5.579111,3.510798,7.990984164999994,8.86827192,9.619221760000006,9.98324985000001,9.612583027367295,10.060115738152556,10.10749969230769,10.852769729069124,9.362229655546255,7.990984164999994,8.86827192,9.619221760000006,9.98324985000001,10.731666666666667,2216764,4302689.8,67.51027116128704,5.2750491724026505,1.5,2.75,NaN,NaN,0.274852972853948,0.5152042334076699,425.7590739444971,0.07971214571383964,0.2769456878232326,0.19723354210939295,28.552738002326542,8.774583963691388,69.13054240722576,7.748578199810125,23.1208793929641,4751537476
1368019800,10.7625,10.947498,10.7425,10.945,9.452954833333333,10.629311317460317,10.1925,6.233271,7.932421,6.233271,7.351593,5.292446,5.579111,3.510798,8.012905324999993,8.904255990000001,9.668923460000004,10.02562485000001,9.66483467335289,10.144390429757074,10.222884307692304,10.98639102319484,9.45937759218977,8.012905324999993,8.904255990000001,9.668923460000004,10.02562485000001,10.878332666666665,2532876,4221081,69.53913391918195,5.325309265336328,1.5,2.75,NaN,NaN,0.26986333193580886,0.6000538724558946,428.5563156937045,0.0925818024831839,0.31296079521337283,0.22037899273018893,28.451518896043844,9.149837945649468,99.99999999999999,0,0,4754070352
1368106200,10.9225,11.0075,10.761003,10.8475,9.47709425,10.647301492063491,10.1925,6.233271,7.932421,6.233271,7.351593,5.292446,5.579111,3.510798,8.035266059999994,8.940565040000001,9.710408540000005,10.05837485000001,9.711213705770424,10.211353245970686,10.320961384615382,11.051957982443744,9.58996478678702,8.035266059999994,8.940565040000001,9.710408540000005,10.05837485000001,10.872001000000004,3724952,4226697.2,66.80158028648586,4.442583243420152,1.5,2.75,NaN,NaN,0.2681943082261082,0.8812914253710912,425.76782130881156,0.08756358751688464,0.32983347712629474,0.2422698896094101,30.38542111207875,8.637956935403112,73.18154592675987,5.958250808554256,20.860203264685875,4750345400
1368192600,10.872503,10.960025,10.77,10.9575,9.501233666666666,10.665291666666667,10.1925,6.233271,7.932421,6.233271,7.351593,5.292446,5.579111,3.510798,8.059120529999994,8.97895742,9.755560300000006,10.100499700000011,9.760087678093152,10.282414841592526,10.403076769230767,11.161303973942939,9.644849564518594,8.059120529999994,8.97895742,9.755560300000006,10.100499700000011,10.895841666666664,2819280,4129683.2,68.31699825711084,3.8924028584892327,1.5,2.75,NaN,NaN,0.26261078620995765,0.6826867494339517,428.4885149543813,0.08463925432700731,0.34806895751816924,0.26342970319116193,29.39519743592335,7.769854929923768,67.94322277355114,8.31388921744827,23.74288800900058,4753164680
1368451800,10.905,11.025003,10.835,10.98,9.525373083333333,10.68328184126984,10.1925,6.233271,7.932421,6.233271,7.351593,5.292446,5.579111,3.510798,8.083862499999995,9.014899830000001,9.798795380000007,10.177999700000012,9.80792737699146,10.348851523345619,10.484999846153842,11.244721659614065,9.72527803269362,8.083862499999995,9.014899830000001,9.798795380000007,10.177999700000012,10.946667666666665,2467664,3884800,68.63240484648244,3.870066273540787,1.5,2.75,NaN,NaN,0.2574245157663892,0.6352100494233938,425.3800587459074,0.0774036684819881,0.36018428879364706,0.28278062031165896,29.076197372650707,7.278944797264299,68.5336259401747,8.092454604218915,23.373919455606373,4755632344
1368538200,10.995,11.337503,10.995,11.325,9.549512499999999,10.701272015873014,10.1925,6.233271,7.932421,6.233271,7.351593,5.292446,5.579111,3.510798,8.110383634999994,9.051875590000002,9.846313840000006,10.25299970000001,9.86742042103101,10.44181804493175,10.584807538461535,11.415492089987051,9.754122986936018,8.110383634999994,9.051875590000002,9.846313840000006,10.25299970000001,11.219167666666666,2985060,3797687.6,73.06083528359586,5.516502203781915,1.5,2.75,NaN,NaN,0.2645729789259328,0.7860204193730943,429.1110103671429,0.08824995232537969,0.39309306071838357,0.3048431083930039,31.94857434953659,13.562296314865872,70.81432370654073,7.0341051203909855,22.151571173068273,4758617404
1368624600,11.2725,11.5625,11.252525,11.4875,9.573651916666666,10.71926219047619,10.1925,6.233271,7.932421,6.233271,7.351593,5.292446,5.579111,3.510798,8.136242289999995,9.092218,9.892132340000007,10.358499800000011,9.930952953539599,10.541406802557297,10.700384461538459,11.581651023580793,9.819117899496124,8.136242289999995,9.092218,9.892132340000007,10.358499800000011,11.434175000000002,3564632,3653695.2,74.86109016379355,5.825230780238484,1.5,2.75,NaN,NaN,0.2678159804312233,0.9756238013504793,430.96201806788235,0.09801315852452958,0.42735955654866586,0.3293463980241363,22.18416739238706,12.264864356680071,73.41246624459998,5.911394803375669,20.676138952024367,4762182036
1368711000,11.43,11.5475,11.287498,11.3425,9.597791333333333,10.737252365079364,10.1925,6.233271,7.932421,6.233271,7.351593,5.292446,5.579111,3.510798,8.159584289999994,9.12982709,9.934267520000006,10.464124800000011,9.9863077396753,10.617701392789936,10.790769076923075,11.675893064895368,9.905645088950783,8.159584289999994,9.12982709,9.934267520000006,10.464124800000011,11.392499333333333,3911964,3602587.2,70.34382903901971,4.786996110424203,1.5,2.75,NaN,NaN,0.2672578389718502,1.0858762835775355,428.8852312520871,0.0867383857988423,0.4377693802726892,0.3510309944738469,25.537899690158618,7.690481841917861,71.10441370131133,6.904358076563323,21.99122822212533,4758270072
1368797400,11.4575,11.68,11.4175,11.662498,9.621930749999999,10.75524253968254,10.1925,6.233271,7.932421,6.233271,7.351593,5.292446,5.579111,3.510798,8.184551279999994,9.17257782,9.981819340000007,10.574999700000012,10.052040691060583,10.717205831571846,10.900576615384615,11.835452427408548,9.965700803360683,8.184551279999994,9.17257782,9.981819340000007,10.574999700000012,11.586666,4243524,3612494.4,74.0634238930856,5.46909143092591,1.5,2.75,NaN,NaN,0.27227513618814664,1.1746797448322688,432.8014894983836,0.09234584938668755,0.46646330620720633,0.3741174568205188,25.257967407478525,9.635703877790835,74.29549502756588,5.550079958719315,20.154425013714807,4762513596
1369056600,11.634998,11.7975,11.5925,11.66,9.646070166666666,10.773232714285713,10.1925,6.233271,7.932421,6.233271,7.351593,5.292446,5.579111,3.510798,8.210122439999994,9.21612022,10.026937880000007,10.679374800000012,10.115097918862128,10.806995752374528,11.030384307692307,11.878336363667675,10.18243225171694,8.210122439999994,9.21612022,10.026937880000007,10.679374800000012,11.683333333333332,4353036,3612745,73.98541277253692,5.265211067948771,1.5,2.75,NaN,NaN,0.2674697693175648,1.2049109472160366,434.95621851681193,0.08744940294448078,0.48342921050111975,0.395979807556639,25.955915955190704,8.113120074177099,44.376499735368945,23.475581513275802,32.147918751355256,4758160560
1369143000,11.695,11.8425,11.572498,11.705003,9.670209583333333,10.791222888888889,10.1925,6.233271,7.932421,6.233271,7.351593,5.292446,5.579111,3.510798,8.236035279999994,9.26104597,10.071056480000008,10.770124950000014,10.17744713773028,10.892520252148381,11.143653923076924,11.925864102388955,10.361443743764893,8.236035279999994,9.26104597,10.071056480000008,10.770124950000014,11.706666999999998,5313656,3629447.4,74.50638887557133,5.067495344895861,1.5,2.75,NaN,NaN,0.2676506429377387,1.4640399527487298,436.3822667086267,0.07905807697398187,0.49480240377411633,0.41574432680013446,25.93784120966514,6.943837368661482,51.540925111281126,18.065976119873767,30.393098768845093,4763474216
1369229400,11.7575,12.109975,11.285,11.462503,9.694348999999999,12.109975,10.1925,6.233271,7.932421,6.233271,7.351593,5.292446,5.579111,3.510798,8.261448069999995,9.30382172,10.111375100000009,10.847500100000014,10.227841485270268,10.946804323372346,11.215192615384616,11.927749420723526,10.502635810045707,8.261448069999995,9.30382172,10.111375100000009,10.847500100000014,11.619159333333334,10790436,4011604.2,66.74923963624093,3.6271805541939846,1.5,2.75,NaN,NaN,0.30745952558504314,2.6898057390606978,431.9821024181561,0.050388156245801397,0.4787295221073862,0.4283413658615848,30.336055594552953,5.66953675962203,15.829080309834117,54.82832625322387,29.342593436941996,4752683780
1369315800,11.0825,11.4375,11.035,11.36,9.718488416666666,12.172819034482758,10.1925,6.233271,7.932421,6.233271,7.351593,5.292446,5.579111,3.510798,8.284481744999994,9.34806408,10.149060320000007,10.914125100000014,10.272239858396924,10.98615629257498,11.27076953846154,11.902551388971357,10.638987687951722,8.284481744999994,9.34806408,10.149060320000007,10.914125100000014,11.277499999999998,5366592,4098889.4,63.72890803998255,0.9841904110069075,1.5,2.75,NaN,NaN,0.3160340594718257,1.3092795331340241,429.4102006122773,0.019330366485460604,0.45250432396841056,0.43317395748294996,30.34170889705011,3.6732831394022347,14.278973295664093,57.244682859496606,28.476343844839302,4747317188
1369402200,11.145,11.32,11.0475,11.32,9.742627833333334,12.235663068965518,10.1925,6.233271,7.932421,6.233271,7.351593,5.292446,5.579111,3.510798,8.307111249999993,9.388223150000002,10.18279556000001,10.980875100000015,10.313328491400966,11.017950931377364,11.311923384615387,11.878061797349636,10.745784971881138,8.307111249999993,9.388223150000002,10.18279556000001,10.980875100000015,11.229166666666666,3885108,4147249.8,62.5396614161637,0.3577648881547703,1.5,2.75,NaN,NaN,0.31578162665240955,0.9367914129503364,427.20196859100014,-0.00765125503748304,0.42360988868609617,0.4312611437235792,30.448722593428492,3.096539162112931,4.262756002590424,77.61969800695245,18.117545990457128,4743432080
1369747800,11.689998,11.824178,11.4225,11.525003,9.76676725,12.298507103448276,10.1925,6.233271,7.932421,6.233271,7.351593,5.292446,5.579111,3.510798,8.330282444999993,9.424865630000001,10.221397540000009,11.048750250000015,10.360845138797007,11.066241604579519,11.356539000000001,11.890482023251906,10.822595976748097,8.330282444999993,9.424865630000001,10.221397540000009,11.048750250000015,11.590560333333334,5694792,4227306.4,66.03764783951613,2.6942061674866036,1.5,2.75,NaN,NaN,0.32923851046295166,1.34714436597262,430.6166980617621,-0.015010634246237442,0.4124978509157824,0.42750848516201984,31.562181136965513,1.766030905077268,15.429134326595847,55.4672882991665,29.103577374237663,4749126872
1369834200,11.3325,11.412498,11.115003,11.3075,9.790906666666666,12.361351137931035,11.705003,6.233271,7.932421,6.233271,7.351593,5.292446,5.579111,3.510798,8.352257789999992,9.45971641,10.258932760000008,11.102375250000014,10.397968858844184,11.089218594619565,11.391923615384618,11.840362425611001,10.943484805158235,8.352257789999992,9.45971641,10.258932760000008,11.102375250000014,11.278333666666667,5443116,4303526.2,59.67115064626846,0.44141314359066935,1.5,2.75,NaN,NaN,0.3350071882870265,1.2648037323439554,424.7779559805507,-0.03661451489670314,0.3817403415411409,0.41835485643784404,29.4090250871923,-1.5669205658324394,3.6192296381669604,79.50504174484054,16.87572861699251,4743683756
1369920600,11.314998,11.572498,11.3,11.4175,9.815046083333332,12.424195172413794,11.705003,6.233271,7.932421,6.233271,7.351593,5.292446,5.579111,3.510798,8.374678969999993,9.494667190000001,10.299734640000008,11.174625250000014,10.437950472222843,11.120483490370082,11.427308230769231,11.799089718267261,11.055526743271201,8.374678969999993,9.494667190000001,10.299734640000008,11.174625250000014,11.429999333333333,3351952,4218770.4,61.68307532681339,1.6822963230296064,1.5,2.75,NaN,NaN,0.3305422462665245,0.7945329283622545,426.85018126923404,-0.0450301337274851,0.3620671892784877,0.4070973230059728,28.700844717854647,0.6612298875909285,17.935984059252164,51.753701549679974,30.310314391067855,4747035708
1370007000,11.314998,11.5075,10.88,10.938,9.8391855,12.487039206896553,11.705003,6.233271,7.932421,6.233271,7.351593,5.292446,5.579111,3.510798,8.394531819999994,9.525706320000001,10.327413240000007,11.209900350000014,10.457560257625868,11.103104110334836,11.424077461538463,11.811741864788026,11.0364130582889,8.394531819999994,9.525706320000001,10.327413240000007,11.209900350000014,11.108500000000001,5644144,4323961.2,49.978411485397494,1.3018765778206016,1.5,2.75,NaN,NaN,0.35175351439034414,1.3053179108082653,420.3903696104729,-0.0822563249406062,0.30427691683021507,0.38653324177082127,37.28213896609446,-6.212202565865381,17.82530125635425,51.91190325270843,30.262795490937307,4741391564
1370266200,11,11.125,10.7625,11.095,9.863324916666667,12.54988324137931,11.705003,6.233271,7.932421,6.233271,7.351593,5.292446,5.579111,3.510798,8.415227999999994,9.558782100000002,10.362865100000008,11.238025350000013,10.482557894581717,11.102332290302947,11.406385153846156,11.829861024583954,10.982909283108357,8.415227999999994,9.558782100000002,10.362865100000008,11.238025350000013,10.994166666666667,7577084,4435447.6,53.11544020085335,2.1132155975348486,1.5,2.75,NaN,NaN,0.35252112050531964,1.7083019986528531,417.675416988062,-0.09478154448945525,0.2680563111590022,0.36283785564845744,33.747170910154786,-4.845626072041162,46.40863913954088,21.84719245693699,31.744168403522142,4748968648
1370352600,11.115003,11.252498,10.775003,10.9525,9.887464333333332,12.61272727586207,11.705003,6.233271,7.932421,6.233271,7.351593,5.292446,5.579111,3.510798,8.435165849999994,9.589907880000002,10.391350340000008,11.253775350000016,10.500986996754984,11.088062548369333,11.36523130769231,11.848885093429672,10.881577521954949,8.435165849999994,9.589907880000002,10.391350340000008,11.253775350000016,10.993333666666667,7126364,4650649.8,50.04752390821695,2.3051228001860524,1.5,2.75,NaN,NaN,0.36144782618351107,1.5323372660740873,414.3254584476884,-0.11006544483195008,0.22525604960851986,0.33532149444046994,33.87706097850283,-6.428900530824289,17.604501849670676,52.17995309851074,30.21554505181859,4741842284
1370439000,10.845,10.913503,10.455003,10.474998,9.91160375,12.675571310344829,11.705003,6.233271,7.932421,6.233271,7.351593,5.292446,5.579111,3.510798,8.452628694999994,9.614425330000003,10.41208554000001,11.238275250000015,10.499967820411651,11.029675448524635,11.298500384615387,11.976586519382957,10.620414249847817,8.452628694999994,9.614425330000003,10.41208554000001,11.238275250000015,10.614501333333333,9672984,5023460.8,41.41520378673858,5.031035954136676,1.5,2.75,NaN,NaN,0.37116562431326033,1.925561756150262,408.9272527272661,-0.14740540914149747,0.15106473301359813,0.2984701421550956,39.50462015957017,-8.61509043879858,13.686812283081982,58.18074126486313,28.132446452054893,4732169300
1370525400,10.462503,10.765,10.285,10.765,9.935743166666667,12.738415344827587,11.705003,6.233271,7.932421,6.233271,7.351593,5.292446,5.579111,3.510798,8.470754054999993,9.641767800000002,10.434537460000008,11.229275250000015,10.510361239219037,11.00446826295086,11.229462076923078,11.92770586801281,10.531218285833345,8.470754054999993,9.641767800000002,10.434537460000008,11.229275250000015,10.605,6878864,5240760.2,47.35427501470385,4.051396192391172,1.5,2.75,NaN,NaN,0.3789395082908846,1.3125698825143726,412.15171595710257,-0.1472959854229578,0.11435016037639834,0.26164614579935613,44.48488719440623,-5.237676056338018,19.474078629387222,49.55582616724947,30.970095203363293,4739048164
1370611800,10.9875,11.197498,10.849998,11.16,9.959882583333332,12.801259379310345,11.705003,6.233271,7.932421,6.233271,7.351593,5.292446,5.579111,3.510798,8.490726914999994,9.673351930000003,10.464906060000008,11.244900250000015,10.535837269053586,11.019280809336493,11.19100053846154,11.843746355648086,10.538254721274992,8.490726914999994,9.673351930000003,10.464906060000008,11.244900250000015,11.069165333333334,6889700,5398997.6,54.16934691691619,0.3074446933179596,1.5,2.75,NaN,NaN,0.3827651148415356,1.2761072536872402,416.1698201481761,-0.1166833025645436,0.11579201759367663,0.23247532015822023,50.55475061241626,-1.413427561837457,41.09117500826287,26.19876177865652,32.710063213080595,4745937864
1370871000,11.2775,11.294998,11.085,11.175,9.984022,12.864103413793105,11.705003,6.233271,7.932421,6.233271,7.351593,5.292446,5.579111,3.510798,8.510756439999994,9.705002730000002,10.494424660000007,11.255775250000015,10.560902474188739,11.034111208447303,11.15023107692308,11.731793992592682,10.568668161253477,8.510756439999994,9.705002730000002,10.494424660000007,11.255775250000015,11.184999333333332,3956268,5455847,54.41069792764433,0.9860177198266047,1.5,2.75,NaN,NaN,0.37042460663856863,0.7251427688496397,414.0470803863622,-0.09254130264564916,0.11679869185115876,0.20933999449680793,50.570243233367144,-3.0369015956004453,35.180602228950285,31.54870342555705,33.270694345492664,4749894132
1370957400,10.86,11.1175,10.7625,10.837503,10.008161416666667,12.926947448275863,11.705003,6.233271,7.932421,6.233271,7.351593,5.292446,5.579111,3.510798,8.529421394999995,9.733245230000001,10.518759980000006,11.248650400000015,10.571749553632317,11.015386617166607,11.102154153846156,11.675789564752286,10.528518742940026,8.529421394999995,9.733245230000001,10.518759980000006,11.248650400000015,10.905834333333333,9634052,5814166.4,48.253473316659615,1.2463780178395563,1.5,2.75,NaN,NaN,0.373429991878671,1.6569962634712345,407.3061605678211,-0.0960051796586196,0.08933351992353344,0.18533869958215304,51.48805657752309,-4.156506743311955,30.634038437557713,36.138002315084705,33.22795924735758,4740260080
1371043800,11.052503,11.0825,10.5275,10.5675,10.032300833333332,12.989791482758621,11.705003,6.233271,7.932421,6.233271,7.351593,5.292446,5.579111,3.510798,8.546738414999995,9.757246060000002,10.535009980000007,11.210775400000015,10.571582904470265,10.972730748865025,11.041192615384615,11.659004066510672,10.423381164258558,8.546738414999995,9.757246060000002,10.535009980000007,11.210775400000015,10.725833333333334,12123688,6271097.8,43.96690318681512,3.429980002266834,1.5,2.75,NaN,NaN,0.38639927817305164,1.9332640610388823,401.6648343581866,-0.11206417873496632,0.04525847616344514,0.15732265489841146,52.17018610339427,-7.4447120648127845,26.789099974735173,40.369308850661234,32.8415911746036,4728136392
1371130200,10.54,11.0925,10.4725,11.0325,10.05644025,13.05263551724138,11.705003,6.233271,7.932421,6.233271,7.351593,5.292446,5.579111,3.510798,8.567184589999995,9.785321880000003,10.566860020000009,11.188025400000015,10.589658084687118,10.978423058496928,11.01907723076923,11.6156003737808,10.42255408775766,8.567184589999995,9.785321880000003,10.566860020000009,11.188025400000015,10.865833333333333,9785164,6582124.4,51.89298906883532,1.0505968635073577,1.5,2.75,NaN,NaN,0.4030850440178336,1.4866270227284066,409.06603546191144,-0.08801412575419204,0.047304997705671425,0.13531912345986347,59.06452602378212,0.8639605046626442,31.864191666279385,34.8545019348348,33.281306398885796,4737921556
1371216600,11.002498,11.127498,10.775003,10.825,10.080579666666667,13.115479551724139,11.705003,6.233271,7.932421,6.233271,7.351593,5.292446,5.579111,3.510798,8.586001604999996,9.810047720000004,10.591910060000009,11.162150400000014,10.59888717940527,10.963811338640078,10.965230846153846,11.491609476256578,10.438852216051114,8.586001604999996,9.810047720000004,10.591910060000009,11.162150400000014,10.909167000000002,9815456,6877299,48.5899733489242,0.8601425899251025,1.5,2.75,NaN,NaN,0.3994714694451312,1.4272254267263935,407.074249048976,-0.0828020164249152,0.03181660292871946,0.11461861935363467,54.65648557749074,-2.4335286164939283,11.693284390206562,61.52119410861685,26.785521501176586,4728106100
1371475800,11.055,11.232498,10.9075,11.09,10.104719083333332,13.178323586206897,11.705003,6.233271,7.932421,6.233271,7.351593,5.292446,5.579111,3.510798,8.606126959999996,9.836990230000003,10.62476010000001,11.133525500000015,10.618146505703104,10.975829306388642,10.948500076923077,11.44317082305721,10.453829330788944,8.606126959999996,9.836990230000003,10.62476010000001,11.133525500000015,11.076665999999998,11221656,7226205.6,52.728219941778235,0.8895637616547004,1.5,2.75,NaN,NaN,0.4000447930561933,1.5529112540058367,410.66091846932466,-0.05932782391002253,0.04045883946610651,0.09978666337612904,55.95202285720018,1.2554211367267682,20.6940906185192,47.90666752045138,31.39924186102943,4739327756
1371562200,11.11,11.392503,11.1025,11.3325,10.1288585,13.241167620689657,11.705003,6.233271,7.932421,6.233271,7.351593,5.292446,5.579111,3.510798,8.627539809999996,9.866307740000003,10.65866010000001,11.117150500000015,10.646160368224551,11.009797943875437,10.941961615384617,11.413362627706586,10.470560603062648,8.627539809999996,9.866307740000003,10.65866010000001,11.117150500000015,11.27583433333333,9159472,7466527.4,56.20252658839358,2.7842201770465635,1.5,2.75,NaN,NaN,0.3930775221236081,1.2267378808520812,414.69861958543396,-0.026938544735044423,0.06611348245732351,0.09305202719236794,56.5505611007689,8.18617817397197,44.34545554343893,23.477397018672423,32.177147437888635,4748487228
1371648600,11.3175,11.37,10.857498,10.892503,10.152997916666667,13.304011655172415,11.705003,6.233271,7.932421,6.233271,7.351593,5.292446,5.579111,3.510798,8.646690179999997,9.889875300000003,10.68216016000001,11.076525500000015,10.655820863588295,10.99862699683968,10.93846184615385,11.410603514299428,10.46632017800827,8.646690179999997,9.889875300000003,10.68216016000001,11.076525500000015,11.040000333333332,13747560,7888222.6,49.144777425827556,0.6611203729775985,1.5,2.75,NaN,NaN,0.4016078419719218,1.7427956457516807,409.0670757727405,-0.034153327200559414,0.05036036819166867,0.08451369539222808,55.06152014824115,1.1844217371109989,41.250644781885754,26.05564111221294,32.69371410590129,4734739668
1371735000,10.555,10.599998,9.9775,10.064998,10.177137333333333,13.366855689655173,11.705003,6.233271,7.932421,6.233271,7.351593,5.292446,5.579111,3.510798,8.662486349999996,9.905401140000002,10.68151012000001,11.006650250000016,10.632651339526008,10.909709949521616,10.859230923076925,11.511165226231167,10.207296619922683,8.662486349999996,9.905401140000002,10.68151012000001,11.006650250000016,10.214165333333332,17889548,8243178.2,39.17976580160095,7.300283708611579,1.5,2.75,NaN,NaN,0.4382789246882131,2.1702245864343923,399.7196162248205,-0.09046497035491222,-0.02856751755141218,0.06189745280350003,70.20616226288864,-9.811845878136209,14.35796192562761,57.09066717096172,28.551370903410664,4716850120
1371821400,10.2575,10.287498,9.857498,10.16,10.20127675,13.429699724137933,11.705003,6.233271,7.932421,6.233271,7.351593,5.292446,5.579111,3.510798,8.678370029999996,9.920827000000001,10.680860120000009,10.946650250000015,10.61411599287793,10.83830900194813,10.798269384615388,11.545206172104763,10.051332597126013,8.678370029999996,9.920827000000001,10.680860120000009,10.946650250000015,10.101665333333333,16165076,8783102.4,40.6672144460029,6.600461100663339,1.5,2.75,NaN,NaN,0.4376875729247693,1.8404745002175995,399.2234772864637,-0.11551919567798477,-0.08250154179398095,0.03301765388400383,65.80630329388063,-9.082774049217006,37.8230455039799,29.095277957920977,33.08167653809911,4733015196
1372080600,9.837503,10.0325,9.517503,9.7725,9.517503,13.492543758620691,11.705003,6.233271,7.932421,6.233271,7.351593,5.292446,5.579111,3.510798,8.692382879999997,9.933377840000002,10.67401006000001,10.869275250000017,10.581111444137619,10.736803382714974,10.744231076923082,11.65956354680525,9.828898607040914,8.692382879999997,9.933377840000002,10.67401006000001,10.869275250000017,9.774167666666667,15412008,9359447.4,36.722219458225005,8.751905010850718,1.5,2.75,NaN,NaN,0.45231681771585724,1.646679268692722,392.45996503030455,-0.1501973519829135,-0.15472903609463806,-0.004531684111724547,67.43124955371478,-9.8270145807572,15.794506727218854,54.841280244398405,29.364213028382743,4717603188
1372167000,10.037498,10.159973,9.84,10.060003,9.526252999999999,13.55538779310345,11.705003,6.233271,7.932421,6.233271,7.351593,5.292446,5.579111,3.510798,8.707874914999996,9.949512050000003,10.686610120000012,10.796025250000017,10.56067581887732,10.672346203408786,10.690000538461543,11.674880588952227,9.70512048797086,8.707874914999996,9.949512050000003,10.686610120000012,10.796025250000017,10.019992,12648200,9707117.8,41.2740631578433,5.2495646133254,1.5,2.75,NaN,NaN,0.4476851164504389,1.302982024180236,397.4362244583023,-0.14567027084741763,-0.18661952267099657,-0.040949251823578954,70.46084043686598,-4.802431984859245,17.71234757981005,52.006175035545525,30.28147738464443,4730251388
1372253400,10.2975,10.415,10.18,10.337503,9.535003,13.618231827586207,11.705003,6.233271,11.705003,6.233271,7.932421,5.292446,7.351593,3.510798,8.722650299999996,9.965829620000001,10.69686018000001,10.747525400000017,10.551923943627228,10.640456374512711,10.626731538461543,11.588105519660285,9.665357557262801,8.722650299999996,9.965829620000001,10.69686018000001,10.747525400000017,10.310834333333332,11986768,10034300.4,45.35965367111585,2.004149098386885,1.5,2.75,NaN,NaN,0.44106453670397894,1.1945793450632591,403.4362244583023,-0.11711377956754156,-0.1873414762830059,-0.07022769671546435,72.02270359486744,-6.29954226150012,39.83078277344526,27.280491069453497,32.888726157101246,4742238156
1372339800,10.5275,10.669998,10.505,10.525003,9.543752999999999,13.681075862068967,11.705003,6.233271,11.705003,6.233271,7.932421,5.292446,7.351593,3.510798,8.737884019999997,9.986880500000002,10.719810280000011,10.702900550000017,10.550868220347729,10.62946081503531,10.576731769230774,11.484989690533258,9.66847384792829,8.737884019999997,9.986880500000002,10.719810280000011,10.702900550000017,10.566666999999999,13806412,10557023.4,47.99243258719806,0.452780544139504,1.5,2.75,NaN,NaN,0.43330956979655183,1.3077940132253567,409.74612262030263,-0.0804697617467288,-0.17081489889887536,-0.09034513715214655,67.56549895016676,-2.7713348729792093,73.71312917264105,5.748580771506234,20.538290055852716,4756044568
1372426200,10.439998,10.590198,10.287498,10.3125,9.552503,13.743919896551725,11.705003,6.233271,11.705003,6.233271,7.932421,5.292446,7.351593,3.510798,8.752696884999997,10.003356370000002,10.74146028000001,10.671625550000018,10.541520447000758,10.599274070746233,10.536346923076927,11.441315277035642,9.631378569118212,8.752696884999997,10.003356370000002,10.74146028000001,10.671625550000018,10.396732,13672424,10958437.4,45.3267756788321,1.0217620986433111,1.5,2.75,NaN,NaN,0.4239803148110838,1.247661824486035,411.05713368051534,-0.06602142905269524,-0.1728719234680156,-0.10685049441532037,67.67896991401386,-7.010820559062217,42.595814453960195,24.906548789424164,32.49763675661564,4742372144
1372685400,10.5675,10.794998,10.517503,10.575,9.561252999999999,13.806763931034485,11.705003,6.233271,11.705003,6.233271,7.932421,5.292446,7.351593,3.510798,8.768505584999996,10.022207240000002,10.76406028000001,10.645625550000016,10.542833370647788,10.596962254484687,10.53692384615385,11.441980463957432,9.63186722835027,8.768505584999996,10.022207240000002,10.76406028000001,10.645625550000016,10.629166999999999,13891104,11274138.4,49.08857534490506,1.2051443953775292,1.5,2.75,NaN,NaN,0.4281601494674349,1.2321211171223514,415.78351809964795,-0.035778269310855024,-0.15157333105388915,-0.11579506174303413,67.82982685517258,-6.684315023163471,75.56263569338626,5.0007226911895115,19.436641615424225,4756263248
1372771800,10.525003,10.759998,10.41,10.5225,9.570003,13.869607965517243,11.705003,6.233271,11.705003,6.233271,7.932421,5.292446,7.351593,3.510798,8.783743459999997,10.040849780000004,10.783060320000011,10.624125550000016,10.542035983563562,10.589870611200432,10.497693076923081,11.356452279389401,9.638933874456761,8.783743459999997,10.040849780000004,10.783060320000011,10.624125550000016,10.564166,13630616,11599351,48.37172706185568,0.5652161950474188,1.5,2.75,NaN,NaN,0.4225771387911895,1.1751188493218285,413.04085110888474,-0.01724163256982364,-0.13734710245531367,-0.12010546988549003,65.73386805141618,-3.396859289366262,46.800558713249345,21.489729896271896,31.70971139047877,4742632632
1372858200,10.405,10.657123,10.355,10.5575,9.578752999999999,13.932452000000001,11.705003,6.233271,11.705003,6.233271,7.932421,5.292446,7.351593,3.510798,8.797364684999996,10.058508990000004,10.796410320000012,10.628250650000016,10.542642415580676,10.58678769584801,10.47711615384616,11.316110362068159,9.63812194562416,8.797364684999996,10.058508990000004,10.796410320000012,10.628250650000016,10.523207666666666,6910144,11461209,48.907398220977385,0.76505864307933,1.5,2.75,NaN,NaN,0.41397327173467596,0.6029158005931137,409.8146380495495,-0.001390796028668137,-0.12184396492132521,-0.12045316889265707,62.59157123598462,4.893215080618993,42.2229513468058,25.176575012878,32.60047364031621,4749542776
1373031000,10.794998,10.913173,10.5675,10.892503,9.587503,13.99529603448276,11.705003,6.233271,11.705003,6.233271,7.932421,5.292446,7.351593,3.510798,8.812165094999997,10.079559900000003,10.815960380000012,10.634625800000018,10.55636243849908,10.61590343910058,10.461924076923083,11.26223764972063,9.661610504125536,8.812165094999997,10.079559900000003,10.815960380000012,10.634625800000018,10.791058666666666,7978416,11516186.6,53.843754291884835,2.354456092514603,1.5,2.75,NaN,NaN,0.4098089666107706,0.6928001670275125,411.96092726050153,0.03109436643981628,-0.08158521084288672,-0.112679577282703,42.46230232807815,7.209675196850389,36.17847327976423,30.569378163838955,33.25214855639681,4757521192
1373290200,11.072498,11.179748,11.015025,11.0825,9.596252999999999,14.05814006896552,11.705003,6.233271,11.705003,6.233271,7.932421,5.292446,7.351593,3.510798,8.828311314999997,10.102035780000003,10.837060380000011,10.630750800000019,10.576995284048136,10.660341206805287,10.442693307692313,11.166791737947113,9.718594877437512,8.828311314999997,10.102035780000003,10.837060380000011,10.630750800000019,11.09242433333333,6358648,11489634,56.41569703276998,4.079939471827367,1.5,2.75,NaN,NaN,0.40105439756714417,0.5534247653145435,414.482627948326,0.06297786173291767,-0.033957250116555926,-0.09693511184947359,42.8036086067884,13.404962906114083,65.82576528310527,9.357809549156652,24.816425167738085,4763879840
1373376600,11.2925,11.3675,11.152528,11.325,9.605003,14.120984103448277,11.705003,6.233271,11.705003,6.233271,7.932421,5.292446,7.351593,3.510798,8.845795039999997,10.126745000000005,10.863860380000013,10.638250800000018,10.606328802320759,10.723642044252403,10.475962307692312,11.310925750755866,9.640998864628758,8.845795039999997,10.126745000000005,10.863860380000013,10.638250800000018,11.281676,8708568,11727249,59.5163964323777,5.247677544789143,1.5,2.75,NaN,NaN,0.3927647977409196,0.742592572222181,418.8031217472646,0.09601993770589393,0.023089810282893808,-0.07293012742300012,30.552592074787498,12.57451911296646,61.75612412640856,11.545052183284335,26.698823690307098,4772588408
1373463000,11.305,11.4525,11.225025,11.335,9.613752999999999,14.183828137931036,11.705003,6.233271,11.705003,6.233271,7.932421,5.292446,7.351593,3.510798,8.863249599999996,10.151279220000003,10.887210380000013,10.663125650000017,10.634904143406219,10.781866611466459,10.573654769230775,11.48693580519865,9.6603737332629,8.863249599999996,10.151279220000003,10.887210380000013,10.663125650000017,11.337508333333334,8383160,11664704.4,59.64389688421659,4.535953628202893,1.5,2.75,NaN,NaN,0.38095838361656825,0.7186774488687429,420.2009854704171,0.11299961368315972,0.06831938968094953,-0.04468022400221019,30.010261681627988,9.649303124748801,99.99999999999999,0,0,4780971568
1373549400,11.7375,11.837503,11.6175,11.8075,9.622503,14.246672172413795,11.705003,6.233271,11.705003,6.233271,7.932421,5.292446,7.351593,3.510798,8.883104164999997,10.180936760000002,10.918660380000013,10.725125650000018,10.680888294645191,10.879545981802986,10.700385538461544,11.789244102098394,9.611526974824695,8.883104164999997,10.180936760000002,10.918660380000013,10.725125650000018,11.754167666666666,8938080,11505424,65.21798461149783,6.7884316075584605,1.5,2.75,NaN,NaN,0.3896401419296705,0.7768579410893506,428.6364018798186,0.14827970638981186,0.14066940898505464,-0.007610297404757216,33.37115564757055,12.185241182354051,99.99999999999999,0,0,4789909648
1373635800,11.794998,11.8875,11.7375,11.802503,9.631253,14.309516206896554,11.705003,6.233271,11.705003,6.233271,7.932421,5.292446,7.351593,3.510798,8.902987904999996,10.20867102,10.955260440000012,10.763625800000018,10.724873185051262,10.967446650202701,10.856539615384621,11.95057100849953,9.762508222269712,8.902987904999996,10.20867102,10.955260440000012,10.763625800000018,11.809167666666667,7355788,11383955.2,65.11555122809179,6.148546774400841,1.5,2.75,NaN,NaN,0.372522988934694,0.6461539834591057,427.5725089660965,0.16237000254248019,0.195352205773343,0.03298220323086283,34.087853813632634,14.448513939393937,77.69314921964164,4.214188149388124,18.092662630970242,4782553860
1373895000,11.9175,12.005,11.8525,11.9575,9.640003,14.372360241379312,11.705003,6.233271,11.705003,6.233271,7.932421,5.292446,7.351593,3.510798,8.923804959999995,10.241230220000002,10.989760480000013,10.82025080000002,10.77321149151984,11.06173744542149,11.00250092307693,12.138028219774869,9.866973626378991,8.923804959999995,10.241230220000002,10.989760480000013,10.82025080000002,11.93833333333333,6809040,11233634.4,66.85454016325205,6.337366147252586,1.5,2.75,NaN,NaN,0.3603782754393588,0.606129749068565,430.8716085358298,0.17228067734722788,0.24833304991489769,0.07605237256766981,27.418124628333427,13.07328605200946,78.68732393931613,3.8737684805785375,17.438907580105344,4789362900
1373981400,11.974998,11.9925,11.7225,11.8125,9.648753,14.43520427586207,11.705003,6.233271,11.705003,6.233271,7.932421,5.292446,7.351593,3.510798,8.945059499999996,10.273981070000001,11.015360480000012,10.85637580000002,10.813967903617101,11.133238641095634,11.115962230769238,12.257775022036812,9.974149439501664,8.945059499999996,10.273981070000001,11.015360480000012,10.85637580000002,11.842500000000001,9300036,11137553.4,63.65752920409201,4.636259722501211,1.5,2.75,NaN,NaN,0.3539226843365474,0.8350160637613643,427.57711941965636,0.15951434230916137,0.2754453004541215,0.11593095814496016,30.462712083041804,12.25944404846756,46.7738720845386,21.529263335698,31.696864579763393,4780062864
1374067800,11.9525,12.015,11.857498,11.905,9.657503,14.49804831034483,11.705003,6.233271,11.705003,6.233271,7.932421,5.292446,7.351593,3.510798,8.967480704999995,10.30509862,11.040710480000012,10.885000800000018,10.856753476024274,11.20673972289605,11.222115846153853,12.380894989052326,10.06333670325538,8.967480704999995,10.30509862,11.040710480000012,10.885000800000018,11.925832666666667,10057504,11182455,64.81350216542232,4.568041933148606,1.5,2.75,NaN,NaN,0.34310677831250835,0.899400355288709,431.05510526525273,0.1479968589105107,0.30092703178309854,0.15293017287258784,28.843786150580407,12.763438313994792,49.69790855584989,19.337344657952837,30.964746786197267,4790120368
1374154200,11.974998,12.185003,11.962503,12.1125,9.666253,14.560892344827588,11.705003,6.233271,11.705003,6.233271,7.932421,5.292446,7.351593,3.510798,8.989893584999994,10.34324112,11.06726048000001,10.94600065000002,10.905998437748812,11.29300260642976,11.360577384615393,12.48103769746338,10.240117071767406,8.989893584999994,10.34324112,11.06726048000001,10.94600065000002,12.086668666666668,10161088,11003131.4,67.32433990170836,5.123916248600595,1.5,2.75,NaN,NaN,0.33859936557590065,0.9234723853247813,434.5891016482139,0.14486761359755104,0.33401468986952665,0.1891470762719756,28.355282351619252,11.200336598484308,51.613106180007186,17.96851177419159,30.41838204580122,4800281456
1374240600,12.03,12.177503,11.982498,12.177503,9.675003,14.623736379310348,11.705003,6.233271,11.705003,6.233271,7.932421,5.292446,7.351593,3.510798,9.013189809999993,10.380417,11.09191054000001,11.051625900000019,10.955861361758663,11.377240739150734,11.483846846153854,12.583895476980649,10.38379821532706,9.013189809999993,10.380417,11.09191054000001,11.051625900000019,12.112501333333334,6259340,10421621,68.09247171075242,4.39781643366718,1.5,2.75,NaN,NaN,0.3283426251776221,0.6006109798082275,433.9224349815472,0.1377359853835429,0.36131705800140423,0.22358107261786134,26.33414474734854,9.880469208211146,74.75274033656389,5.322845720468462,19.924413942967647,4806540796
1374499800,12.212503,12.287498,12.13,12.2375,9.683753,14.686580413793106,11.705003,6.233271,11.705003,6.233271,7.932421,5.292446,7.351593,3.510798,9.036544354999993,10.41505954,11.11971054000001,11.15550090000002,11.006121700513225,11.45917019256495,11.615769923076932,12.631099344248955,10.60044050190491,9.036544354999993,10.41505954,11.11971054000001,11.15550090000002,12.218332666666669,5344812,9880607.8,68.82101304784855,4.462127929171101,1.5,2.75,NaN,NaN,0.3161394376649347,0.5409395968535458,436.18047958520293,0.12783619344475167,0.38337631442380093,0.25554012097904927,26.23600221416252,8.057395143487872,74.54833738847896,5.4304442507393365,20.0212183607817,4811885608
1374586200,12.302503,12.3075,12.14,12.169998,9.692503,14.749424448275864,11.705003,6.233271,11.705003,6.233271,7.932421,5.292446,7.351593,3.510798,9.059390554999993,10.4497604,11.14396050000001,11.275375800000019,11.051763908336236,11.526868078987334,11.739808230769238,12.587906005783836,10.891710455754641,9.059390554999993,10.4497604,11.14396050000001,11.275375800000019,12.205832666666666,7102408,9465127.8,66.96832516110655,3.7734080715328084,1.5,2.75,NaN,NaN,0.30552233497458214,0.7503763446279087,438.4675670847904,0.10829228070101748,0.3909054718553211,0.2826131911543036,26.423573500897042,7.366546096162318,79.59204812694676,3.58927242952196,16.818679443531295,4804783200
1374672600,12.3,12.310003,11.95,12.025003,9.701253,14.812268482758622,11.705003,6.233271,11.705003,6.233271,7.932421,5.292446,7.351593,3.510798,9.081070119999993,10.48182797,11.164860560000008,11.373625800000019,11.089930147225012,11.57430950003616,11.826923615384622,12.529091400764262,11.124755830004982,9.081070119999993,10.48182797,11.164860560000008,11.373625800000019,12.095002,11014848,9383460.2,63.04245963966979,2.552736051680296,1.5,2.75,NaN,NaN,0.30941381104782634,1.1738578056738602,434.52926744133606,0.07853590184000786,0.3807830684543134,0.30224716661430556,28.494043739546104,1.8420749523607933,41.89066539512645,25.553095479316397,32.556239125557155,4793768352
1374759000,11.947498,12.134998,11.8975,12.1235,9.710003,14.875112517241382,11.705003,6.233271,11.705003,6.233271,7.932421,5.292446,7.351593,3.510798,9.102346344999992,10.513572199999999,11.18083056000001,11.46292565000002,11.130462298314226,11.626613357175573,11.907000538461546,12.476159067689558,11.337842009233533,9.102346344999992,10.513572199999999,11.18083056000001,11.46292565000002,12.051999333333331,6072064,9087725,64.56226038863313,1.9742178524297196,1.5,2.75,NaN,NaN,0.3042769674015529,0.6681610634124602,436.5448318784107,0.059298517006834806,0.37637031287284906,0.31707179586601425,18.149988693115585,2.719736652471092,34.742630397103405,32.051776469444576,33.20559313345201,4799840416
1374845400,11.955003,12.155,11.805375,12.1375,9.718753,14.93795655172414,11.705003,6.233271,11.705003,6.233271,7.932421,5.292446,7.351593,3.510798,9.12376756499999,10.54298145,11.193830560000011,11.54355050000002,11.16995397289014,11.675269227920756,11.969500538461546,12.43901215936376,11.499988917559332,9.12376756499999,10.54298145,11.193830560000011,11.54355050000002,12.032625000000001,6883708,8741589.8,64.78393407754966,1.5755700799087045,1.5,2.75,NaN,NaN,0.3075161125871563,0.7874663713916202,434.3950361621573,0.042135134890039505,0.3697407144785636,0.3276055795885241,18.075143526727242,1.5053313819778358,35.879661979226874,30.957039334322275,33.16329868645086,4806724124
1375104600,12.052503,12.134998,11.934398,12.03,9.727502999999999,15.0008005862069,12.2375,6.233271,11.705003,6.233271,7.932421,5.292446,7.351593,3.510798,9.145038824999991,10.57092404,11.207580560000011,11.62942550000002,11.203681268070918,11.709053110975923,12.022962076923083,12.316663788154013,11.729260365692152,9.145038824999991,10.57092404,11.207580560000011,11.62942550000002,12.033132,5346368,8325287,61.59769954051102,1.1823617789131267,1.5,2.75,NaN,NaN,0.3000579616880736,0.6421842274026108,429.8066190681507,0.019321549698145812,0.35175751671120636,0.33243596701306055,17.90877293187528,1.8412698412698358,16.594403985090047,53.586012755647396,29.81958325926255,4801377756
1375191000,12.150003,12.177503,11.95,12.03,9.736253,15.063644620689658,12.2375,6.233271,11.705003,6.233271,7.932421,5.292446,7.351593,3.510798,9.167451699999992,10.59837497,11.21493060000001,11.70217550000002,11.236085924225,11.739619481359169,12.040077461538468,12.306197568619828,11.773957354457108,9.167451699999992,10.59837497,11.21493060000001,11.70217550000002,12.052501,6519932,7956728.4,61.59769954051102,1.1090038526079644,1.5,2.75,NaN,NaN,0.2948754644246398,0.8194237219407916,430.29848844498866,0.000978813655111932,0.33365948408195045,0.3326806704268385,15.98678284255424,1.0499790004199916,26.264887037912157,40.94282656382588,32.79228639826196,4801377756
1375277400,12.107498,12.3,12.009998,12.060003,9.745002999999999,15.126488655172416,12.2375,6.233271,11.705003,6.233271,7.932421,5.292446,7.351593,3.510798,9.190718749999991,10.62493427,11.22293066000001,11.77905065000002,11.268396397784803,11.7701321974202,12.05988515384616,12.28793348446302,11.8318368232293,9.190718749999991,10.62493427,11.22293066000001,11.77905065000002,12.123333666666667,8793832,7714889.2,62.19947413571283,1.7365173154564293,1.5,2.75,NaN,NaN,0.29452735982287986,1.1398520149842204,431.007369649997,-0.011687633769637662,0.31807112821479144,0.3297587619844291,15.545958065471192,-0.43341176470588794,76.7432961884418,4.556717403276852,18.69998640828134,4810171588
1375363800,12.3275,12.50475,12.3125,12.465,9.753753,15.189332689655174,12.2375,6.233271,11.705003,6.233271,7.932421,5.292446,7.351593,3.510798,9.215977449999992,10.65459354,11.23813060000001,11.874425650000019,11.315322029244223,11.83631008338018,12.09892361538462,12.404181606236282,11.79366562453296,9.215977449999992,10.65459354,11.23813060000001,11.874425650000019,12.427416666666668,6253804,7682072.2,69.21272885119902,3.545229928798103,1.5,2.75,NaN,NaN,0.30525733412124556,0.8140777432422465,435.0497586826,0.0038255821550522984,0.3345407396782445,0.3307151575231922,22.51622546462487,2.3608862999253635,77.09008785653579,4.430051710198795,18.479860433265426,4816425392
1375450200,12.39,12.537498,12.3425,12.5275,9.762502999999999,12.537498,12.2375,6.233271,11.705003,6.233271,7.932421,5.292446,7.351593,3.510798,9.241944489999991,10.68540282,11.259430540000013,11.956175500000018,11.362858420254254,11.90213769448683,12.15392361538462,12.48911915564368,11.818728075125561,9.241944489999991,10.68540282,11.259430540000013,11.956175500000018,12.469166000000001,6214176,7593860.2,70.13363841662282,3.1657052272007533,1.5,2.75,NaN,NaN,0.29738166739829947,0.8183158283582834,436.0815125917432,0.014321959043100352,0.3486176063270676,0.33429564728396727,22.50299793623717,2.369765066394273,76.63218379834417,4.597643530686452,18.770172670969366,4822639568
1375709400,12.4575,12.537425,12.405025,12.4875,9.771253,12.54604846,12.2375,6.233271,11.705003,6.233271,7.932421,5.292446,7.351593,3.510798,9.266796949999991,10.71552043,11.281980540000012,12.02642550000002,11.406962011616832,11.957886485488086,12.198731307692315,12.54441543228664,11.85304718309799,9.266796949999991,10.71552043,11.281980540000012,12.02642550000002,12.476650000000001,3798156,7465835.6,68.71695007396549,2.6757512371215464,1.5,2.75,NaN,NaN,0.28559726258413526,0.5087382315249481,432.6815125917432,0.01454968781138788,0.3524827570482021,0.3379330692368142,22.708605420303094,2.608891143614001,82.94097294629127,2.547351144478813,14.51167590922992,4818841412
1375795800,12.4075,12.4375,12.185003,12.28,9.780002999999999,12.55459892,12.2375,6.233271,11.705003,6.233271,7.932421,5.292446,7.351593,3.510798,9.28944733499999,10.74198805,11.30118054000001,12.07417550000002,11.441198795474996,11.988563963060649,12.211615923076929,12.555967045014954,11.867264801138903,9.28944733499999,10.74198805,11.30118054000001,12.07417550000002,12.300834333333334,6200828,7340448.6,61.748774480773946,1.1136136348232641,1.5,2.75,NaN,NaN,0.2868043866852685,0.8447478264475553,427.3290250572395,-0.0023933314144365947,0.33494140496876845,0.33733473638320505,24.879053684798986,2.120556643520168,60.083395618935015,12.526891109836885,27.389713271228096,4812640584
1375882200,12.1525,12.195,12.009998,12.1525,9.788753,12.563149379999999,12.2375,6.233271,11.705003,6.233271,7.932421,5.292446,7.351593,3.510798,9.31095605499999,10.76756401,11.313730480000011,12.11505050000002,11.46909296035833,12.004176918959635,12.209692615384622,12.555062170727693,11.864323060041551,9.31095605499999,10.76756401,11.313730480000011,12.11505050000002,12.119166000000002,6038884,7223234.8,57.865888788351185,0.35599197562196483,1.5,2.75,NaN,NaN,0.2856042162077493,0.8360359544175416,424.7601984658758,-0.024099593773644068,0.30721024416614995,0.331309837939794,24.600565020094155,0.23920485008454584,26.901226272522887,40.247936166766166,32.85083756071094,4806601700
1375968600,12.325,12.355,12.0925,12.265,9.797502999999999,12.571699839999999,12.2375,6.233271,11.705003,6.233271,7.932421,5.292446,7.351593,3.510798,9.33330227999999,10.79590662,11.33288048000001,12.13792550000002,11.500305001128591,12.02901721239205,12.211808000000007,12.558168374705534,11.865447625294479,9.33330227999999,10.79590662,11.33288048000001,12.13792550000002,12.237499999999999,7320376,7142349.6,60.241540822882335,1.082064045323119,1.5,2.75,NaN,NaN,0.283953915050053,1.0249254671039907,428.08825335831506,-0.0322823193434395,0.29095693876049467,0.32323925810393417,24.719146734312787,1.0504634397528427,29.176727385760863,37.70824883743778,33.11502377680136,4813922076
1376055000,12.2225,12.337503,12.044998,12.175,9.806253,12.5802503,12.5275,6.233271,11.705003,6.233271,7.932421,5.292446,7.351593,3.510798,9.357173484999988,10.82388256,11.34803048000001,12.156550350000021,11.526763628535313,12.042920335021378,12.212192769230777,12.558377572229366,11.866007966232187,9.357173484999988,10.82388256,11.34803048000001,12.156550350000021,12.185833666666667,5729336,7061027,57.45079854371884,0.07433170557232555,1.5,2.75,NaN,NaN,0.2845647068321921,0.8114026472353101,427.10671648476097,-0.04440930103964458,0.2677276318043784,0.312136932844023,25.19754586613862,1.2053200332502192,8.243449626147939,68.10161341466004,23.65493695919202,4808192740
1376314200,11.985,12.169378,11.9735,12.1175,9.815002999999999,12.58880076,12.5275,6.233271,11.705003,6.233271,7.932421,5.292446,7.351593,3.510798,9.38073218999999,10.849516860000001,11.371620480000008,12.16455035000002,11.549929760749615,12.050023160257437,12.219307923076931,12.553402020090573,11.88521382606329,9.38073218999999,10.849516860000001,11.371620480000008,12.16455035000002,12.086792666666668,4097836,6925466.8,55.676187547872956,0.672762559949005,1.5,2.75,NaN,NaN,0.2786315134870356,0.5917053851157008,428.20474825063354,-0.05619745778932089,0.24189011060737187,0.29808756839669276,24.751542364923775,0.7273482959268526,8.02490768241325,68.54325671679231,23.431835600794443,4804094904
1376400600,12.1825,12.2892,11.9775,12.240003,9.823753,12.597351219999998,12.5275,6.233271,11.705003,6.233271,7.932421,5.292446,7.351593,3.510798,9.406482559999988,10.87869282,11.394520540000007,12.185925500000021,11.576991456406493,12.068116478328157,12.2282696923077,12.557822474809063,11.898716909806337,9.406482559999988,10.87869282,11.394520540000007,12.185925500000021,12.168901,5421384,6731534.2,58.60958204844223,0.568381647951481,1.5,2.75,NaN,NaN,0.28099354823796163,0.8053712332026776,425.1049586364542,-0.055539834656770426,0.22866277507572974,0.28420260973250017,25.30918748103783,1.4925369421549872,27.36018960003545,39.70870361922602,32.93110678073853,4809516288
1376487000,12.2175,12.267825,12.035028,12.0475,9.832502999999999,12.605901679999999,12.5275,6.233271,11.705003,6.233271,7.932421,5.292446,7.351593,3.510798,9.431528739999987,10.903885439999996,11.416420540000008,12.19305050000002,11.595442771841531,12.066153004201666,12.221346615384622,12.561835782124781,11.880857448644463,9.431528739999987,10.903885439999996,11.416420540000008,12.19305050000002,12.116784333333333,3802356,6418776.8,52.70657109158033,0.6292617163365164,1.5,2.75,NaN,NaN,0.2775509376495358,0.5923801556707814,421.12756349250037,-0.06709227199095447,0.20033726974380706,0.2674295417347615,27.21959033813435,-3.349378259125555,32.286582086099,34.41162848677214,33.30178942712886,4805713932
1376573400,11.75,11.755,11.474998,11.5225,9.841253,12.61445214,12.5275,6.233271,11.705003,6.233271,7.932421,5.292446,7.351593,3.510798,9.453633259999988,10.924728059999998,11.437370580000009,12.163550500000019,11.592582270985,12.01437652761103,12.182308153846162,12.68115077788202,11.683465529810302,9.453633259999988,10.924728059999998,11.437370580000009,12.163550500000019,11.584166000000002,7564444,6288944.6,40.674643602157886,4.507838688455944,1.5,2.75,NaN,NaN,0.298618870674569,1.2028161291164816,419.08577778168524,-0.10675840573009313,0.13398153457214512,0.24073994030223825,29.012045696993255,-8.022350828178,5.412044397544548,74.5233437332986,20.064611869156856,4798149488
1376659800,11.4675,11.587503,11.352525,11.4375,9.850003,12.6230026,12.5275,6.233271,11.705003,6.233271,7.932421,5.292446,7.351593,3.510798,9.475408609999988,10.942679019999998,11.45082058000001,12.12655035000002,11.586500613299314,11.95943590593379,12.13673123076924,12.772408935013557,11.501053526524922,9.475408609999988,10.942679019999998,11.45082058000001,12.12655035000002,11.459176,5701612,6261058.2,39.11764766650252,4.636004961799163,1.5,2.75,NaN,NaN,0.294073094197814,0.910646701862634,417.97609090752763,-0.13364319936583152,0.07368594109494886,0.20732914046078038,27.852442691089276,-8.408408408408414,5.580555689799678,74.10247183802234,20.316972472178005,4792447876
1376919000,11.39,11.497503,11.2,11.2025,9.858753,12.63155306,12.5275,6.233271,11.705003,6.233271,7.932421,5.292446,7.351593,3.510798,9.496163129999989,10.95828832,11.451670580000009,12.074800350000018,11.57144176571895,11.887346772035333,12.070769461538472,12.879114080180646,11.262424842896298,9.496163129999989,10.95828832,11.451670580000009,12.074800350000018,11.300001000000002,5994964,6293565.8,35.115474434061056,5.182584039780528,1.5,2.75,NaN,NaN,0.2943180874693988,0.9525544326556498,416.41342156186585,-0.1603756010211185,0.00685963918438226,0.16723524020550076,28.308612086966516,-8.774429967426702,4.897246769761018,75.83842100186732,19.264332228371664,4786452912
1377005400,11.2575,11.4925,11.22,11.3675,9.867503,12.640103519999998,12.5275,6.233271,11.705003,6.233271,7.932421,5.292446,7.351593,3.510798,9.51646349499999,10.97497262,11.455520580000009,12.03467545000002,11.563444049416246,11.837837555651015,11.986346384615395,12.840320661698561,11.132372107532229,9.51646349499999,10.97497262,11.455520580000009,12.03467545000002,11.36,5524652,6214678,39.77459199077721,3.8378622134812197,1.5,2.75,NaN,NaN,0.294009652650156,0.8889683423662497,420.1550789486398,-0.15971853570497044,-0.03241292942571228,0.12730560627925816,31.45993387053394,-6.4595762188850046,4.455156492768888,77.02715651105039,18.517686996180725,4791977564
1377091800,11.2725,11.455003,11.077598,11.165,9.876253,12.648653979999999,12.5275,6.233271,11.705003,6.233271,7.932421,5.292446,7.351593,3.510798,9.536788849999988,10.990415250000002,11.462070520000008,11.991675300000018,11.547818792576393,11.773757788446156,11.881538692307702,12.777529142385031,10.985548242230372,9.536788849999988,10.990415250000002,11.462070520000008,11.991675300000018,11.232533666666667,8779800,6102925.6,36.32698569819073,4.241415464190645,1.5,2.75,NaN,NaN,0.29996646317514486,1.4386215031033642,418.40832871931786,-0.16501768816528292,-0.0789665039273455,0.08605118423793742,31.98958351514245,-8.968609865470864,3.253261982131872,80.56361566732105,16.183122350547077,4783197764
1377178200,11.2275,11.505,11.224998,11.4525,9.885003,12.65720444,12.5275,6.233271,11.705003,6.233271,7.932421,5.292446,7.351593,3.510798,9.55829753999999,11.00739025,11.47977052000001,11.958125300000018,11.544080800710653,11.743161808594142,11.801923307692316,12.651100203560267,10.952746411824366,9.55829753999999,11.00739025,11.47977052000001,11.958125300000018,11.394166,5799792,6089312,43.77800499984011,2.407290010866397,1.5,2.75,NaN,NaN,0.3028260015197775,0.9524543987892228,424.5342794804057,-0.1421255282467337,-0.09160572607047968,0.050519802176254,36.317581357392086,-5.93429158110883,17.14445066830076,52.78451432693855,30.071035004760688,4788997556
1377264600,11.560003,11.615003,11.400003,11.57,9.893753,12.6657549,12.5275,6.233271,11.705003,6.233271,7.932421,5.292446,7.351593,3.510798,9.579568744999989,11.02869027,11.49052052000001,11.92975030000002,11.54509723989847,11.726670207775651,11.747307923076932,12.556872616247645,10.937743229906218,9.579568744999989,11.02869027,11.49052052000001,11.92975030000002,11.528335333333333,4485560,5969404.6,46.53185388804138,1.0999110972138684,1.5,2.75,NaN,NaN,0.29655271569693625,0.7514250248676393,426.76021161534305,-0.11328871475711265,-0.09109109127013681,0.022197623486975834,37.601224472246535,-4.518258716731995,36.998799618751384,29.80581858571232,33.195381795536306,4793483116
1377523800,11.607498,11.715,11.4225,11.439998,9.902503,12.674305359999998,12.5275,6.233271,11.705003,6.233271,7.932421,5.292446,7.351593,3.510798,9.60271073999999,11.04736527,11.502820480000008,11.90025020000002,11.54097570107892,11.699368092749399,11.692500076923086,12.48111947328084,10.903880680565331,9.60271073999999,11.04736527,11.502820480000008,11.90025020000002,11.525832666666666,6434912,6023831.8,43.96591214715782,0.8650596130463878,1.5,2.75,NaN,NaN,0.296263236004298,1.0682423104841672,424.7357137641968,-0.09777437252323987,-0.100020342167074,-0.0022459696438341357,37.76604131910387,-6.5359869601339184,36.96214334508113,29.918813333363836,33.119043321555026,4787048204
1377610200,11.0975,11.23,10.8625,10.892503,9.911253,12.682855819999999,12.5275,6.233271,11.705003,6.233271,7.932421,5.292446,7.351593,3.510798,9.62439441499999,11.061815320000001,11.498870540000008,11.84337535000002,11.515545399075826,11.622523798201836,11.586923384615393,12.4075380253129,10.766308743917884,9.62439441499999,11.061815320000001,11.498870540000008,11.84337535000002,10.995001,10715204,6233595.4,35.16995579963674,5.23165799993108,1.5,2.75,NaN,NaN,0.3163514334325623,1.7189444152888074,418.59405275108315,-0.11784416497697363,-0.14955117586505118,-0.03170701088807755,43.49101045742636,-9.587026354015356,11.550464266006113,61.833737426527215,26.615798307466665,4776333000
1377696600,10.8825,11.1175,10.8325,10.997503,10.8325,12.691406279999999,12.5275,6.233271,11.705003,6.233271,7.932421,5.292446,7.351593,3.510798,9.64650726499999,11.07541535,11.492170600000009,11.790250350000019,11.495230010876774,11.5629980078969,11.496346692307698,12.297020593754524,10.695672790860872,9.64650726499999,11.07541535,11.492170600000009,11.790250350000019,10.982501,7798844,6183846,37.74244103770049,4.2101629217378544,1.5,2.75,NaN,NaN,0.31411204533023646,1.2611640069949996,421.07900747904097,-0.11725601474735287,-0.17827702932226863,-0.061021014574915766,45.01509159959198,-4.556276849642011,37.51380265822471,29.407342695786646,33.07885464598864,4784131844
1377783000,10.925,11.23,10.91,11.060003,10.861086891304348,12.69995674,12.5275,6.233271,11.705003,6.233271,7.932421,5.292446,7.351593,3.510798,9.66879093999999,11.08884038,11.49552060000001,11.720000500000019,11.478162284960039,11.515093721430528,11.415000769230774,12.159632238230927,10.670369300230622,9.66879093999999,11.08884038,11.49552060000001,11.720000500000019,11.066667666666667,5964740,6169392.8,39.28675438595161,2.927423766872097,1.5,2.75,NaN,NaN,0.31453261352093387,0.9668277241157347,424.3533805468727,-0.10619569859775875,-0.1937656378221142,-0.08756993922435545,39.44288686117889,-3.300520218579235,37.43737408474438,29.477878204259863,33.08474771099576,4790096584
1377869400,11.12,11.12,10.852178,10.9375,10.889673782608694,12.7085072,12.5275,6.233271,11.705003,6.233271,7.932421,5.292446,7.351593,3.510798,9.69079960499999,11.09724038,11.51297064000001,11.64050050000002,11.456959842412587,11.460084795580002,11.314808230769236,11.927224454729155,10.702392006809317,9.69079960499999,11.09724038,11.51297064000001,11.64050050000002,10.969892666666667,8155892,6266478.6,37.33206933810176,3.370334361927965,1.5,2.75,NaN,NaN,0.31119614112658134,1.3015111868410434,420.5715389873418,-0.10071584955893367,-0.21346475117302255,-0.11274890161408888,39.61485086351991,-2.3655434054898508,17.239086180187336,52.73298778891993,30.027926030892736,4781940692
1378215000,11.2625,11.3325,10.9575,11.085,10.918260673913043,12.717057659999998,12.5275,6.233271,11.705003,6.233271,7.932421,5.292446,7.351593,3.510798,9.71474158499999,11.10616538,11.53147064000001,11.570375500000019,11.442373181925818,11.424362434096192,11.240769769230777,11.692650242518301,10.788889295943253,9.71474158499999,11.10616538,11.53147064000001,11.570375500000019,11.125,8747544,6513948,41.130062621185324,2.088115485527828,1.5,2.75,NaN,NaN,0.3171821310461112,1.3428943553126307,421.38120284077456,-0.0815604794575358,-0.21469950093600865,-0.13313902147847284,39.324187246725906,-2.4851550472839135,38.79617845141859,28.18042931808063,33.02339223050079,4790688236
1378301400,11.107498,11.4225,11.044998,11.375,10.946847565217391,12.725608119999999,12.5275,6.233271,11.705003,6.233271,7.932421,5.292446,7.351593,3.510798,9.74045022999999,11.11876535,11.56352064000001,11.52512550000002,11.4397310963601,11.419661249896555,11.229423615384622,11.659310595587586,10.799536635181658,9.74045022999999,11.11876535,11.56352064000001,11.52512550000002,11.280832666666667,6272284,6517520.8,47.82521091960689,0.814934915833224,1.5,2.75,NaN,NaN,0.3214906931142461,0.9623726862521099,425.6693329345908,-0.0455578039217594,-0.1900862763806721,-0.1445284724589127,41.42262365881188,1.8808777429467163,73.05385986585696,6.013242514060494,20.932897620082553,4796960520
1378387800,11.39,11.5,11.365003,11.395,10.97543445652174,12.734158579999999,12.5275,6.233271,11.705003,6.233271,7.932421,5.292446,7.351593,3.510798,9.765846384999989,11.13841535,11.59022058000001,11.48725050000002,11.437976935718527,11.417312559430217,11.226154384615391,11.650269741267357,10.802039027963426,9.765846384999989,11.13841535,11.59022058000001,11.48725050000002,11.420001,4842328,6457693,48.26222063576406,0.9429511137672665,1.5,2.75,NaN,NaN,0.3081697150346571,0.7498541661859739,423.7576463874431,-0.018009817249680843,-0.16704074402101377,-0.14903092677133292,39.79792025980149,-0.5020737830168173,70.54922032403525,7.099279988457866,22.351499687506877,4801802848
1378474200,11.517503,11.6175,11.105,11.419998,11.004021347826086,12.74270904,12.5275,6.233271,11.705003,6.233271,7.932421,5.292446,7.351593,3.510798,9.789392544999991,11.154365330000001,11.61187048000001,11.445000400000017,11.43727187941584,11.417568315674957,11.242885000000005,11.678939657163355,10.806830342836655,9.789392544999991,11.154365330000001,11.61187048000001,11.445000400000017,11.380832666666668,8379380,6510643.2,48.83902581028887,1.4794834126464778,1.5,2.75,NaN,NaN,0.32276473538932443,1.2870279851920006,426.6028595772126,0.0031548319552198167,-0.14508738682730815,-0.14824221878252797,36.94018001102853,-1.296473638720835,72.98848107750244,6.040544455065059,20.970974467432487,4810182228
1378733400,11.5125,11.775003,11.5125,11.759998,11.032608239130434,12.7512595,12.5275,6.233271,12.5275,6.233271,11.705003,5.292446,7.932421,3.510798,9.814538704999991,11.17819033,11.636570380000009,11.424250300000017,11.449927805713259,11.450180666563057,11.273077153846158,11.786884512135142,10.759269795557174,9.814538704999991,11.17819033,11.636570380000009,11.424250300000017,11.682500333333332,6572228,6552787.8,56.02073289379091,2.8656966902234444,1.5,2.75,NaN,NaN,0.3250676114329441,1.002966706780891,431.6714038302571,0.03930454425495081,-0.09911153846383947,-0.13841608271879027,40.38953160506209,2.797203286224353,100,0,0,4816754456
1378819800,11.962503,12.0225,11.89,12.009998,11.061195130434783,12.759809959999998,12.5275,6.233271,12.5275,6.233271,11.705003,5.292446,7.932421,3.510798,9.84074319999999,11.205990309999999,11.67052034000001,11.418875200000016,11.471891342744112,11.50349660308086,11.338077000000006,11.97885547533378,10.69729852466623,9.84074319999999,11.205990309999999,11.67052034000001,11.418875200000016,11.974166000000002,9019664,6798879.2,60.42027455448059,4.222849126212591,1.5,2.75,NaN,NaN,0.3205986391877339,1.3266398379309343,435.33944764877197,0.07711840338985135,-0.042018078481476095,-0.11913648187132744,40.860867990664055,10.259304036914196,100,0,0,4825774120
1378906200,11.97,12.134998,11.9075,12.134998,11.08978202173913,12.768360419999999,12.5275,6.233271,12.5275,6.233271,11.705003,5.292446,7.932421,3.510798,9.86635604499999,11.23289029,11.701720300000009,11.413624950000017,11.497895525381598,11.563639593263636,11.39057684615385,12.15931203998804,10.621841652319661,9.86635604499999,11.23289029,11.701720300000009,11.413624950000017,12.059165333333334,4611920,6758406,62.44330094669764,4.140856393575904,1.5,2.75,NaN,NaN,0.3139485935314671,0.6823975949358473,437.01522185136673,0.10584007612288071,0.013163613282273445,-0.09267646284060727,22.165697054423887,10.343211545384435,100,0,0,4830386040
1378992600,12.1175,12.162498,11.982498,12.04,11.118368913043478,12.776910879999999,12.5275,6.233271,12.5275,6.233271,11.705003,5.292446,7.932421,3.510798,9.89156472999999,11.25756531,11.732070300000007,11.413249950000017,11.519154524386241,11.609007251048052,11.426730692307697,12.26672433719222,10.586737047423172,9.89156472999999,11.25756531,11.732070300000007,11.413249950000017,12.061665333333334,5680564,6852316.4,59.93600446174588,3.4963969518813593,1.5,2.75,NaN,NaN,0.304380836850648,0.8289990812449932,433.08675703405,0.11307631567186975,0.04866893174922993,-0.06440738392263982,24.63278437378904,8.860729965443943,81.06695979693517,3.1030909050186444,15.829949298046193,4824705476
1379079000,12.07,12.1375,11.9875,12.10775,11.146955804347826,12.78546134,12.5275,6.233271,12.5275,6.233271,11.705003,5.292446,7.932421,3.510798,9.91764548999999,11.279742809999998,11.763075300000008,11.442512450000017,11.542236699900506,11.656506560472046,11.478096230769236,12.393347711327499,10.562844750210973,9.91764548999999,11.279742809999998,11.763075300000008,11.442512450000017,12.077583333333331,2942492,6621218.8,61.134572811018394,3.225813343714543,1.5,2.75,NaN,NaN,0.2933536342184587,0.44440337781920153,435.6067799434533,0.11659503966323065,0.08133641565639849,-0.03525862400683216,24.635603335862655,10.699428571428566,77.26513865184937,4.378114983046097,18.35674636510455,4827647968
1379338200,12.509998,12.5225,12.265,12.32,11.175542695652174,12.794011799999998,12.5275,6.233271,12.5275,6.233271,11.705003,5.292446,7.932421,3.510798,9.94402084499999,11.303792809999997,11.791625240000007,11.486637450000016,11.572737221473036,11.719696411855661,11.587903692307695,12.537658290402424,10.638149094212965,9.94402084499999,11.303792809999997,11.791625240000007,11.486637450000016,12.369166666666667,5932384,6632757.4,64.69772463031804,4.660995496770006,1.5,2.75,NaN,NaN,0.30202480320285463,0.8944069023239113,440.0807188156618,0.12655514833878062,0.1229353114166436,-0.003619836922137007,21.301840387283487,11.141181777176358,77.62120452653349,4.2765197326191355,18.1022757408474,4833580352
1379424600,12.349998,12.4925,12.349998,12.474998,11.20412958695652,12.802562259999998,12.5275,6.233271,12.5275,6.233271,11.705003,5.292446,7.932421,3.510798,9.970658689999988,11.328267789999998,11.819475200000008,11.550262350000017,11.608119997101545,11.791629896440837,11.701557153846156,12.694152935089797,10.708961372602516,9.970658689999988,11.328267789999998,11.819475200000008,11.550262350000017,12.439165333333333,3184356,6492227,67.07183798167688,4.63895177098259,1.5,2.75,NaN,NaN,0.2927730315455078,0.4904874706321883,443.8622528958996,0.13608833311752133,0.16649057947476464,0.030402246357243326,21.285138277225894,9.670312087912082,70.9338204947683,6.971503301908914,22.09467620332278,4836764708
1379511000,12.4675,13.02,12.377498,12.9325,11.232716478260869,12.811112719999999,12.5275,6.233271,12.5275,6.233271,11.705003,5.292446,7.932421,3.510798,9.999684044999988,11.357742789999998,11.851625200000008,11.628512350000017,11.660056467803445,11.9002841920179,11.84559538461539,12.959972499936642,10.731218269294137,9.999684044999988,11.357742789999998,11.851625200000008,11.628512350000017,12.776665999999999,7134888,6572738.8,72.87120772359232,6.132345980094692,1.5,2.75,NaN,NaN,0.31775367214940015,1.0855273908039675,448.8663607974552,0.1638491107061748,0.23521363473996182,0.07136452403378703,24.319313828606983,13.49275998244844,74.88549086544818,5.307138978327311,19.80737015622451,4843899596
1379597400,13.0225,13.037498,12.8175,12.87,11.261303369565217,13.037498,12.5275,6.233271,12.5275,6.233271,11.705003,5.292446,7.932421,3.510798,10.028813564999988,11.384767789999996,11.882325200000007,11.713762350000017,11.707505233771936,11.992638078492385,11.994249230769235,13.099963366174293,10.888535095364176,10.028813564999988,11.384767789999996,11.882325200000007,11.713762350000017,12.908332666666666,7936812,6530589.4,71.03072700575007,5.820887956268514,1.5,2.75,NaN,NaN,0.3107711241387286,1.21532858887132,446.3710318278268,0.1680205664201402,0.2813902320589623,0.11336966563882209,25.673271401531856,12.69704250386033,64.38673417176017,10.178237235552986,25.43502859268685,4835962784
1379683800,12.945,12.945,12.555,12.585,11.289890260869564,13.052649515151515,12.5275,6.233271,12.5275,6.233271,11.705003,5.292446,7.932421,3.510798,10.056713914999987,11.408267789999998,11.897875200000009,11.770387350000018,11.74191679323186,12.049053499588348,12.109633846153852,13.120747104609059,11.098520587698644,10.056713914999987,11.408267789999998,11.897875200000009,11.770387350000018,12.695000000000002,6187228,6549961.2,63.19294105383978,3.7742138371423524,1.5,2.75,NaN,NaN,0.31643032955739087,0.9446205574469663,441.8081739370803,0.1426056345252624,0.2916267087954001,0.1490210742701377,32.1992962620035,7.01532432233408,40.10516105657741,27.12460270709029,32.77023623633231,4829775556
1379943000,12.535,12.56435,12.29,12.4225,11.318477152173912,13.06780103030303,12.5275,6.233271,12.5275,6.233271,11.705003,5.292446,7.932421,3.510798,10.083639264999986,11.432767789999996,11.910275140000008,11.813012350000019,11.76860633075218,12.084619832960886,12.190210769230772,13.117810083426344,11.2626114550352,10.083639264999986,11.432767789999996,11.910275140000008,11.813012350000019,12.425616666666665,6947168,6673041.6,59.183005922553406,1.4222183654001503,1.5,2.75,NaN,NaN,0.31489959173186305,1.0410796779687392,439.2907347620455,0.10747145751727788,0.28336039616673503,0.17588893864945715,31.92291062690342,3.4346550265870146,13.849773419809972,57.85133160996815,28.298894970221873,4822828388
1380029400,12.405,12.5425,12.2575,12.3325,11.34706404347826,13.082952545454544,12.5275,6.233271,12.5275,6.233271,11.705003,5.292446,7.932421,3.510798,10.109693784999987,11.453767809999995,11.917775140000009,11.85763745000002,11.790719807977585,12.108227467916992,12.262326153846157,13.069354791147155,11.455297516545158,10.109693784999987,11.453767809999995,11.917775140000009,11.85763745000002,12.3775,4940664,6598329.2,57.02473537181833,1.2354862920614884,1.5,2.75,NaN,NaN,0.31276390660815856,0.7487750080732558,441.3561541980944,0.07246906901655747,0.266475274920154,0.19400620590359652,30.997766731436577,1.6275404412922037,5.714810583629952,73.7593501309445,20.525839285425548,4817887724
1380115800,12.3475,12.4075,12.1825,12.2225,11.375650934782609,13.09810406060606,12.9325,6.233271,12.5275,6.233271,11.705003,5.292446,7.932421,3.510798,10.134944139999988,11.470667809999995,11.925975140000007,11.92413730000002,11.807652364527483,12.119110566210612,12.324057076923081,12.970762261012144,11.677351892834018,10.134944139999988,11.470667809999995,11.925975140000007,11.92413730000002,12.270833333333334,10606220,6592880,54.41290115788675,0.12630371141202573,1.5,2.75,NaN,NaN,0.3064950561361473,1.6087385179162976,442.456659132709,0.037942641099308894,0.24143450727773264,0.20349186617842374,31.221387005547786,1.5157807308970184,0,100.00000000000001,0,4807281504
1380202200,12.285,12.4558,12.22,12.349998,11.404237826086955,13.113255575757575,12.9325,6.233271,12.5275,6.233271,11.705003,5.292446,7.932421,3.510798,10.160727819999988,11.487792789999993,11.934875100000008,11.99176205000002,11.828920820820523,12.141099845619125,12.369441692307696,12.928279235872981,11.81060414874241,10.160727819999988,11.487792789999993,11.934875100000008,11.99176205000002,12.341932666666667,7090460,6557460.8,56.87822688987038,0.5912730783214578,1.5,2.75,NaN,NaN,0.3014454092692796,1.0812813398747272,445.0965591620564,0.02059455702582441,0.22923506246070424,0.20864050543487983,31.142138557136484,2.0007681030744773,4.557461419595512,76.74524673772109,18.697291842683377,4814371964
1380288600,12.162498,12.23,12.085,12.195,11.432824717391304,13.128407090909091,12.9325,6.233271,12.5275,6.233271,11.705003,5.292446,7.932421,3.510798,10.185082354999986,11.501892789999992,11.93652510000001,12.048511900000019,11.843276867062855,12.1462331936554,12.383672615384619,12.913859937045725,11.853485293723512,10.185082354999986,11.501892789999992,11.93652510000001,12.048511900000019,12.170000000000002,5494492,6533948.4,53.11745478858745,0.7398010990134407,1.5,2.75,NaN,NaN,0.2988420228929024,0.8409145073750506,442.25379627834485,-0.003152232611878386,0.20470021467003185,0.20785244728191024,32.22218086777412,-1.0146103896103895,4.807447305740777,76.07353683365385,19.119015860605376,4808877472
1380547800,11.87,12.1025,11.8075,12.009998,11.461411608695652,13.143558606060605,12.9325,6.233271,12.5275,6.233271,11.705003,5.292446,7.932421,3.510798,10.208399379999989,11.512542769999992,11.933175000000011,12.10213680000002,11.849814950707449,12.133258413307267,12.374057230769235,12.926022159402123,11.822092302136348,10.208399379999989,11.512542769999992,11.933175000000011,12.10213680000002,11.973332666666664,7104716,6481389.6,48.95664707437893,2.0777691530946325,1.5,2.75,NaN,NaN,0.30517473554340946,1.0961717221874767,438.24156009191637,-0.03157236159061949,0.16838699529363588,0.19995935688425537,31.488211548055155,-3.727455507407696,5.0660536985052165,75.39660250022946,19.537343801265326,4801772756
1380634200,12.02,12.302503,11.990003,12.2775,11.489998499999999,13.15871012121212,12.9325,6.233271,12.5275,6.233271,11.705003,5.292446,7.932421,3.510798,10.233703904999988,11.526842769999991,11.93397500000001,12.161761800000018,11.866586913424804,12.146995707278004,12.392326461538467,12.913730569105194,11.87092235397174,10.233703904999988,11.526842769999991,11.93397500000001,12.161761800000018,12.190001999999998,7182392,6403132,54.50585718610969,0.3312938329553957,1.5,2.75,NaN,NaN,0.30569796871888016,1.1216998181514921,442.154403665021,-0.032482111060946395,0.1593567180580724,0.19183882911901878,33.555727918420224,-5.064759327276238,19.691290945805616,49.19497131232997,31.113737741864412,4808955148
1380720600,12.0475,12.2375,11.9425,12.22,11.518585391304347,13.173861636363636,12.9325,6.233271,12.5275,6.233271,11.705003,5.292446,7.932421,3.510798,10.259212594999987,11.539467769999993,11.934975040000014,12.20401180000002,11.880446250153243,12.153948497061052,12.40096107692308,12.906711304822773,11.895210849023387,10.259212594999987,11.539467769999993,11.934975040000014,12.20401180000002,12.133333333333333,7097584,6444397,53.16782559152933,0.7841083337774736,1.5,2.75,NaN,NaN,0.30779097095324587,1.1013573496480742,440.1428628883286,-0.03676803212399968,0.14587878896401918,0.18264682108801886,23.50787274667903,-5.0505050505050395,24.180503598363124,43.425755808908576,32.393740592728285,4801857564
1380807000,12.150003,12.175,11.724998,11.892503,11.547172282608695,13.189013151515152,12.9325,6.233271,12.5275,6.233271,11.705003,5.292446,7.932421,3.510798,10.281746314999989,11.548592799999993,11.932325040000014,12.22888695000002,11.880919063872724,12.12904892591238,12.368076692307698,12.941651889325026,11.794501495290369,10.281746314999989,11.548592799999993,11.932325040000014,12.22888695000002,11.930833666666667,10904128,6747487,46.209863687246184,2.1040573252132933,1.5,2.75,NaN,NaN,0.3211631873137284,1.6160280116138053,435.1226140348628,-0.06009217306494452,0.1075316047568382,0.16762377782178273,26.512069497556766,-5.502558601509744,4.526956113326303,76.82975219067085,18.64329169600284,4790953436
1380893400,11.9225,12.197498,11.871025,12.150003,11.575759173913044,13.204164666666665,12.9325,6.233271,12.5275,6.233271,11.705003,5.292446,7.932421,3.510798,10.30435920999999,11.556842829999992,11.932855100000014,12.265387200000019,11.891471375093403,12.131044552015963,12.343077076923082,12.924113780594908,11.762040373251256,10.30435920999999,11.556842829999992,11.932855100000014,12.265387200000019,12.072842,4181848,6537610.4,51.57585204254418,0.8541579115380393,1.5,2.75,NaN,NaN,0.32154245964846206,0.6396600201198896,436.44998164103106,-0.056656307286148344,0.0968033937140973,0.15345970100024564,29.494442606889365,-2.1935761722680582,12.9663790765235,59.31113296706211,27.722487956414394,4795135284
1381152600,11.8475,12.060003,11.808175,11.8425,11.60434606521739,13.219316181818181,12.9325,6.233271,12.5275,6.233271,11.705003,5.292446,7.932421,3.510798,10.326305414999993,11.56039282999999,11.926955100000011,12.26951230000002,11.889550929011309,12.103564118490633,12.259230923076927,12.788083843097061,11.730378003056794,10.326305414999993,11.56039282999999,11.926955100000011,12.26951230000002,11.903559333333334,4830136,6450505.8,45.711388371863066,1.9027328181505119,1.5,2.75,NaN,NaN,0.322991426816429,0.7487995747558277,431.72461245714175,-0.07255594180979691,0.06276477373799949,0.1353207155477964,31.778031184053212,-3.973241435232112,15.340438012577094,55.525350708476054,29.134211278946847,4790305148
1381239000,11.84,11.8842,11.41,11.4225,11.632932956521739,13.234467696969697,12.9325,6.233271,12.5275,6.233271,11.705003,5.292446,7.932421,3.510798,10.345509959999992,11.56119282999999,11.914805100000013,12.24013740000002,11.871235206304982,12.038700869110572,12.147884769230775,12.722979089363852,11.572790449097697,10.345509959999992,11.56119282999999,11.914805100000013,12.24013740000002,11.572233333333335,9210384,6460041.8,39.16160432971992,4.434898292698172,1.5,2.75,NaN,NaN,0.33379203918668404,1.4257468117311562,427.6353310750133,-0.10675513427605181,0.0018767977027316363,0.10863193197878344,36.54390222540244,-6.5453057885048125,1.6635500274840906,86.37070106011069,11.965748912405202,4781094764
1381325400,11.502498,11.580003,11.235,11.4525,11.235,13.249619212121212,12.9325,6.233271,12.5275,6.233271,11.705003,5.292446,7.932421,3.510798,10.365835334999993,11.559092849999992,11.903255100000013,12.20601250000002,11.854814217822435,11.982872214909566,12.060769384615387,12.68556864582865,11.435970123402125,10.365835334999993,11.559092849999992,11.903255100000013,12.20601250000002,11.422500999999999,13926044,6925748,39.82485298227092,4.569006468353521,1.5,2.75,NaN,NaN,0.33459282210192093,2.0107638914959076,427.16907867089316,-0.12167009169550663,-0.043455682640599846,0.07821440905490679,36.99436857420154,-7.267191460273911,24.144228052111973,43.503352988119445,32.35241895976859,4795020808
1381411800,11.8,12.212503,11.7925,12.195,11.248879310344828,13.264770727272726,12.9325,6.233271,12.5275,6.233271,11.705003,5.292446,7.932421,3.510798,10.390281534999993,11.564442849999992,11.905955040000013,12.21376250000002,11.868154836731359,12.003074861108654,12.043269384615389,12.638611160958014,11.447927608272764,10.390281534999993,11.564442849999992,11.905955040000013,12.21376250000002,12.066667666666667,9573968,7120418.2,53.37338876228214,0.9641083820396557,1.5,2.75,NaN,NaN,0.36497926338035513,1.3445794518080412,429.67437851945215,-0.07796880125122843,-0.019246592509128746,0.05872220874209968,54.02154601293064,0,58.50004673105211,13.473850860049692,28.026102408898186,4804594776
1381498200,12.1475,12.4425,12.11,12.43,11.262758620689654,13.279922242424242,12.9325,6.233271,12.5275,6.233271,11.705003,5.292446,7.932421,3.510798,10.416369394999993,11.571692819999992,11.90525504000001,12.229875000000018,11.890187980388951,12.043734398145926,12.05076938461539,12.662721725555327,11.438817043675451,10.416369394999993,11.571692819999992,11.90525504000001,12.229875000000018,12.327500000000002,6400716,7293329.4,56.69656687704274,2.654981017144367,1.5,2.75,NaN,NaN,0.3626593159960442,0.8776123562991683,434.0269875622507,-0.03202863380738645,0.01868641648286662,0.05071505029025307,54.64066837711483,3.4971029970196517,61.16327339282867,11.902538532194594,26.934188074976745,4810995492
1381757400,12.205003,12.607273,12.169998,12.587503,11.276637931034482,13.295073757575757,12.9325,6.233271,12.5275,6.233271,11.705003,5.292446,7.932421,3.510798,10.443382269999994,11.582942819999992,11.90645510000001,12.24325015000002,11.917533667432522,12.09552188403679,12.078846538461542,12.75033667101502,11.407356405908065,10.443382269999994,11.582942819999992,11.90645510000001,12.24325015000002,12.454924666666665,8689852,7431202.8,58.815230721216615,3.2695780702501342,1.5,2.75,NaN,NaN,0.3679890077106124,1.1693735501337683,435.7934248670764,0.00803388111789266,0.060757401687618895,0.052723520569726234,53.767728322842395,2.5249684381999598,78.51249546880915,3.928446840123982,17.559057691066855,4819685344
1381843800,12.474998,12.6175,12.2575,12.2975,11.290517241379309,13.310225272727273,12.9325,6.233271,12.5275,6.233271,11.705003,5.292446,7.932421,3.510798,10.470190949999994,11.592317819999991,11.902655100000011,12.23437525000002,11.932434307925364,12.114757895080905,12.074808230769234,12.740331960208124,11.409284501330344,10.470190949999994,11.592317819999991,11.902655100000011,12.23437525000002,12.390833333333331,12127436,7878356.8,53.61388906985514,1.9909432355935084,1.5,2.75,NaN,NaN,0.36741836430271146,1.5393357152851976,431.19487437081494,0.01373515577649305,0.06989246529034254,0.05615730951384949,54.70426311365058,0.6342062193125924,70.54250038570291,7.0929481624438235,22.36455145185329,4807557908
1381930200,12.5325,12.835,12.5075,12.8175,11.304396551724137,13.325376787878787,12.9325,6.233271,12.5275,6.233271,11.705003,5.292446,7.932421,3.510798,10.497757984999994,11.607292819999993,11.913405100000011,12.228625250000022,11.967142766438094,12.181685714597009,12.12269284615385,12.896660206142569,11.348725486165131,10.497757984999994,11.607292819999993,11.913405100000011,12.228625250000022,12.72,11873572,8115291,60.3798199619355,4.027766785712863,1.5,2.75,NaN,NaN,0.3795670525668036,1.4631110578782696,435.89308368200017,0.04926179443221944,0.1177345525541238,0.06847275812190436,59.39270092817684,7.777984163636547,70.13264684497254,7.278331827821376,22.589021327206098,4819431480
1382016600,12.6575,13.095,12.6575,13.080003,11.318275862068965,13.340528303030302,12.9325,6.233271,12.5275,6.233271,11.705003,5.292446,7.932421,3.510798,10.523854224999994,11.622842819999994,11.931955160000012,12.23912540000002,12.010784344224836,12.267239741778246,12.205000923076927,13.126956259893516,11.283045586260338,10.523854224999994,11.622842819999994,11.931955160000012,12.23912540000002,12.944167666666667,8415440,8139222.4,63.29074347978054,4.917695272089977,1.5,2.75,NaN,NaN,0.3837051202406033,1.0339366079983268,441.855765245573,0.08507489375050195,0.1748163753100318,0.08974148155952985,56.21999626549921,7.654319097698986,69.74793643699307,7.454336434793872,22.79772712821305,4827846920
1382103000,13.224998,13.365003,13.140025,13.32,11.332155172413792,13.355679818181818,12.9325,6.233271,12.5275,6.233271,11.705003,5.292446,7.932421,3.510798,10.551342114999994,11.642967819999994,11.953055160000012,12.27587540000002,12.062126134647391,12.367502623513651,12.285193230769234,13.383005276422603,11.187381185115866,10.551342114999994,11.642967819999994,11.953055160000012,12.27587540000002,13.275009333333337,10887928,8374257.4,65.7671058322127,6.091942235949431,1.5,2.75,NaN,NaN,0.3766547545091317,1.3001663884847867,445.81873486507914,0.11755997598418466,0.23669145153976068,0.11913147555557602,55.999891411824024,12.476250791640286,73.1555145165363,5.96272169019962,20.88176379326408,4838734848
1382362200,13.349998,13.419998,13.25,13.3475,11.34603448275862,13.370831333333333,12.9325,6.233271,12.5275,6.233271,11.705003,5.292446,7.932421,3.510798,10.578467504999992,11.662267819999995,11.976505160000013,12.322125400000019,12.112532952896514,12.460835706988542,12.371924000000003,13.60522204956504,11.138625950434967,10.578467504999992,11.662267819999995,11.976505160000013,12.322125400000019,13.339166,6539124,8353855.2,66.0497197412228,5.381802077149649,1.5,2.75,NaN,NaN,0.3618935577584795,0.7827672186609124,444.67587772222197,0.13242719482043314,0.28466546908111745,0.15223827426068431,51.805393479064094,16.85270299846794,74.11528991685861,5.65440009560501,20.230309987536366,4845273972
1382448600,13.4575,13.6875,13.4025,13.5475,11.359913793103448,13.385982848484847,12.9325,6.233271,12.5275,6.233271,11.705003,5.292446,7.932421,3.510798,10.60703456999999,11.688362819999993,12.005105160000014,12.38287540000002,12.168806170429983,12.564327544418205,12.499231461538463,13.844853333966482,11.153609589110443,10.60703456999999,11.688362819999993,12.005105160000014,12.38287540000002,13.545833333333334,8558644,8534754.2,68.111605299327,6.100483448217444,1.5,2.75,NaN,NaN,0.36032973220430237,1.0027991198621748,449.43409429989055,0.14617923265987662,0.3349623150855301,0.18878308242565348,41.81499316157013,18.29294913774284,99.99999999999999,0,0,4853832616
1382535000,13.4325,13.447498,13.2375,13.377498,11.373793103448275,13.401134363636363,12.9325,6.233271,12.5275,6.233271,11.705003,5.292446,7.932421,3.510798,10.634984949999991,11.711187799999994,12.027855060000013,12.440625300000018,12.216205850020964,12.64177234971171,12.593654153846156,13.99894716332553,11.188361144366782,10.634984949999991,11.711187799999994,12.027855060000013,12.440625300000018,13.354165333333333,4856608,8247273.6,64.5244183589746,3.933341568953456,1.5,2.75,NaN,NaN,0.3567347513325664,0.5888743644930126,447.2716752059062,0.13456555681934598,0.35699002844983596,0.22242447163048998,44.56062192998082,9.696580565805649,87.32322246007294,1.472156183803224,11.20462135612383,4848976008
1382621400,13.45,13.555,13.3625,13.5,11.387672413793103,13.416285878787878,12.9325,6.233271,12.5275,6.233271,11.705003,5.292446,7.932421,3.510798,10.663285339999991,11.736662799999992,12.056905060000012,12.498125400000017,12.266550718647593,12.723508316405832,12.721154153846156,14.131463058153479,11.310845249538833,10.663285339999991,11.736662799999992,12.056905060000012,12.498125400000017,13.472500000000002,3444892,8064995.2,65.91738166667275,4.243180219390389,1.5,2.75,NaN,NaN,0.34500369766595446,0.4271412337604367,449.25493850999203,0.12602217095151036,0.37995218531987796,0.2539300143683676,32.855218714115175,8.608205953338699,85.34613445533299,1.9395171758465388,12.714348368820483,4852420900
1382707800,13.5825,13.6925,13.5075,13.6825,11.40155172413793,13.431437393939394,12.9325,6.233271,12.5275,6.233271,11.705003,5.292446,7.932421,3.510798,10.691581574999992,11.768737819999991,12.100105060000011,12.572500400000015,12.322078141445727,12.814840857700515,12.89500030769231,14.173093519054246,11.616907096330374,10.691581574999992,11.768737819999991,12.100105060000011,12.572500400000015,13.6275,8241624,8202351.8,67.93721601860076,4.27236828979101,1.5,2.75,NaN,NaN,0.33411057640410063,1.004787919484263,450.9705324046383,0.12339274393609595,0.40817094428848755,0.2847782003523916,32.4520317524824,8.699080349772304,84.09140067142873,2.2662821203524324,13.642317208218826,4860662524
1382967000,13.675,13.8075,13.6315,13.755,11.415431034482758,13.446588909090908,12.9325,6.233271,12.5275,6.233271,11.705003,5.292446,7.932421,3.510798,10.720202809999991,11.798637819999993,12.146455060000012,12.659750500000015,12.37827115550668,12.9043798236338,13.072115692307696,14.118711859379536,12.025519525235856,10.720202809999991,11.798637819999993,12.146455060000012,12.659750500000015,13.731333333333334,3991148,8046673.4,68.73002784254852,4.421648473453713,1.5,2.75,NaN,NaN,0.3228169638038076,0.49599975065472396,449.22610964834087,0.11730673062286895,0.4314116136309778,0.31410488300810885,32.47642766914099,11.85200243952024,81.25600078399705,3.038461111873363,15.705538104129577,4864653672
1383053400,13.84,13.9825,13.7925,13.98,11.429310344827586,13.461740424242423,12.9325,6.233271,12.5275,6.233271,11.705003,5.292446,7.932421,3.510798,10.750094874999991,11.82683781999999,12.202005060000012,12.744875500000017,12.441084051369163,13.00681984043058,13.209423384615388,14.227681209411186,12.19116555981959,10.750094874999991,11.82683781999999,12.202005060000012,12.744875500000017,13.918333333333331,5289448,7952026.2,71.1169646231912,4.742908399795876,1.5,2.75,NaN,NaN,0.3160086092463927,0.6651698406124467,451.61548004848623,0.11883806282230791,0.4626524615359937,0.3438143987136858,25.288000921006894,9.069631363370389,78.70590866764016,3.8637432979015234,17.430348034458323,4869943120
1383139800,14.0275,14.054975,13.615,13.7625,11.443189655172413,13.476891939393939,12.9325,6.233271,12.5275,6.233271,11.705003,5.292446,7.932421,3.510798,10.77885777499999,11.852712819999992,12.249905060000014,12.822000500000016,12.492904284648803,13.078789379437191,13.311923384615387,14.2616716788351,12.362175090395674,10.77885777499999,11.852712819999992,12.249905060000014,12.822000500000016,13.810825,6837692,7939031.6,65.88168875250774,3.4558967471424866,1.5,2.75,NaN,NaN,0.32486335144307893,0.8612753222949762,448.01435729212494,0.09655335242932378,0.46450608925034054,0.36795273682101676,22.77376628971274,5.217865775718856,70.2363712778868,7.2337056846560355,22.529923037457188,4863105428
1383226200,13.7375,13.8975,13.5825,13.615,11.45706896551724,13.492043454545454,12.9325,6.233271,12.5275,6.233271,11.705003,5.292446,7.932421,3.510798,10.806866509999988,11.880487789999993,12.298905060000015,12.908125350000017,12.536908038191987,13.12985705758603,13.390961615384619,14.253414275197422,12.528508955571816,10.806866509999988,11.880487789999993,12.298905060000015,12.908125350000017,13.698333333333332,8385504,7813100.4,62.52040200060135,2.845663827380835,1.5,2.75,NaN,NaN,0.3241588263400019,1.0732620305250398,445.61533266762933,0.06475658112167842,0.4488984632231148,0.38414188210143635,23.174456187006182,2.214714714714714,39.00187421271136,27.979405476782908,33.01872031050574,4854719924
1383312600,13.6975,13.825,13.505,13.74,11.470948275862069,13.507194969696968,12.9325,6.233271,12.5275,6.233271,11.705003,5.292446,7.932421,3.510798,10.834729424999987,11.912212789999991,12.344655060000015,12.987625200000016,12.584088115125635,13.187965909244504,13.501923153846157,14.10538429637028,12.898462011322033,10.834729424999987,11.912212789999991,12.344655060000015,12.987625200000016,13.69,7356564,7971836.2,64.1879292909363,1.9119716652879204,1.5,2.75,NaN,NaN,0.3238617673157159,0.9228192621418889,443.3996858300013,0.0459073936486139,0.4415261241622037,0.3956187305135898,21.68767827248117,2.9406255853156025,37.28849133058099,29.538743573012724,33.17276509640629,4862076488
1383575400,13.855,13.8975,13.725,13.8825,11.484827586206896,13.522346484848484,12.9325,6.233271,12.5275,6.233271,11.705003,5.292446,7.932421,3.510798,10.863017334999988,11.94071278999999,12.390905060000016,13.089625200000018,12.635006228257962,13.25411201312598,13.583846230769232,14.071444108794623,13.096248352743842,10.863017334999988,11.94071278999999,12.390905060000016,13.089625200000018,13.835,5560684,8008363.6,66.04274245430477,2.473408532614779,1.5,2.75,NaN,NaN,0.31305021250745063,0.6943595817752332,446.622587748179,0.03717378332139992,0.4420859596653397,0.4049121763439398,22.055910069081154,2.472780955895928,40.64204564393318,26.538998115441892,32.81895624062492,4867637172
1383661800,13.72,13.86,13.5825,13.7525,11.498706896551724,13.537498,13.98,6.233271,12.5275,6.233271,11.705003,5.292446,7.932421,3.510798,10.890017754999988,11.96998778999999,12.437155100000018,13.206125200000017,12.678829513424317,13.30157753568541,13.63557676923077,14.032677979111464,13.238475559350077,10.890017754999988,11.96998778999999,12.437155100000018,13.206125200000017,13.731666666666667,4940608,7794874.8,62.84492183987736,2.0006566714142067,1.5,2.75,NaN,NaN,0.3121180544712042,0.6338277556427205,442.5308369930102,0.01776321110088197,0.4271161902200422,0.40935297911916024,22.049350509126153,2.8032297220302356,20.77216441134102,47.75450121442395,31.473334374235026,4862696564
1383748200,13.93,14.035,13.8125,13.9475,11.51258620689655,13.552649515151515,13.98,6.233271,12.5275,6.233271,11.705003,5.292446,7.932421,3.510798,10.917776509999989,11.998562789999992,12.498255040000018,13.330875200000017,12.728581297211598,13.36309396085823,13.683846,14.068117105299372,13.29957489470063,10.917776509999989,11.998562789999992,12.498255040000018,13.330875200000017,13.931666666666667,3556508,7276398,65.54028116706885,2.4553430327858545,1.5,2.75,NaN,NaN,0.3100024791518325,0.48877315396986254,443.87109677987854,0.0133783150725299,0.42607587295982263,0.41269755788729273,21.09522770076763,3.314814814814813,41.785998875276455,25.557516038499475,32.65648508622407,4866253072
1383834600,14.05,14.0675,13.39,13.44,11.526465517241379,13.56780103030303,13.98,6.233271,12.5275,6.233271,11.705003,5.292446,7.932421,3.510798,10.94297276499999,12.019637789999992,12.547104980000018,13.393125200000018,12.756480069869966,13.370418345538399,13.690961384615386,14.05282960738719,13.329093161843582,10.94297276499999,12.019637789999992,12.547104980000018,13.393125200000018,13.6325,9454628,7270431,54.46611557473737,0.8963615409586709,1.5,2.75,NaN,NaN,0.33625230206955875,1.3004219419729037,439.34754728860514,-0.026221315436903092,0.37992091359116387,0.40614222902806696,31.28809472637926,-1.7723369267312241,39.39737189963865,27.631653416297333,32.97097468406403,4856798444
1383921000,13.4125,13.9725,13.4125,13.9725,11.540344827586207,13.582952545454544,13.98,6.233271,12.5275,6.233271,11.705003,5.292446,7.932421,3.510798,10.97015652999999,12.050437759999992,12.605354920000016,13.470250200000018,12.804167125953496,13.427759455487122,13.723653692307694,14.104087281751985,13.343220102863404,10.97015652999999,12.050437759999992,12.605354920000016,13.470250200000018,13.785833333333334,6365628,7268676.6,61.76606652664003,1.5306097258649145,1.5,2.75,NaN,NaN,0.35223428049316174,0.875761620760511,438.97254728860514,-0.019386847177432442,0.3819086700562764,0.4012955172337088,38.063980524288496,1.5812431842966146,37.50325636385902,29.345492958970272,33.15125067717071,4863164072
1384180200,13.945,14.025,13.88,13.9625,11.554224137931033,13.59810406060606,13.98,6.233271,12.5275,6.233271,11.705003,5.292446,7.932421,3.510798,10.997406959999992,12.089412779999993,12.665854920000015,13.539000050000016,12.849591944543555,13.47868712639311,13.76865384615385,14.111165021629109,13.42614267067859,10.997406959999992,12.089412779999993,12.665854920000015,13.539000050000016,13.955833333333333,3646316,7016499.8,61.56645094821895,2.133358721759495,1.5,2.75,NaN,NaN,0.3374318318865073,0.5196773468161433,440.05743951847984,-0.018383555581990674,0.3783160727562205,0.39669962833821115,38.03594239190079,-0.1251788268955656,17.74473361349033,51.953840561261046,30.30142582524863,4859517756
1384266600,13.8875,13.98,13.75,13.8925,11.568103448275862,13.613255575757575,13.98,6.233271,12.5275,6.233271,11.705003,5.292446,7.932421,3.510798,11.023782389999992,12.126737779999992,12.722004920000016,13.618750050000013,12.890490299659493,13.518097876260432,13.798846153846158,14.108974014479202,13.488718293213115,11.023782389999992,12.126737779999992,12.722004920000016,13.618750050000013,13.874166666666667,6737296,6746992.8,60.10219320179077,1.2173216205677149,1.5,2.75,NaN,NaN,0.32975812960889966,0.998562796747019,437.0501224344403,-0.02487488674146726,0.3656060199113771,0.39048090665284435,36.96764141979134,0.9445958219800239,15.488882530907466,55.30298319502616,29.20813427406638,4852780460
1384353000,13.68,14.23,13.68,14.215,11.58198275862069,13.628407090909091,13.98,6.233271,12.5275,6.233271,11.705003,5.292446,7.932421,3.510798,11.052270309999992,12.17116277999999,12.778804920000017,13.688625050000013,12.942431856535592,13.584469507092772,13.839807692307696,14.212084788952643,13.46753059566275,11.052270309999992,12.17116277999999,12.778804920000017,13.688625050000013,14.041666666666666,6987836,6502706,64.31329920052107,2.2787816200218938,1.5,2.75,NaN,NaN,0.34548969177969263,1.074604326260483,439.2012735170917,-0.010618287995970976,0.37720804665788066,0.38782633465385163,37.846103418329875,4.406904149834738,23.14190098698387,44.744507674868,32.11359133814814,4859768296
1384439400,14.2575,14.4725,14.196,14.45,11.595862068965516,13.643558606060605,13.98,6.233271,12.5275,6.233271,11.705003,5.292446,7.932421,3.510798,11.082287399999991,12.21506274999999,12.839904920000016,13.757124900000013,13.001552175887138,13.666900982607746,13.893269230769233,14.382665973297861,13.403872488240605,11.082287399999991,12.21506274999999,12.839904920000016,13.757124900000013,14.372833333333332,5704408,6367154.4,67.04301510383621,3.8552403363018564,1.5,2.75,NaN,NaN,0.34056185665257177,0.8959116807344895,442.44820332715676,0.010335512437768646,0.40074572520106244,0.3904102127632938,37.37594255566157,5.167394468704506,56.23132955739536,14.890714868424853,28.87795557417978,4865472704
1384525800,14.5,14.6325,14.45525,14.6325,11.609741379310345,13.65871012121212,13.98,6.233271,12.5275,6.233271,11.705003,5.292446,7.932421,3.510798,11.111921169999992,12.25801271999999,12.90415496000002,13.822749900000014,13.065510914087643,13.75886279378796,13.943461538461541,14.572158415592014,13.314764661331068,11.111921169999992,12.25801271999999,12.90415496000002,13.822749900000014,14.573416666666667,5293228,6087419.4,69.02457847270936,4.043718477320869,1.5,2.75,NaN,NaN,0.329271724034531,0.869535619642044,444.8806232470445,0.03101457222615983,0.4291784280459936,0.39816385581983377,37.53293253832255,5.4024851431658565,54.790585834392594,15.824042560520184,29.385371605087215,4870765932
1384785000,14.695,14.7325,14.3725,14.4825,11.623620689655171,13.673861636363636,13.98,6.233271,12.5275,6.233271,11.705003,5.292446,7.932421,3.510798,11.142234094999992,12.297587689999991,12.958605000000018,13.879499900000013,13.121079113535187,13.827780622951012,13.998846153846157,14.678785674303153,13.318906633389162,11.142234094999992,12.297587689999991,12.958605000000018,13.879499900000013,14.529166666666667,6652072,6093066.8,65.53672447090128,3.304740996490914,1.5,2.75,NaN,NaN,0.33146660088920726,1.0917444725864487,442.2239073166365,0.029147337712942922,0.43459802796101243,0.4054506902480695,38.572476841466674,5.308125795309947,46.690693627273994,21.716107478293274,31.593198894432714,4864113860
1384871400,14.4525,14.5775,14.3,14.3825,11.6375,13.689013151515152,13.98,6.233271,12.5275,6.233271,11.705003,5.292446,7.932421,3.510798,11.170822029999993,12.33828768999999,13.00605504000002,13.921249900000012,13.170546599278905,13.880611039812822,14.057884615384618,14.727459239690821,13.388309991078414,11.170822029999993,12.33828768999999,13.00605504000002,13.921249900000012,14.42,7285328,6029401,63.242392535893,2.219999765695787,1.5,2.75,NaN,NaN,0.3276118436828353,1.208300459697406,439.0545154120205,0.016370856756761698,0.42591426119402165,0.40954340443725995,38.27749440975615,3.118838501523574,44.68319594791332,23.301767851042182,32.0150362010445,4856828532
1384957800,14.465,14.585,14.12,14.2475,11.651379310344828,13.704164666666665,13.98,6.233271,12.5275,6.233271,11.705003,5.292446,7.932421,3.510798,11.198609964999992,12.37501268999999,13.048305080000018,13.964750000000013,13.21278006597385,13.915552845544934,14.096923076923078,14.746695681662477,13.44715047218368,11.198609964999992,12.37501268999999,13.048305080000018,13.964750000000013,14.3175,6957376,6134439.4,60.17945445821943,1.3744253857139712,1.5,2.75,NaN,NaN,0.33742528341977573,1.1341502534037584,435.8088889841809,-0.0048444950064379655,0.4034877856792125,0.4083322806856505,38.49638687106058,6.008184523809532,17.273787805903865,52.770650816230784,29.955561377865347,4849871156
1385044200,14.36,14.6125,14.33225,14.58,11.665258620689654,13.719316181818181,13.98,6.233271,12.5275,6.233271,11.705003,5.292446,7.932421,3.510798,11.228218734999992,12.415587689999988,13.09910508000002,14.018750000000011,13.266396533974877,13.978833526921607,14.150576923076926,14.83493556119157,13.466218284962283,11.228218734999992,12.415587689999988,13.09910508000002,14.018750000000011,14.508249999999999,3990744,6161732,64.71253051300826,2.571535399603463,1.5,2.75,NaN,NaN,0.33939490603264894,0.6476659484703327,440.1503289832852,-0.00039122428843119117,0.4078432503251115,0.4082344746135427,30.811886581228826,4.3478260869565215,13.719780731582263,58.23530014782821,28.044919120589523,4853861900
1385130600,14.595,14.8075,14.5475,14.785,11.679137931034482,13.734467696969697,13.98,6.233271,12.5275,6.233271,11.705003,5.292446,7.932421,3.510798,11.258185839999989,12.45786268999999,13.152650080000019,14.073875000000012,13.325949611073902,14.055611286262407,14.230000000000002,14.94986109771261,13.510138902287395,11.258185839999989,12.45786268999999,13.152650080000019,14.073875000000012,14.713333333333333,6285640,6063932.8,67.19228496623077,3.2960349781323526,1.5,2.75,NaN,NaN,0.3337238413160311,1.0365616188886526,442.00924144909834,0.01178133344976029,0.42296114142574304,0.41117980797598275,24.38838376003333,5.890778871978512,15.989039963080486,54.675387092080335,29.335572944839186,4860147540
1385389800,14.8825,14.8825,14.6912,14.7675,11.693017241379309,13.749619212121212,13.98,6.233271,12.5275,6.233271,11.705003,5.292446,7.932421,3.510798,11.28808627999999,12.49661265999999,13.201600080000018,14.124500000000012,13.382480998874925,14.123410211380273,14.293076923076928,15.04582101547424,13.540332830679615,11.28808627999999,12.49661265999999,13.201600080000018,14.124500000000012,14.7804,5895088,6159129.8,66.76098465880567,2.9765128417206395,1.5,2.75,NaN,NaN,0.32355070979345746,0.9571300153472979,440.4209963412757,0.013927802912447607,0.42858956161654227,0.41466175870409466,24.43445798650779,6.2983624257693,15.403806940321855,55.39509309255821,29.20109996711993,4854252452
1385476200,14.7825,14.897,14.6975,14.7675,11.706896551724137,13.764770727272726,13.98,6.233271,12.5275,6.233271,11.705003,5.292446,7.932421,3.510798,11.317749219999989,12.533462659999989,13.24745012000002,14.16387500000001,13.436795469507281,14.184752096010723,14.395192307692314,15.003672322971438,13.78671229241319,11.317749219999989,12.533462659999989,13.24745012000002,14.16387500000001,14.787333333333335,6876248,6238469.8,66.76098465880567,2.981245381569792,1.5,2.75,NaN,NaN,0.3146899448082105,1.1022331149218676,442.5218992670313,0.01076265784221786,0.428115081006867,0.41735242316464916,23.797779114885596,3.8867393598311657,27.133542168111973,39.95278730968991,32.91367052219813,4854252452
1385562600,14.8075,14.9025,14.7551,14.8625,11.720775862068965,13.779922242424242,13.98,6.233271,12.5275,6.233271,11.705003,5.292446,7.932421,3.510798,11.34779132999999,12.568837659999987,13.286050120000018,14.218875000000011,13.492705451095231,14.249299515438272,14.463653846153854,15.066744014768208,13.8605636775395,11.34779132999999,12.568837659999987,13.286050120000018,14.218875000000011,14.840033333333333,4233796,6108275,68.05207872894982,2.609110595249657,1.5,2.75,NaN,NaN,0.3027406630361954,0.6931246546692806,444.126608454109,0.010472365608956202,0.4304428801758444,0.4199705145668882,21.28075775252866,2.8546712802768264,64.06476750714047,10.280531938119958,25.654700554739566,4858486248
1385735400,14.915,15.025,14.7925,14.8225,11.734655172413792,15.025,13.98,6.233271,12.5275,6.233271,11.705003,5.292446,7.932421,3.510798,11.377495939999992,12.603712659999987,13.325100120000018,14.27925000000001,13.544854256934634,14.303890037777485,14.529807692307697,15.085285523820149,13.974329860795246,11.377495939999992,12.603712659999987,13.325100120000018,14.27925000000001,14.88,4952608,5936630.2,66.87422977921867,2.4867475918227586,1.5,2.75,NaN,NaN,0.29772347281932426,0.8342456634742046,446.2125977521044,0.0033599397823577126,0.42417043929483533,0.4208104995124776,20.153584711617757,1.2984794122672099,32.87346485925064,33.80306038496356,33.3234747557858,4853533640
1385994600,14.87,14.9465,14.655,14.72,11.74853448275862,15.06475004,13.98,6.233271,12.5275,6.233271,11.705003,5.292446,7.932421,3.510798,11.40688720999999,12.63283765999999,13.367800120000018,14.328250000000011,13.59093840372151,14.343519557989154,14.593461538461543,15.015961144567589,14.170961932355498,11.40688720999999,12.63283765999999,13.367800120000018,14.328250000000011,14.773833333333334,6927472,5915175.6,63.82568723389185,1.658611297887826,1.5,2.75,NaN,NaN,0.2972789390465155,1.1711354773643576,442.26583666522276,-0.011651884070311258,0.40624564442458855,0.4178975284948998,19.712819178698428,1.6399102364923233,4.859517022111334,76.00416870569951,19.136314272189146,4846606168
1386081000,14.5825,14.69,14.3925,14.5525,11.762413793103448,15.104500080000001,13.98,6.233271,12.5275,6.233271,11.705003,5.292446,7.932421,3.510798,11.434504324999988,12.66033762999999,13.410400120000018,14.361750000000011,13.628646701614786,14.363422457228282,14.619423076923082,14.983091109433259,14.255755044412906,11.434504324999988,12.66033762999999,13.410400120000018,14.361750000000011,14.545,8018544,6038068.6,59.08555541704199,0.27443803768200675,1.5,2.75,NaN,NaN,0.2994375862574787,1.3279981615313214,439.3362840575687,-0.03494954410414869,0.37421059836471393,0.4091601424688626,19.952332586052307,1.181992004171736,4.039682917877005,78.25613489194767,17.704182190175324,4838587624
1386167400,14.385,14.7025,14.1825,14.51,11.776293103448275,15.14425012,13.98,6.233271,12.5275,6.233271,11.705003,5.292446,7.932421,3.510798,11.46354642499999,12.68586262999999,13.453950120000018,14.399625000000011,13.663209576061265,14.37738222320654,14.624038461538467,14.980438941020674,14.267637982056259,11.46354642499999,12.68586262999999,13.453950120000018,14.399625000000011,14.464999999999998,13852368,6483656.6,57.91036027335337,0.5405747298416462,1.5,2.75,NaN,NaN,0.31519204438194454,2.1365055021575325,436.22983914416693,-0.05416243883870292,0.34145709392048396,0.3956195327591869,19.53714455849837,1.8424284962274033,1.5721466912038995,86.7962383054637,11.631615003332401,4824735256
1386253800,14.45,14.52,14.297475,14.335,11.790172413793103,15.18400016,14.8625,6.233271,12.5275,6.233271,11.705003,5.292446,7.932421,3.510798,11.492534349999993,12.71108762999999,13.496200120000019,14.419000000000011,13.689554298568666,14.373345820996393,14.601153846153853,14.989238964615767,14.213068727691939,11.492534349999993,12.71108762999999,13.496200120000019,14.419000000000011,14.384158333333334,7274208,6669541.6,53.21671235720422,1.069960925170765,1.5,2.75,NaN,NaN,0.3085729697832341,1.0906608634092634,432.9511198820159,-0.07814030343072387,0.29794415347078207,0.37608445690150594,20.111001999751032,-1.6803840877914897,0,100,0,4817461048
1386340200,14.7575,14.85,14.619975,14.8025,11.80405172413793,15.223750200000001,14.8625,6.233271,12.5275,6.233271,11.705003,5.292446,7.932421,3.510798,11.522580624999991,12.74006262999999,13.545250160000018,14.487125000000011,13.733199228036561,14.414217647568165,14.625769230769238,15.021153097874187,14.23038536366429,11.522580624999991,12.74006262999999,13.545250160000018,14.487125000000011,14.757491666666667,9174612,6655540.8,62.06274265524963,1.5573058191794613,1.5,2.75,NaN,NaN,0.3233177576558602,1.3784923382935312,436.94827796336233,-0.06266685297261632,0.29775089068573557,0.3604177436583519,24.064709730331405,0.11836320595197884,5.54773816843898,74.24388806685155,20.208373764709457,4826635660
1386599400,14.9375,14.985,14.865,14.92,11.817931034482758,15.26350024,14.8625,6.233271,12.5275,6.233271,11.705003,5.292446,7.932421,3.510798,11.555689374999993,12.768137629999991,13.599750160000017,14.534500000000012,13.779740434780225,14.462387395418816,14.667115384615393,15.064505166886219,14.269725602344566,11.555689374999993,12.768137629999991,13.599750160000017,14.534500000000012,14.923333333333334,6923160,6683417.4,63.90983046201462,2.1196792295650417,1.5,2.75,NaN,NaN,0.31325934639472724,1.0358712595146309,437.56619234401563,-0.04547057828380413,0.30357952080359674,0.34905009908740087,23.15443428385927,1.032673099712205,17.84091863131853,51.811625488092496,30.347455880588978,4833558820
1386685800,14.82,14.91,14.735,14.775,11.831810344827586,15.30325028,14.8625,6.233271,12.5275,6.233271,11.705003,5.292446,7.932421,3.510798,11.587264799999993,12.794112599999995,13.655050200000016,14.57512500000001,13.818770221651588,14.492160024426548,14.707692307692316,15.025082273716045,14.390302341668587,11.587264799999993,12.794112599999995,13.655050200000016,14.57512500000001,14.806666666666667,5458056,6774004.4,60.025869219473634,1.188497474472597,1.5,2.75,NaN,NaN,0.30409796450938964,0.8057355262420556,435.39417782776036,-0.044744427984997004,0.2931195641061546,0.3378639920911516,23.946482356168573,0.050787201625192374,20.06098989477099,48.73030127144649,31.20870883378253,4828100764
1386772200,14.7825,14.7825,14.2105,14.2575,11.845689655172412,15.34300032,14.8625,6.233271,12.5275,6.233271,11.705003,5.292446,7.932421,3.510798,11.614686069999994,12.814312599999994,13.694650200000018,14.593375000000012,13.835975310998585,14.469811450671639,14.682884615384621,15.077369899081306,14.288399331687936,11.614686069999994,12.814312599999994,13.694650200000018,14.593375000000012,14.416833333333335,7688432,6821561.2,48.65992134713473,1.6082106756047037,1.5,2.75,NaN,NaN,0.32323382418729046,1.127078065355479,429.7358256690005,-0.07804959674291795,0.24030199616250414,0.3183515929054221,31.501350105188614,-4.070647603027757,27.76032019855068,39.27919459307092,32.96048520837841,4820412332
1386858600,14.2325,14.294975,14.0325,14.1225,11.85956896551724,15.382750360000001,14.8625,6.233271,12.5275,6.233271,11.705003,5.292446,7.932421,3.510798,11.641799009999993,12.833837619999992,13.732700200000016,14.588750000000013,13.847211573312366,14.436734169655292,14.631923076923083,15.120437913506509,14.143408240339658,11.641799009999993,12.833837619999992,13.732700200000016,14.588750000000013,14.149991666666667,8199088,6882123.8,46.20217144596097,2.568096252053075,1.5,2.75,NaN,NaN,0.3188939081739126,1.1913601437974715,427.5999891226307,-0.10635087777987146,0.18541299568058278,0.29176387346045424,30.987812262122297,-4.722550177095627,26.585192282130954,40.61543537472858,32.79937234314046,4812213244
1386945000,14.21,14.25,14.0375,14.1025,11.873448275862069,15.4225004,14.8625,6.233271,12.5275,6.233271,11.705003,5.292446,7.932421,3.510798,11.668220279999993,12.854612589999993,13.776900140000015,14.571375000000014,13.857222884162862,14.404902343973836,14.580769230769237,15.136437174693777,14.025101286844697,11.668220279999993,12.854612589999993,13.776900140000015,14.571375000000014,14.13,4559688,6824887.8,45.832833522852255,2.2979981859114806,1.5,2.75,NaN,NaN,0.3112943433043474,0.6680971370694182,429.81734490523905,-0.12245079251506508,0.1387003828166229,0.26115117533168797,31.03273988236453,-4.194972826086967,6.081644487520546,72.90103127468636,21.0173242377931,4807653556
1387204200,14.315,14.5175,14.3025,14.375,11.887327586206895,15.46225044,14.92,6.233271,12.5275,6.233271,11.705003,5.292446,7.932421,3.510798,11.695349894999993,12.877127589999994,13.821400080000014,14.558500000000015,13.877527869097651,14.402054501690614,14.550576923076928,15.105031450053854,13.996122396100002,11.695349894999993,12.877127589999994,13.821400080000014,14.558500000000015,14.398333333333333,6599436,6890198.2,51.519406741139136,0.3091854227832745,1.5,2.75,NaN,NaN,0.3187018902111798,0.9578006043425572,433.28484103526785,-0.11111338630574127,0.12225944244951137,0.23337282875525264,33.898650262869005,-1.2197216973028704,5.31471442122627,74.7951837721042,19.890101806669538,4814252992
1387290600,14.415,14.422475,14.14275,14.2175,11.901206896551724,15.502000480000001,14.92,6.233271,12.5275,6.233271,11.705003,5.292446,7.932421,3.510798,11.720454519999993,12.897927589999993,13.868900080000014,14.545250000000014,13.890860109525194,14.384477882481985,14.500961538461542,15.050298686099628,13.951624390823456,11.720454519999993,12.897927589999993,13.868900080000014,14.545250000000014,14.260908333333333,5402820,6827735.6,48.3593580157562,1.052841411557435,1.5,2.75,NaN,NaN,0.31591782662466705,0.7913048068235097,431.96913117478385,-0.1103614700035753,0.09542099125078352,0.2057824612543588,33.85776534216889,-2.0158511371467984,5.409039790970825,74.5570928708992,20.03386733812998,4808850172
1387377000,14.2975,14.9725,13.912525,14.96,13.912525,15.54175052,14.92,6.233271,12.5275,6.233271,11.705003,5.292446,7.932421,3.510798,11.749075814999994,12.927227589999994,13.939650080000014,14.574125000000013,13.932787164053618,14.439289512721796,14.511538461538466,15.089766984574187,13.933309938502745,11.749075814999994,12.927227589999994,13.939650080000014,14.574125000000013,14.615008333333336,12232628,7075100.6,60.62185175411692,1.352409251969285,1.5,2.75,NaN,NaN,0.3690647675800479,1.7289687725429657,437.53368737580166,-0.05859631684537481,0.1325370651976403,0.1911333820430151,45.55061042338667,4.359958144401814,37.373613800905304,29.500990822336362,33.12539537675833,4821082800
1387463400,14.84,14.965,14.7275,14.935,13.96716836734694,15.58150056,14.92,6.233271,12.5275,6.233271,11.705003,5.292446,7.932421,3.510798,11.777326279999993,12.956277589999992,14.009300080000013,14.608500000000012,13.972089628208378,14.48650003531972,14.528076923076927,15.140496945629806,13.915656900524048,11.777326279999993,12.956277589999992,14.009300080000013,14.608500000000012,14.875833333333333,8283776,7141420.6,60.10433880165366,2.4585578235739067,1.5,2.75,NaN,NaN,0.3596672841814731,1.1599619269028911,434.94801255368765,-0.026417174104003294,0.15811191441301098,0.18452908851701427,44.663407678446205,0.8951190677250483,36.3307241567929,30.474707634852244,33.19456820835486,4812799024
1387549800,14.9525,15.284975,14.9525,15.18,14.021811734693879,15.6212506,14.92,6.233271,12.5275,6.233271,11.705003,5.292446,7.932421,3.510798,11.80620591499999,12.987477559999993,14.069000080000013,14.638500000000013,14.019458662396286,14.552547651003556,14.576346153846158,15.280849839987674,13.871842467704642,11.80620591499999,12.987477559999993,14.069000080000013,14.638500000000013,15.139158333333333,8709976,7377382.2,63.40168032054046,3.829683877688849,1.5,2.75,NaN,NaN,0.35897497816851065,1.1806323386634354,439.62380272205814,0.009089932230358005,0.1958915038049618,0.18680157157460378,41.877958466220534,1.7426273458445025,59.18624618884034,13.068661461578246,27.745092349581398,4821509000
1387809000,15.4,15.4475,15.3125,15.4175,14.076455102040818,15.661000640000001,14.92,6.233271,12.5275,6.233271,11.705003,5.292446,7.932421,3.510798,11.835798049999992,13.017002559999995,14.128750080000014,14.670125000000013,14.074283812890549,14.634924065193694,14.646153846153851,15.47873005053077,13.813577641776932,11.835798049999992,13.017002559999995,14.128750080000014,14.670125000000013,15.3925,5641244,7345162.4,66.30864006904618,4.147122107899942,1.5,2.75,NaN,NaN,0.3524410511564742,0.7680216845852176,443.5504558326808,0.04432225021178898,0.24220438433934,0.197882134127551,42.45929618555788,4.3485617597292725,59.115878389888714,13.142353239105951,27.741768371005335,4827150244
1387895400,15.4225,15.535,15.4125,15.53,14.131098469387755,15.70075068,14.92,6.233271,12.5275,6.233271,11.705003,5.292446,7.932421,3.510798,11.866215189999993,13.047027559999995,14.187600020000014,14.708250000000012,14.131370722188958,14.720169392318104,14.738076923076928,15.670792466007176,13.80536138014668,11.866215189999993,13.047027559999995,14.187600020000014,14.708250000000012,15.492500000000001,3255716,7213193.8,67.62059909840409,4.556881738578159,1.5,2.75,NaN,NaN,0.33601669035958326,0.4513556810299482,446.6940768246543,0.06945717249899608,0.2847035997512961,0.21524642725230003,41.66397352912439,8.92512712607399,75.53088137342479,5.043516351345334,19.425602275229874,4830405960
1388068200,15.6275,15.777475,15.6175,15.76,14.185741836734694,15.74050072,14.92,6.233271,12.5275,6.233271,11.705003,5.292446,7.932421,3.510798,11.897636494999995,13.079752559999996,14.256850020000012,14.757875000000013,14.195238537005077,14.819200878763999,14.811730769230772,15.892616062752467,13.730845475709078,11.897636494999995,13.079752559999996,14.256850020000012,14.757875000000013,15.718324999999998,4352136,7086988.2,70.17745596573374,4.797809971772918,1.5,2.75,NaN,NaN,0.3296922839053274,0.6141023347548399,448.2854940218883,0.09428589717705033,0.33310379872361295,0.23881790154656263,32.78797263231194,11.594972561515307,68.31886680303784,8.168817071144636,23.512316125817534,4834758096
1388154600,15.8175,15.835,15.6975,15.7525,14.240385204081633,15.780250760000001,14.92,6.233271,12.5275,6.233271,11.705003,5.292446,7.932421,3.510798,11.928232804999995,13.114477559999996,14.315550020000014,14.802375000000012,14.25630761398527,14.908086509357904,14.875769230769235,16.067668788707326,13.683869672831143,11.928232804999995,13.114477559999996,14.315550020000014,14.802375000000012,15.761666666666665,3594460,7055021.4,69.98338941320068,4.19584096151202,1.5,2.75,NaN,NaN,0.31596426362637553,0.50948959559499,449.4696282680967,0.10224954856213497,0.36662983724923137,0.2643802886870964,31.193150421026303,11.700053182059921,84.5627756339859,2.1178582327747626,13.31936613323936,4831163636
1388413800,15.75,15.7825,15.68,15.735,14.295028571428572,15.8200008,14.92,6.233271,12.5275,6.233271,11.705003,5.292446,7.932421,3.510798,11.958933284999995,13.150302559999995,14.368649960000013,14.848000000000013,14.31429555069173,14.986840175133342,14.949615384615388,16.223526452266512,13.675704316964266,11.958933284999995,13.150302559999995,14.368649960000013,14.848000000000013,15.7325,2427284,6928755.2,69.50043950235177,3.439283748488902,1.5,2.75,NaN,NaN,0.3007168162244916,0.3503203576884921,448.905227358196,0.09835380693073015,0.3873225473505091,0.28896874041977894,31.149479837791095,9.460869565217388,62.407878214908294,11.292499804139597,26.299621980952104,4828736352
1388500200,15.81,15.955,15.755,15.95,14.349671938775511,15.85975084,14.92,6.233271,12.5275,6.233271,11.705003,5.292446,7.932421,3.510798,11.991529589999995,13.187152559999994,14.421249960000013,14.909500000000012,14.378440823213623,15.078569682263499,15.079807692307696,16.38961164348991,13.77000374112548,11.991529589999995,13.187152559999994,14.421249960000013,14.909500000000012,15.886666666666665,5003800,6832571.6,72.05219961869317,3.6799771192252826,1.5,2.75,NaN,NaN,0.29495132935131363,0.7323450514591022,452.11511377153164,0.10184248734161977,0.41627184959680363,0.31442936225518386,30.776734858466444,12.18568665377176,61.319671862951,11.908930547093055,26.771397589955942,4833740152
1388673000,15.78,15.7925,15.3875,15.51,14.40431530612245,15.899500880000002,14.92,6.233271,12.5275,6.233271,11.705003,5.292446,7.932421,3.510798,12.022192559999997,13.220502559999995,14.464499960000014,14.95737500000001,14.42281569289152,15.11965828395269,15.186538461538465,16.388612852013814,13.984464071063114,12.022192559999997,13.220502559999995,14.464499960000014,14.95737500000001,15.563333333333333,7065516,6784920.2,60.83468972303184,1.506006665222378,1.5,2.75,NaN,NaN,0.3140619486833627,1.0413557995862648,448.3248371083976,0.0677440086068421,0.3991093730137365,0.3313653644068944,36.148773994547376,3.676470588235287,25.745009632979894,41.768342463817554,32.48664790320256,4826674636
1388759400,15.58,15.6665,15.4275,15.4675,14.458958673469388,15.939250920000001,14.92,6.233271,12.5275,6.233271,11.705003,5.292446,7.932421,3.510798,12.051759709999997,13.254002559999995,14.502899960000013,15.005250000000009,14.46378370493499,15.152786066433386,15.291538461538465,16.32284371826141,14.26023320481552,12.051759709999997,13.254002559999995,14.502899960000013,15.005250000000009,15.520499999999998,4637780,6324190.8,59.865196962515355,1.2442777494107704,1.5,2.75,NaN,NaN,0.30870038092026525,0.7333396709030348,451.44337438174784,0.03708724437288524,0.377724419873001,0.34063717550011574,24.480956407045145,3.565450284566447,6.941086530552644,71.05737453430231,22.00153893514503,4822036856
1389018600,15.64,15.655,15.2825,15.35,14.513602040816327,15.97900096,14.92,6.233271,12.5275,6.233271,11.705003,5.292446,7.932421,3.510798,12.081897674999995,13.285102529999994,14.542350000000015,15.056000000000012,14.498537285133617,15.171568345820683,15.366538461538465,16.25178840117207,14.48128852190486,12.081897674999995,13.285102529999994,14.542350000000015,15.056000000000012,15.429166666666667,8282840,6374622.4,57.153329689763055,0.5189264751183098,1.5,2.75,NaN,NaN,0.31325749656881763,1.2993459816537525,449.7915355795122,0.005323904231769316,0.34729205578982736,0.34196815155805804,25.154026115981498,1.1198945981554673,4.311681999692332,77.4329652928463,18.255352707461345,4813754016
1389105000,15.5475,15.7125,15.51,15.6325,14.568245408163266,16.018751,14.92,6.233271,12.5275,6.233271,11.705003,5.292446,7.932421,3.510798,12.112418984999998,13.320952529999994,14.585000000000015,15.09750000000001,14.54300641120681,15.215466598599665,15.475384615384618,16.06851142162762,14.882257809141617,12.112418984999998,13.320952529999994,14.585000000000015,15.09750000000001,15.618333333333334,5583240,6195053.8,61.65123830976037,1.620510377589179,1.5,2.75,NaN,NaN,0.31677481824247355,0.9012415679101932,453.2139095623143,0.00004700179901684365,0.3420269038068291,0.34197990200781225,25.561797461489252,1.394519215177557,16.546179466377893,53.67868640860356,29.775134125018553,4819337256
1389191400,15.635,15.7175,15.4825,15.64,14.622888775510205,16.05850104,15.95,6.233271,12.5275,6.233271,11.705003,5.292446,7.932421,3.510798,12.143427794999996,13.362127529999995,14.624150000000016,15.133500000000009,14.58602576763007,15.255898351113983,15.52769230769231,16.044860862043276,15.010523753341346,12.143427794999996,13.362127529999995,14.624150000000016,15.133500000000009,15.613333333333337,6792220,6188506.8,61.76599310937154,1.1999479402418265,1.5,2.75,NaN,NaN,0.31093375979658255,1.0975539365974358,451.43079790583084,-0.005902055336973078,0.3346023328365959,0.340504388173569,24.28002233998549,0.7083065035415403,20.11007646597971,48.64225427055362,31.24766926346667,4826129476
1389277800,15.79,15.7975,15.460025,15.6675,14.677532142857144,16.09825108,15.95,6.233271,12.5275,6.233271,11.705003,5.292446,7.932421,3.510798,12.173553274999994,13.404427529999996,14.662400000000016,15.178125000000012,14.628436521840657,15.295098508150746,15.584038461538464,15.974794821108437,15.19328210196849,12.173553274999994,13.404427529999996,14.662400000000016,15.178125000000012,15.641675000000001,6452748,6238241.4,62.21249555214613,1.158226672249571,1.5,2.75,NaN,NaN,0.31282956266825523,1.0343857485220114,452.1149653607591,-0.010670741359402325,0.3271659614743161,0.3378367028337184,24.000209060338857,-0.5869289340101482,47.80536577135139,20.737446937948604,31.45718729070001,4832582224
1389364200,15.7525,15.8175,15.51,15.7825,14.732175510204083,16.138001120000002,15.95,6.233271,12.5275,6.233271,11.705003,5.292446,7.932421,3.510798,12.204257924999995,13.450227529999996,14.698450000000015,15.254375000000014,14.673693913141022,15.341517697850675,15.630384615384617,15.955942398001598,15.304826832767636,12.204257924999995,13.450227529999996,14.698450000000015,15.254375000000014,15.703333333333333,6011864,6154413,64.10053816975605,1.26097465681192,1.5,2.75,NaN,NaN,0.3124488796205228,0.9768379210170003,455.52217696397526,-0.008841244872193121,0.32678514674347703,0.33562639161567015,22.79045609255752,0.19044596095858524,70.44085109681201,7.145098807830474,22.414050095357513,4838594088
1389623400,15.675,15.805,15.08,15.18,14.78681887755102,16.17775116,15.95,6.233271,12.5275,6.233271,11.705003,5.292446,7.932421,3.510798,12.231662574999994,13.488352529999995,14.726800000000015,15.307250000000014,14.693549053802158,15.326135059960134,15.612115384615388,16.00342406738016,15.220806701850616,12.231662574999994,13.488352529999995,14.726800000000015,15.307250000000014,15.354999999999999,7871216,6138019.4,50.00400630582055,1.3064546574253508,1.5,2.75,NaN,NaN,0.3419168167904854,1.2823706617805737,450.860274634096,-0.048741063448647315,0.274700062304861,0.3234411257535083,31.974160193018875,-3.5271687321258325,73.1148090071432,6.028904825140311,20.856286167716508,4830722872
1389709800,15.3125,15.685,15.235,15.6575,14.84146224489796,16.2175012,15.95,6.233271,12.5275,6.233271,11.705003,5.292446,7.932421,3.510798,12.261846389999992,13.533277529999996,14.767650000000014,15.385000000000014,14.73135105169227,15.357693625678216,15.62192307692308,16.010891900303733,15.232954253542426,12.261846389999992,13.533277529999996,14.767650000000014,15.385000000000014,15.525833333333335,5931540,6206612,57.90500625470391,0.9021650461145921,1.5,2.75,NaN,NaN,0.3535656155911651,0.9556808126559224,454.64317627537434,-0.043670226188750716,0.2688533430175699,0.31252356920632063,37.69807003691455,-1.8338557993730324,73.45619434443161,5.886772844218088,20.65703281135031,4836654412
1389796200,15.7675,15.985,15.75,15.915,14.896105612244899,15.985,15.95,6.233271,12.5275,6.233271,11.705003,5.292446,7.932421,3.510798,12.292646389999991,13.577902529999994,14.811150000000014,15.462000000000014,14.77776865750826,15.410770423232671,15.633846153846157,16.047719115517207,15.219973192175107,12.292646389999991,13.577902529999994,14.811150000000014,15.462000000000014,15.883333333333333,6478024,6200541.4,61.443608708165634,2.294406824142464,1.5,2.75,NaN,NaN,0.3517037859060818,1.0447513502611239,455.70165176888867,-0.024618827506157515,0.2817500348236237,0.3063688623297812,38.10186884040375,2.611218568665373,73.26601858453961,5.9657605620664995,20.768220853393885,4843132436
1389882600,15.8175,15.869975,15.7,15.8475,14.950748979591838,16.015967741935484,15.95,6.233271,12.5275,6.233271,11.705003,5.292446,7.932421,3.510798,12.324683899999991,13.620677529999996,14.850450000000013,15.543500000000018,14.819718906233426,15.452363716258132,15.641153846153848,16.066348893634846,15.215958798672851,12.324683899999991,13.620677529999996,14.850450000000013,15.543500000000018,15.805824999999997,4510480,6155924.4,60.01930210086098,1.399101400829166,1.5,2.75,NaN,NaN,0.34193922976993313,0.7327055543437148,457.48116481089386,-0.018488019025164282,0.2832588385483259,0.3017468575734902,33.999740114245995,2.4567641829642852,50.296112550211966,18.99742965820249,30.706457791585553,4838621956
1389969000,15.7725,15.855,15.567675,15.6375,15.005392346938777,16.046935483870968,15.95,6.233271,12.5275,6.233271,11.705003,5.292446,7.932421,3.510798,12.35500890999999,13.662652549999995,14.888150000000012,15.577375000000018,14.851788753047801,15.469995743281167,15.633653846153846,16.05538842995223,15.21191926235546,12.35500890999999,13.662652549999995,14.888150000000012,15.577375000000018,15.686725000000003,5636060,5826096,55.69382492487999,0.5665122911804522,1.5,2.75,NaN,NaN,0.3380382133577951,0.967381931228047,455.1285314520956,-0.0298288524392768,0.2644607920243942,0.294289644463671,35.08190280953447,1.8729641693811052,24.381468463159294,43.3304837919248,32.28804774491591,4832985896
1390314600,15.925,15.9325,15.4925,15.7875,15.060035714285714,16.077903225806452,15.95,6.233271,12.5275,6.233271,11.705003,5.292446,7.932421,3.510798,12.38670891999999,13.711602519999994,14.924950000000013,15.620000000000019,14.88848331175181,15.500234243921057,15.621153846153847,16.01323221049825,15.229075481809444,12.38670891999999,13.711602519999994,14.924950000000013,15.620000000000019,15.737499999999999,5273588,5675586.6,58.02101402944411,0.751996711391028,1.5,2.75,NaN,NaN,0.34532119811795253,0.9291705636206837,458.5527101857484,-0.028483722321060223,0.2586849915623457,0.2871687138834059,34.90436731325109,0.9915240684471412,55.06838653740502,15.716655784355932,29.21495767823906,4838259484
1390401000,15.8675,15.8825,15.715,15.815,15.114679081632653,16.108870967741936,15.95,6.233271,12.5275,6.233271,11.705003,5.292446,7.932421,3.510798,12.41759641999999,13.759777489999994,14.972450000000013,15.651750000000018,14.924817299526248,15.530211934976194,15.644615384615387,16.043719410739705,15.24551135849107,12.41759641999999,13.759777489999994,14.972450000000013,15.651750000000018,15.804166666666667,5788060,5529490.8,58.45188266681732,1.1330615518872496,1.5,2.75,NaN,NaN,0.33261968396667024,1.046761846497692,461.6199831219747,-0.027010533625082822,0.2534055468520524,0.28041608047713523,33.495383647290204,1.1189258312020391,54.90821927785127,15.821862912201311,29.269917809947415,4844047544
1390487400,15.58,15.5825,15.1775,15.4275,15.169322448979592,16.13983870967742,15.95,6.233271,12.5275,6.233271,11.705003,5.292446,7.932421,3.510798,12.44614641999999,13.803452459999994,15.001550000000014,15.652250000000018,14.944530346603651,15.520429845930842,15.641538461538463,16.046628852503332,15.236448070573594,12.44614641999999,13.803452459999994,15.001550000000014,15.652250000000018,15.395833333333336,8831348,5688996,50.57471515027117,1.8865435980822285,1.5,2.75,NaN,NaN,0.35439684939762234,1.5523561626691247,457.96148406025344,-0.05195707529377269,0.2154697363599194,0.2674268116536921,36.66829092608467,-1.531833413116325,19.71127051449126,49.32437019971889,30.964359285789847,4835216196
1390573800,15.1225,15.135,14.4275,14.4275,15.223965816326531,16.170806451612904,15.95,6.233271,12.5275,6.233271,11.705003,5.292446,7.932421,3.510798,12.467796419999988,13.838352459999994,15.010850000000014,15.59712500000002,14.924254646736841,15.416341289175524,15.570576923076926,16.32642630226809,14.814727543885763,12.467796419999988,13.838352459999994,15.010850000000014,15.59712500000002,14.663333333333334,15681088,6310264.6,36.79423541676326,5.893355418654417,1.5,2.75,NaN,NaN,0.40051136015493505,2.4850127520801584,451.65776752909,-0.1311251515872157,0.10352037216967247,0.23464552375688816,52.3581008392789,-8.585458577538416,10.87252140278355,63.11382261183555,26.013655985380886,4819535108
1390833000,14.485,14.585,14.005,14.22,15.27860918367347,16.201774193548385,15.95,6.233271,12.5275,6.233271,11.705003,5.292446,7.932421,3.510798,12.487933919999987,13.869702459999994,15.017400000000015,15.520125000000021,14.896636817453043,15.30240402353976,15.461923076923082,16.50315044780315,14.420695706043013,12.487933919999987,13.869702459999994,15.017400000000015,15.520125000000021,14.27,14229056,6804110.6,34.68247906764013,7.061313996181165,1.5,2.75,NaN,NaN,0.4133319772867254,2.0912440782488164,446.91678418415796,-0.1892537546395652,-0.0019216695425683383,0.18733208509699686,51.477075925435095,-6.3241106719367535,7.059275075751956,70.62719068159448,22.31353424265356,4805306052
1390919400,14.255,14.5275,14.245,14.48,15.33325255102041,16.23274193548387,15.95,6.233271,12.5275,6.233271,11.705003,5.292446,7.932421,3.510798,12.509758904999988,13.900752459999994,15.022700000000013,15.456500000000023,14.880298118729394,15.224079830821687,15.37269230769231,16.52993781309007,14.21544680229455,12.509758904999988,13.900752459999994,15.022700000000013,15.456500000000023,14.417499999999999,7117280,6980251.6,39.37750266365804,5.132412294338774,1.5,2.75,NaN,NaN,0.4057725503376735,1.0196308683199902,450.94375511096644,-0.20088192061808122,-0.06377031567560465,0.13711160494247657,50.319914081265686,-7.520357656075364,8.395183413954078,67.76886261928469,23.83595396676125,4812423332
1391005800,14.1275,14.347475,13.945,14.0475,15.387895918367349,16.263709677419353,15.95,6.233271,12.5275,6.233271,11.705003,5.292446,7.932421,3.510798,12.532846404999988,13.927277459999994,15.014650000000012,15.372125000000022,14.847639368975301,15.112024608838668,15.248076923076926,16.58625041109097,13.909903435062883,12.532846404999988,13.927277459999994,15.014650000000012,15.372125000000022,14.113324999999998,8327048,7275239.8,34.88540396616199,6.480594033885757,1.5,2.75,NaN,NaN,0.4150030824564111,1.1445736812688978,446.51493384212694,-0.22649082748906937,-0.14600192941886014,0.08048889807020923,46.575014190922765,-11.734213006597548,2.023975544481178,84.87809107030529,13.097933385213528,4804096284
1391092200,14.41,14.635,14.275,14.5075,15.442539285714286,16.294677419354837,15.95,6.233271,12.5275,6.233271,11.705003,5.292446,7.932421,3.510798,12.556258904999991,13.958152479999992,15.012150000000013,15.300000000000022,14.834300570191957,15.05445083656832,15.150000000000004,16.50392307473789,13.796076925262119,12.556258904999991,13.958152479999992,15.012150000000013,15.300000000000022,14.472500000000002,9116216,7480860.6,42.41032813015093,3.1608195349947783,1.5,2.75,NaN,NaN,0.42732429085238177,1.2186052497756743,450.6117014892653,-0.20204664731711264,-0.17206941107618157,0.02997723624093107,50.67383313791611,-8.455592364726298,11.879129834857903,61.180621404742915,26.94024876039918,4813212500
1391178600,13.9625,14.515,13.9425,14.2325,15.497182653061225,16.32564516129032,15.95,6.233271,12.5275,6.233271,11.705003,5.292446,7.932421,3.510798,12.580533914999991,13.982877499999994,15.007150000000014,15.236125000000024,14.810700547831487,14.976169804514194,15.077115384615386,16.516073135309973,13.6381576339208,12.580533914999991,13.982877499999994,15.007150000000014,15.236125000000024,14.230000000000002,9188908,7587030.2,39.4734343729081,4.224571894543375,1.5,2.75,NaN,NaN,0.4376939843629259,1.2111337055176081,447.689172366983,-0.19395704391969248,-0.21246906865868453,-0.01851202473899205,50.85473234668346,-8.984812150279772,15.682212442226845,54.97567936992343,29.34210818784973,4804023592
1391437800,14.1875,14.285,13.1975,13.2775,15.551826020408164,16.356612903225805,15.95,6.233271,12.5275,6.233271,11.705003,5.292446,7.932421,3.510798,12.600771414999992,13.995552519999992,14.985050000000012,15.126625000000024,14.75057503615182,14.814391727893796,14.894038461538464,16.576115403963122,13.211961519113807,12.600771414999992,13.995552519999992,14.985050000000012,15.126625000000024,13.586666666666668,21695836,8439933,31.353418710850335,9.621422940723388,1.5,2.75,NaN,NaN,0.484108699765574,2.570617089021915,442.2939793112983,-0.23949618684071972,-0.3178822582898917,-0.07838607144917198,61.04804719974003,-15.898653998416467,12.529530407670194,60.09345196002235,27.37701763230747,4782327756
1391524200,13.46,13.655,13.315,13.555,15.606469387755103,16.38758064516129,15.95,6.233271,12.5275,6.233271,11.705003,5.292446,7.932421,3.510798,12.62132141499999,14.009752539999992,14.971200000000012,15.036875000000023,14.703689740616456,14.694449658570576,14.712500000000004,16.423795056157992,13.001204943842017,12.62132141499999,14.009752539999992,14.971200000000012,15.036875000000023,13.508333333333335,13088328,8680207.4,35.50507861905575,7.011059354969332,1.5,2.75,NaN,NaN,0.47649379263946157,1.507835861156958,443.833811879258,-0.23706042096071797,-0.37471159765006945,-0.13765117668935148,63.07342412223858,-14.290230793550425,18.416869663198828,51.00453855882715,30.578591777974022,4795416084
1391610600,13.4075,13.595,13.17,13.4925,13.17,16.418548387096774,15.95,6.233271,12.5275,6.233271,11.705003,5.292446,7.932421,3.510798,12.64092142499999,14.024277539999993,14.949450000000011,14.929875000000024,14.656192103729536,14.579978262516235,14.531346153846158,16.22216140484721,12.840530902845106,12.64092142499999,14.024277539999993,14.949450000000011,14.929875000000024,13.419166666666667,7805116,8791301.2,34.99177940683957,6.68141338492802,1.5,2.75,NaN,NaN,0.4728156645937858,0.8878226126526072,441.60408137688614,-0.2258402955912484,-0.419951546178412,-0.1941112505871636,62.551286058506385,-12.54253767622752,18.9594860256863,50.24622603820823,30.794287936105476,4787610968
1391697000,13.6025,14.0325,13.602475,14.0225,13.14679609375,16.449516129032258,15.95,6.233271,15.95,6.233271,12.5275,5.292446,11.705003,3.510798,12.661583924999992,14.043425039999995,14.934200000000011,14.849000000000023,14.631341432995045,14.526885094657546,14.407115384615391,15.988351325451456,12.825879443779327,12.661583924999992,14.043425039999995,14.934200000000011,14.849000000000023,13.885825000000002,7728144,8838097.4,42.573580611584674,2.7972016460978253,1.5,2.75,NaN,NaN,0.4776145456942298,0.8744126309357034,445.61448451539144,-0.17137577985893787,-0.40833097541083596,-0.2369551955518981,69.41038678360405,-2.807139143995837,17.03090716204124,52.995244619168965,29.973848218789804,4795339112
1391783400,14.23,14.6,14.0975,14.565,13.1235921875,16.480483870967742,15.95,6.233271,15.95,6.233271,12.5275,5.292446,11.705003,3.510798,12.68483392499999,14.065875039999996,14.930150000000012,14.793875000000023,14.62873980817171,14.530515085642541,14.31307692307693,15.686506311150328,12.93964753500353,12.68483392499999,14.065875039999996,14.930150000000012,14.793875000000023,14.420833333333334,12395644,9135242.2,49.115406485604105,1.258980053588684,1.5,2.75,NaN,NaN,0.48474922100178475,1.3569037063954366,447.641403626755,-0.0914733170775166,-0.35129684189879384,-0.25982352482127724,63.51364772771418,2.4261603375527345,40.52354021110541,26.674163062270427,32.802296726624164,4807734756
1392042600,14.5625,14.65,14.4425,14.6275,13.10038828125,16.511451612903226,15.95,13.2775,15.95,6.233271,12.5275,5.292446,11.705003,3.510798,12.70783392499999,14.087400059999998,14.927350000000013,14.73612500000002,14.628691188243408,14.539751744152776,14.221730769230776,15.312265896544575,13.131195641916976,12.70783392499999,14.087400059999998,14.927350000000013,14.73612500000002,14.573333333333332,7870864,9228192.2,49.82456504001509,1.6389694092108913,1.5,2.75,NaN,NaN,0.464945705215943,0.8529150487351141,449.9011343582191,-0.030239453471912536,-0.2976228416611679,-0.2673833881892554,62.75525433558971,1.0186464088397726,83.22350420612077,2.4753712716172345,14.301124522262013,4815605620
1392129000,14.69,15.23,14.6525,15.11,13.077184375,16.54241935483871,15.95,13.2775,15.95,6.233271,12.5275,5.292446,11.705003,3.510798,12.73345892499999,14.109175059999998,14.932300000000014,14.732625000000022,14.647566043606412,14.594061101852512,14.197307692307696,15.188422956772744,13.206192427842648,12.73345892499999,14.109175059999998,14.932300000000014,14.732625000000022,14.9975,7576124,9213437.6,55.03456606881515,4.363872224010796,1.5,2.75,NaN,NaN,0.47477101198623284,0.822290694192144,454.2216281571577,0.042955654161481394,-0.21368882048740367,-0.25664447464888507,64.54266890968779,7.563623420537462,81.29419622257791,3.0405961320597217,15.665207645362356,4823181744
1392215400,15.1875,15.325,15.0525,15.1575,13.05398046875,16.57338709677419,15.95,13.2775,15.95,6.233271,12.5275,5.292446,11.705003,3.510798,12.75840892499999,14.13205006,14.939000000000014,14.707625000000021,14.667563453661062,14.64772194929513,14.253461538461542,15.365700338328276,13.141222738594807,12.75840892499999,14.13205006,14.939000000000014,14.707625000000021,15.178333333333333,7738448,9303783,55.52417758673865,4.026242303008024,1.5,2.75,NaN,NaN,0.4603230825586447,0.8317528472020468,455.4390900410519,0.0919522409468157,-0.14170417346536546,-0.23365641441218116,60.73561314164186,4.480441151128728,100.00000000000001,0,0,4830920192
1392301800,14.8375,15.42,14.8225,15.375,13.0307765625,16.604354838709675,15.95,13.2775,15.95,6.233271,12.5275,5.292446,11.705003,3.510798,12.78410892499999,14.159950059999998,14.952100000000014,14.68062500000002,14.695306063321413,14.716986525552738,14.342307692307696,15.60412637600696,13.080489008608431,12.78410892499999,14.159950059999998,14.952100000000014,14.68062500000002,15.205833333333333,12641896,9611976.6,57.790557874881785,4.462323233401371,1.5,2.75,NaN,NaN,0.47012143380445576,1.3152233433443856,458.97338319105734,0.13385260671738758,-0.0663406560154467,-0.20019326273283428,58.92327130994065,8.027402072720886,100.00000000000001,0,0,4843562088
1392388200,15.34,15.71,15.2875,15.6225,13.00757265625,16.63532258064516,15.95,13.2775,15.95,6.233271,12.5275,5.292446,11.705003,3.510798,12.81235892499999,14.19195006,14.973500000000012,14.66937500000002,14.731666609857827,14.803225904071525,14.430192307692312,15.865369141528024,12.9950154738566,12.81235892499999,14.19195006,14.973500000000012,14.66937500000002,15.540000000000001,9148396,9843872.4,60.27147288426821,5.206231969198245,1.5,2.75,NaN,NaN,0.4667199028184233,0.9293493076972432,462.158603916213,0.17071816497001255,0.013204443479681416,-0.15751372149033113,56.89926078224557,17.661457352664286,100.00000000000001,0,0,4852710484
1392733800,15.66,15.745,15.535,15.6775,12.98436875,16.666290322580643,15.95,13.2775,15.95,6.233271,12.5275,5.292446,11.705003,3.510798,12.83958393499999,14.22540006,14.996850000000013,14.67137500000002,14.768758115353599,14.88649010368376,14.555576923076929,16.114578272370956,12.996575573782904,12.83958393499999,14.22540006,14.996850000000013,14.67137500000002,15.652500000000003,5578700,9841004.4,60.82254778806188,4.8785730468144495,1.5,2.75,NaN,NaN,0.4483827669028216,0.5668831933455898,465.20540861424087,0.18982144841416815,0.07976308902737905,-0.1100583593867891,28.114428919676406,15.658428624123944,100,0,0,4858289184
1392820200,15.5575,15.8625,15.33,15.375,12.96116484375,16.697258064516127,15.95,13.2775,15.95,6.233271,12.5275,5.292446,11.705003,3.510798,12.86379643499999,14.256925059999999,15.017650000000012,14.65075000000002,14.79253230690836,14.933014855713878,14.622307692307698,16.24050524316775,13.004110141447647,12.86379643499999,14.256925059999999,15.017650000000012,14.65075000000002,15.5225,13063088,10230479.4,56.20481238279678,3.3824453076628904,1.5,2.75,NaN,NaN,0.45439114069547726,1.276879361098171,462.0120513113076,0.17354280014331627,0.10687014079235624,-0.06667265935096003,34.65744982508925,13.952195664257923,67.668765055303,8.469133445681402,23.8621014990156,4845226096
1392906600,15.4225,15.7425,15.2675,15.635,12.9379609375,16.72822580645161,15.95,13.2775,15.95,6.233271,12.5275,5.292446,11.705003,3.510798,12.888783934999992,14.28977508,15.034300000000012,14.64175000000002,14.825570255657052,14.999870583741128,14.730192307692315,16.415661269525128,13.044723345859504,12.888783934999992,14.28977508,15.034300000000012,14.64175000000002,15.548333333333332,10673200,10474736.4,59.08041152764899,3.7439558664013455,1.5,2.75,NaN,NaN,0.45586320207437175,1.0189468825201176,465.0838005791282,0.171442692928781,0.14763070681001622,-0.023811986118764783,32.90213137167774,11.49937600285255,70.02127876352074,7.356285109270865,22.622436127208402,4855899296
1392993000,15.7325,15.837475,15.5575,15.59,12.91475703125,16.759193548387096,15.95,13.2775,15.95,6.233271,12.5275,5.292446,11.705003,3.510798,12.912808934999994,14.323725079999999,15.047700000000013,14.649875000000018,14.855547892690108,15.056073385289592,14.90807692307693,16.422135597184063,13.394018248969795,12.912808934999994,14.323725079999999,15.047700000000013,14.649875000000018,15.661658333333335,4687816,10267559.8,58.366101917692944,3.193189395510921,1.5,2.75,NaN,NaN,0.44329975906905955,0.45656573629110975,466.29274162878215,0.15848437161394538,0.17429347839866693,0.015809106784721562,30.44134546222112,7.037418468932374,47.85422151635467,20.742057089915313,31.403721393730017,4851211480
1393252200,15.685,16.1575,15.665,15.8075,12.891553125,16.79016129032258,15.95,13.2775,15.95,6.233271,12.5275,5.292446,11.705003,3.510798,12.937121434999993,14.361700099999998,15.068350000000015,14.718875000000017,14.892879347878731,15.127637824785822,15.08134615384616,16.444382379145875,13.718309928546448,12.937121434999993,14.361700099999998,15.068350000000015,14.718875000000017,15.876666666666665,10555028,10011256.8,60.831095736358236,4.709455847168433,1.5,2.75,NaN,NaN,0.45217120484984097,1.0543159775903461,469.0469853699675,0.15579054748667637,0.21054729114306703,0.05475674365639066,25.22073985536638,8.066997094513757,50.984940232347995,18.53862364503037,30.476436122621642,4861766508
1393338600,15.8775,16.0125,15.667525,15.81,12.86834921875,16.821129032258064,15.95,13.2775,15.95,6.233271,12.5275,5.292446,11.705003,3.510798,12.961933934999992,14.397025099999999,15.099400000000012,14.798375000000016,14.928844863648193,15.192624698615743,15.25961538461539,16.316670157510064,14.202560611720717,12.961933934999992,14.397025099999999,15.099400000000012,14.798375000000016,15.830008333333334,7138544,9656731.2,60.85978090734139,3.131209192928629,1.5,2.75,NaN,NaN,0.44451433307485233,0.7392298545081176,467.7323921477859,0.145595650160597,0.23675130635713693,0.09115565619653992,25.56219256431797,4.632693580410332,52.989131062104796,17.13796276019719,29.872906177698006,4868905052
1393425000,15.9,16.0125,15.687525,15.8225,12.8451453125,16.852096774193548,15.95,13.2775,15.95,6.233271,12.5275,5.292446,11.705003,3.510798,12.986258934999993,14.433050099999997,15.133400000000012,14.865500000000015,14.96389016311297,15.2526128225571,15.398076923076928,16.214935713825774,14.58121813232808,12.986258934999993,14.433050099999997,15.133400000000012,14.865500000000015,15.840841666666666,4837872,9542760.8,61.0135201481075,2.757020253327091,1.5,2.75,NaN,NaN,0.43597580928379137,0.5069677529798294,470.28958116822895,0.13153999353802806,0.255580648119075,0.12404065458104693,20.30566410040069,4.387267029523333,87.32277037153689,1.4650264229463708,11.212203205516747,4873742924
1393511400,15.7525,16.0775,15.71,16.0775,12.82194140625,16.883064516129032,15.95,13.2775,15.95,6.233271,12.5275,5.292446,11.705003,3.510798,13.011746434999994,14.474900069999999,15.172900000000013,14.967000000000013,15.007561137108539,15.331173506123092,15.514423076923082,16.25036087176027,14.778485282085894,13.011746434999994,14.474900069999999,15.172900000000013,14.967000000000013,15.955000000000002,9284608,9590638.8,64.11053517596336,3.1267228213305875,1.5,2.75,NaN,NaN,0.43108468004923484,0.9680906760871861,473.5824730970511,0.1309772857524885,0.28776226177165753,0.15678497601916905,21.278554292807755,4.569105691056914,86.89334345797035,1.5611100611945115,11.54554648083514,4883027532
1393597800,16.0625,16.4125,15.870025,16.1975,12.7987375,16.914032258064516,15.95,13.2775,15.95,6.233271,12.5275,5.292446,11.705003,3.510798,13.036108934999994,14.515375039999999,15.209350000000013,15.051500000000013,15.054225406241537,15.413680791254226,15.63519230769231,16.25550693486661,15.01487768051801,13.036108934999994,14.515375039999999,15.209350000000013,15.051500000000013,16.160008333333334,11882664,9728961.2,65.49946673427175,3.4766642083526804,1.5,2.75,NaN,NaN,0.4390411314742896,1.2213702733237337,475.8457057899535,0.12998728662449432,0.31926908429978695,0.18928179767529263,20.651273627662928,3.6805888942230824,99.99999999999999,0,0,4894910196
1393857000,15.7675,15.9675,15.5275,15.84,12.77553359375,16.945,15.95,13.2775,15.95,6.233271,12.5275,5.292446,11.705003,3.510798,13.057871434999996,14.555350039999999,15.241800000000014,15.131875000000012,15.085040096192849,15.454282620658585,15.691346153846158,16.239263944509542,15.143428363182775,13.057871434999996,14.555350039999999,15.241800000000014,15.131875000000012,15.778333333333329,14548856,9996958.6,58.2650804065745,0.963428689072364,1.5,2.75,NaN,NaN,0.45553819351184044,1.4553282235259033,472.65666204613314,0.09801216515836986,0.31179700412325495,0.2137848389648851,24.644616829875297,1.0365173018657288,63.177858353055676,10.796830812275168,26.025310834669174,4880361340
1393943400,16.3225,16.6175,16.3075,16.5475,12.7523296875,16.97596774193548,15.95,13.2775,15.95,6.233271,12.5275,5.292446,11.705003,3.510798,13.083896434999994,14.606600039999998,15.273550000000014,15.295375000000012,15.142391464969599,15.558398561548243,15.798269230769238,16.424633540512943,15.171904921025531,13.083896434999994,14.606600039999998,15.273550000000014,15.295375000000012,16.49083333333333,7682988,9296316.2,66.21737420740902,4.6331662930618505,1.5,2.75,NaN,NaN,0.47853546540385183,0.8264551070240059,477.54482301392653,0.11603478041150517,0.35882831447926655,0.24279353406776139,34.64518785725865,7.626016260162598,63.97032513050767,10.367548369516108,25.66212649997621,4888044328
1394029800,16.5575,16.6465,16.485,16.5325,12.72912578125,17.006935483870965,15.95,13.2775,15.95,6.233271,12.5275,5.292446,11.705003,3.510798,13.108246444999994,14.657400039999997,15.305500000000016,15.444250000000014,15.19690552516687,15.651170127115076,15.887307692307699,16.573872333049675,15.200743051565722,13.108246444999994,14.657400039999997,15.305500000000016,15.444250000000014,16.554666666666666,6804356,8982117.6,65.93054129979265,4.113524842568171,1.5,2.75,NaN,NaN,0.4558900750178624,0.7575447464637961,476.82541780151206,0.11807750430638181,0.39039041445073863,0.2723129101443568,31.24406535377802,5.740326191237602,45.86948841869884,22.277072219163347,31.853439362137802,4881239972
1394116200,16.6875,16.79,16.6025,16.6775,12.705921875,17.03790322580645,15.95,13.2775,15.95,6.233271,12.5275,5.292446,11.705003,3.510798,13.133333944999993,14.702225039999998,15.335450000000016,15.603500000000015,15.254968053591698,15.748915829294592,15.968461538461545,16.753047510760943,15.183875566162147,13.133333944999993,14.702225039999998,15.335450000000016,15.603500000000015,16.689999999999998,6214688,8902596.2,67.40057854864985,4.206213464554569,1.5,2.75,NaN,NaN,0.4417193553737294,0.6980759163265207,478.96872132644734,0.11993896261171871,0.4222366134090052,0.3022976507972865,30.68569385293351,6.975625400898003,42.27761733193734,25.198247934546032,32.524134733516625,4887454660
1394202600,16.8625,16.8825,16.475,16.6825,12.68271796875,16.8825,15.95,13.2775,15.95,6.233271,12.5275,5.292446,11.705003,3.510798,13.158221429999992,14.744750039999996,15.360750000000017,15.736500000000015,15.310949698548887,15.837828607457013,16.04576923076924,16.895767838495214,15.195770623043265,13.158221429999992,14.744750039999996,15.360750000000017,15.736500000000015,16.680000000000003,10562088,9044293.4,67.45272975528675,3.5466672953159555,1.5,2.75,NaN,NaN,0.4392751157041772,1.1678179303647978,476.30234006318136,0.11238138834552919,0.44277438622919796,0.33039299788366877,30.38500740659904,5.535347145342412,40.90537737066432,26.368328495669534,32.72629413366616,4898016748
1394458200,16.6075,16.685,16.3875,16.665,12.6595140625,16.908142857142856,15.95,13.2775,15.95,6.233271,12.5275,5.292446,11.705003,3.510798,13.184233914999991,14.785525009999997,15.383450000000016,15.841500000000016,15.3640497103705,15.91660683531825,16.145000000000007,16.959035531260064,15.330964468739948,13.184233914999991,14.785525009999997,15.383450000000016,15.841500000000016,16.579166666666666,3594308,8604226.6,67.0484370966592,2.5570717439626733,1.5,2.75,NaN,NaN,0.42914832172530737,0.4177374872949069,475.0860593213396,0.09762429011946672,0.45242336053300214,0.3547990704135354,30.317829756030648,5.407969639468681,63.88602993980292,10.412320725751407,25.701649334445683,4894422440
1394544600,16.7525,16.8125,16.31,16.42,12.63631015625,16.933785714285715,15.95,13.2775,15.95,13.2775,12.5275,6.233271,11.705003,5.292446,13.20953391499999,14.826750009999998,15.396650000000015,15.931125000000018,15.405459525650087,15.964549041478417,16.20538461538462,16.974349569457114,15.436419661312124,13.20953391499999,14.826750009999998,15.396650000000015,15.931125000000018,16.514166666666668,10950136,8758190.2,61.49163317866628,1.874814989453575,1.5,2.75,NaN,NaN,0.43438772731635694,1.250273829403705,471.5971606708908,0.06438723720421169,0.43528311691880006,0.3708958797145884,32.384746067015584,3.776267972823523,27.51783799928066,39.59044090357395,32.89172109714539,4883472304
1394631000,16.19,16.447475,16.0675,16.43,12.61310625,16.95942857142857,15.95,13.2775,15.95,13.2775,12.5275,6.233271,11.705003,5.292446,13.235083914999988,14.862875009999998,15.410200000000014,15.997125000000016,15.44563758346773,16.00887770419476,16.270000000000007,16.958191610169507,15.581808389830504,13.235083914999988,14.862875009999998,15.410200000000014,15.997125000000016,16.314991666666668,5336508,8646209.4,61.63140861853257,0.7386224945153248,1.5,2.75,NaN,NaN,0.4305011039366173,0.6172078136344928,474.14012482059223,0.03743640067714571,0.4176913805610205,0.3802549798838748,32.39104002238516,2.192505053646395,49.855099214592975,19.263118154980546,30.881782630426475,4888808812
1394717400,16.5825,16.6175,15.745,15.9,12.58990234375,16.98507142857143,15.95,13.2775,15.95,13.2775,12.5275,6.233271,11.705003,5.292446,13.256958899999988,14.891074979999999,15.413500000000013,16.034250000000014,15.463455717449389,15.998508399033353,16.277115384615392,16.947720295681187,15.606510473549598,13.256958899999988,14.891074979999999,15.413500000000013,16.034250000000014,16.0875,7755376,8647055.8,51.05426606103436,1.8428912727614333,1.5,2.75,NaN,NaN,0.4620724536554303,0.8968805312901993,472.54245384302754,-0.018708413408444702,0.3568694631233189,0.3755778765317636,37.358161986816164,-1.8367031949374977,24.841261203720922,42.702524020559224,32.45621477571985,4881053436
1394803800,15.7925,16.029975,15.685,15.7275,12.5666984375,17.010714285714286,16.6825,13.2775,15.95,13.2775,12.5275,6.233271,11.705003,5.292446,13.279058899999988,14.915149979999999,15.409050000000011,16.051875000000017,15.473810395196471,15.972698075315892,16.270769230769236,16.96023218959852,15.581306271939951,13.279058899999988,14.915149979999999,15.409050000000011,16.051875000000017,15.814158333333332,9372932,8483607.6,48.157407595163825,2.2329621566131963,1.5,2.75,NaN,NaN,0.4537083498228996,1.104828563735079,474.5629906052122,-0.06735078804381883,0.29138939147699006,0.3587401795208089,37.3059178559618,-0.7102272727272773,2.6800113661621863,82.5021385661506,14.8178500676872,4871680504
1395063000,15.975,16.2775,15.9625,16.16,12.54349453125,17.036357142857142,16.6825,13.2775,15.95,13.2775,12.5275,6.233271,11.705003,5.292446,13.302771399999989,14.943274979999998,15.422050000000011,16.078750000000017,15.500719791463277,15.990536353857236,16.296730769230773,16.940632292445024,15.652829246016523,13.302771399999989,14.943274979999998,15.422050000000011,16.078750000000017,16.133333333333336,5727888,8312582.2,55.04482808552917,0.3140600166870922,1.5,2.75,NaN,NaN,0.4605863248355497,0.689062419136138,478.2952821265165,-0.06997767264280053,0.27126808871730823,0.34124576136010876,38.67280281480227,-2.341743465780325,11.228740350477606,62.43073068262385,26.340528966898535,4877408392
1395149400,16.2575,16.575,16.22,16.5125,12.520290625,17.062,16.6825,13.2775,15.95,13.2775,12.5275,6.233271,11.705003,5.292446,13.330643899999986,14.97292498,15.442950000000012,16.120500000000014,15.54039744670001,16.040247177299403,16.330192307692315,16.97024477410684,15.690139841277793,13.330643899999986,14.97292498,15.442950000000012,16.120500000000014,16.435833333333335,6570840,8362189.2,59.73951450000009,2.048764708736629,1.5,2.75,NaN,NaN,0.45733015877586747,0.7857798768772177,483.0612327886914,-0.04857115375818977,0.2805318191623716,0.32910297292056134,31.35363664713125,-0.12097383940722561,37.562679937831525,29.38505132734954,33.05226873481893,4883979232
1395235800,16.515,16.585,15.9325,16.2425,12.49708671875,17.087642857142857,16.6825,13.2775,15.95,13.2775,12.5275,6.233271,11.705003,5.292446,13.356381399999986,15.001575,15.460800000000011,16.163875000000015,15.567930880162756,16.059509350889936,16.333653846153855,16.97128050139914,15.69602719090857,13.356381399999986,15.001575,15.460800000000011,16.163875000000015,16.253333333333334,9406280,8179348.8,55.00155624695499,0.6754593811886808,1.5,2.75,NaN,NaN,0.47127086172044846,1.1500035308434333,478.38454287258315,-0.05283892050913053,0.26305432228414816,0.3158932427932787,32.72140739445906,-2.608304602008687,14.440693078088088,57.01348372232113,28.545823199590785,4874572952
1395322200,16.1375,16.56175,16.055,16.5275,12.4738828125,17.113285714285716,16.6825,13.2775,15.95,13.2775,12.5275,6.233271,11.705003,5.292446,13.384256399999988,15.031849999999999,15.47870000000001,16.208500000000015,15.605561041725,16.10407988890042,16.386538461538468,16.962697956221675,15.81037896685526,13.384256399999988,15.031849999999999,15.47870000000001,16.208500000000015,16.381416666666667,7273112,8009344.4,58.72293701007797,1.5222618258458023,1.5,2.75,NaN,NaN,0.4738050858832736,0.9080783191193526,477.90767260949957,-0.03743587471077553,0.2690983994048093,0.3065342741155848,34.08438889786498,-0.9291173385284048,37.680469427501095,29.276615687046302,33.04291488545261,4881846064
1395408600,16.7375,16.859975,16.292475,16.33,12.45067890625,17.138928571428572,16.6825,13.2775,15.95,13.2775,12.5275,6.233271,11.705003,5.292446,13.413531409999987,15.058325,15.492500000000012,16.245500000000014,15.633970412637746,16.125596089957522,16.369807692307695,16.938887453982566,15.800727930632824,13.413531409999987,15.058325,15.492500000000012,16.245500000000014,16.49415,6010548,8075481,55.30934174645581,1.4770486637573677,1.5,2.75,NaN,NaN,0.48049757974875396,0.7442959744441229,480.40767260949957,-0.041217696667624426,0.2550121532810543,0.29622984994867874,34.65249636957476,-2.0102010201020155,43.938229452813616,23.85395645380062,32.20781409338576,4875835516
1395667800,16.5175,16.565,15.92,16.125,12.427475,17.164571428571428,16.6825,13.2775,15.95,13.2775,12.5275,6.233271,11.705003,5.292446,13.440331409999988,15.082024999999998,15.50165000000001,16.261375000000015,15.653226474887246,16.125539319485377,16.338461538461544,16.91310704276946,15.763816034153626,13.440331409999988,15.082024999999998,15.50165000000001,16.261375000000015,16.203333333333333,5650148,7830237,51.93465873387073,0.5625719514233254,1.5,2.75,NaN,NaN,0.49224775262384307,0.721580713329622,477.12742871612824,-0.057210661715082156,0.224716522804826,0.28192718451990817,35.152366615852856,-1.7965895249695596,21.695628256372544,46.54674444118526,31.7576273024422,4870185368
1395754200,16.365,16.5225,16.09225,16.365,12.40427109375,17.190214285714287,16.6825,13.2775,15.95,13.2775,12.5275,6.233271,11.705003,5.292446,13.466356409999987,15.105875,15.51330000000001,16.289125000000016,15.68113916214657,16.148345098582006,16.31442307692308,16.855490945004178,15.773355208841984,13.466356409999987,15.105875,15.51330000000001,16.289125000000016,16.326583333333332,4690944,7707857,55.368043564812986,0.5795562536902299,1.5,2.75,NaN,NaN,0.48781934172214003,0.6085925050244186,479.31680954863594,-0.05148970195823771,0.21756505707211105,0.26905475903034876,35.69995655738327,-0.395617772367628,17.88261880910375,51.72400698939201,30.39337420150425,4874876312
1395840600,16.555,16.625,15.995,15.9975,12.3810671875,17.215857142857143,16.6825,13.2775,15.95,13.2775,12.5275,6.233271,11.705003,5.292446,13.490468909999986,15.128224999999997,15.52965000000001,16.297875000000015,15.69354546951337,16.133978898717054,16.261730769230773,16.782179483231804,15.741282055229744,13.490468909999986,15.128224999999997,15.52965000000001,16.297875000000015,16.205833333333334,6129084,7772417.6,49.53333933010214,0.25556446118735243,1.5,2.75,NaN,NaN,0.4979751030277015,0.7885685401154977,477.7401947301992,-0.07111065228974545,0.18016644366816692,0.25127709595791237,37.90877247109152,0.6132075471698122,22.379037104301247,45.67166072775206,31.949302167946694,4868747228
1395927000,15.9475,16.0975,15.725,15.92,12.35786328125,17.241500000000002,16.6825,13.2775,15.95,13.2775,12.5275,6.233271,11.705003,5.292446,13.515881394999985,15.151274999999998,15.53490000000001,16.290000000000017,15.702426039336375,16.113599955982096,16.20442307692308,16.69800556105218,15.710840592793982,13.515881394999985,15.151274999999998,15.53490000000001,16.290000000000017,15.914166666666668,6171836,7616779,48.375588835714126,1.7217466626010272,1.5,2.75,NaN,NaN,0.48901259566857996,0.8102947453247626,479.2632139778996,-0.08691766020389383,0.1426300207030451,0.22954768090693892,32.85060126011632,1.2239707518677525,3.320827913851936,80.35446255542726,16.324709530720785,4862575392
1396013400,16.0325,16.37,16.005,16.13,12.334659375,17.267142857142858,16.6825,13.2775,15.95,13.2775,12.5275,6.233271,11.705003,5.292446,13.543693894999985,15.175175,15.53920000000001,16.28662500000002,15.71919364563691,16.115161864936184,16.18211538461539,16.660694395670497,15.703536373560283,13.543693894999985,15.175175,15.53920000000001,16.28662500000002,16.168333333333333,4215584,7233425,51.67183721315297,0.3567672684384011,1.5,2.75,NaN,NaN,0.4862259816922529,0.5827922457203883,481.42985645478444,-0.08095985214766224,0.12834786572236112,0.20930771787002336,32.78966689592226,-0.18564356435644266,14.87156999565438,56.22970994186824,28.89872006247738,4866790976
1396272600,16.44,16.6025,16.3925,16.53,12.31145546875,17.292785714285714,16.6825,13.2775,15.95,13.2775,12.5275,6.233271,11.705003,5.292446,13.571181394999988,15.201649999999999,15.55285000000001,16.32112500000002,15.750989973258992,16.154670258751786,16.189807692307696,16.686931966889713,15.692683417725677,13.571181394999988,15.201649999999999,15.55285000000001,16.32112500000002,16.508333333333333,4537876,6732876,57.26860478015712,1.8650987033925832,1.5,2.75,NaN,NaN,0.4852455544285205,0.6739877579803936,485.1222355477727,-0.049362717233976755,0.1476043213275524,0.19696703856152917,32.09619581031504,0.10598031794096502,37.522495239565714,29.316358607918357,33.161146152515926,4871328852
1396359000,16.6975,16.8825,16.6475,16.8525,12.2882515625,17.318428571428573,16.6825,13.2775,15.95,13.2775,12.5275,6.233271,11.705003,5.292446,13.601318894999988,15.23265,15.577150000000008,16.33637500000002,15.794186444895894,16.22113023410876,16.263076923076927,16.841819438716037,15.684334407437818,13.601318894999988,15.23265,15.577150000000008,16.33637500000002,16.794166666666666,4366352,6567044.2,61.172766868568324,2.903000865715423,1.5,2.75,NaN,NaN,0.47576372911219755,0.664888474482934,486.95925480990695,-0.008185084314548313,0.18673568316834377,0.19492076748289208,31.62312434555751,3.755579498229949,37.020692150087534,29.780773138459093,33.19853471145336,4875695204
1396445400,16.93,17.0925,16.8315,17.02,12.26504765625,17.34407142857143,16.6825,13.2775,15.95,13.2775,12.5275,6.233271,11.705003,5.292446,13.630968894999988,15.263374999999998,15.601800000000008,16.360750000000017,15.842257564703898,16.297213068955543,16.362500000000004,16.981717868953066,15.743282131046945,13.630968894999988,15.263374999999998,15.601800000000008,16.360750000000017,16.981333333333335,4244456,6439049.2,63.06050395767773,3.4679245566345633,1.5,2.75,NaN,NaN,0.46042346274704077,0.6591743389691758,488.90814298977125,0.026965737160426106,0.2286279389334247,0.2016622017729986,29.527594475927128,2.979882014823777,68.96968041951702,7.81612717347041,23.214192407012572,4879939660
1396531800,17.1125,17.12,16.804,16.95,12.24184375,17.369714285714288,16.6825,13.2775,15.95,13.2775,12.5275,6.233271,11.705003,5.292446,13.659056394999986,15.298474999999998,15.624500000000006,16.37437500000002,15.88569844451943,16.35938325286454,16.423269230769236,17.103154358553518,15.743384102984955,13.659056394999986,15.298474999999998,15.624500000000006,16.37437500000002,16.958,3254472,6291038.4,61.71020489651861,2.770149372608234,1.5,2.75,NaN,NaN,0.4501075011222523,0.517318730720194,486.71639977539667,0.0412782503087715,0.253260014658963,0.21198176435019148,28.70862906501065,3.796693202694434,81.65341114266946,2.9167105889733214,15.429878268357239,4876685188
1396618200,17.235,17.2475,16.27,16.3625,12.21863984375,17.2475,16.6825,13.2775,15.95,13.2775,12.5275,6.233271,11.705003,5.292446,13.686406379999987,15.322374999999997,15.643200000000006,16.358375000000017,15.904396544734356,16.35968008592506,16.411730769230775,17.090256843258956,15.733204695202597,13.686406379999987,15.322374999999997,15.643200000000006,16.358375000000017,16.626666666666665,7700252,6147946.6,51.703579274863294,1.1857420681220003,1.5,2.75,NaN,NaN,0.4877783938992342,1.2524916855979198,485.5568658105384,0.008659707405735406,0.22280639860736073,0.21414669120162533,35.337570924888055,1.472868217054268,40.474832109983446,26.673323432710262,32.85184445730629,4868984936
1396877400,16.23,16.3125,15.7151,15.8025,12.1954359375,17.265749999999997,16.6825,13.2775,15.95,13.2775,12.5275,6.233271,11.705003,5.292446,13.715093889999986,15.340774999999997,15.670700000000005,16.315250000000017,15.900400601803597,16.306615315836957,16.377884615384623,17.12702218659015,15.628747044179097,13.715093889999986,15.340774999999997,15.670700000000005,16.315250000000017,15.943366666666668,8206904,6378576.4,44.32541510665919,3.1224789028973134,1.5,2.75,NaN,NaN,0.4991799371921461,1.2866356825325476,481.71594298235726,-0.04992914577596971,0.15173525898166318,0.2016644047576329,40.22906791151026,-3.4372135655361946,13.295503021204185,58.761477245368994,27.943019733426826,4860778032
1396963800,15.7975,16.0825,15.62,16.005,12.17223203125,17.284,16.6825,13.2775,15.95,13.2775,12.5275,6.233271,11.705003,5.292446,13.744318889999988,15.361899999999999,15.706400000000006,16.294500000000017,15.904502538987769,16.27789004766201,16.337692307692315,17.10622352806426,15.56916108732037,13.744318889999988,15.361899999999999,15.706400000000006,16.294500000000017,15.902499999999998,6742896,6168214.4,47.25643566549576,2.6221723927392886,1.5,2.75,NaN,NaN,0.4965599416784214,1.0931682270966456,484.8970223675732,-0.0729495945307321,0.11047741159421776,0.18342700612494986,39.93399152163605,0.046882325363328696,17.867749803368618,51.73676045308175,30.395489743549636,4867520928
1397050200,16.13,16.5325,16,16.5275,12.149028125,17.302249999999997,17.02,13.2775,15.95,13.2775,12.5275,6.233271,11.705003,5.292446,13.778093889999989,15.385024999999999,15.747350000000006,16.299375000000015,15.92893381196864,16.30166242407515,16.35288461538462,17.127987204509854,15.577782026259388,13.778093889999989,15.385024999999999,15.747350000000006,16.299375000000015,16.353333333333335,5491404,6175959.2,53.987498872441556,0.3908218455957707,1.5,2.75,NaN,NaN,0.4991270887013912,0.8891580760442848,487.0874091182743,-0.05188176719820381,0.1185747971271951,0.1704565643253989,41.98089103862506,3.8159547738693465,20.310773441635636,48.358294377460325,31.330932180904036,4873012332
1397136600,16.51,16.5375,15.42,15.48,12.12582421875,17.3205,17.02,13.2775,15.95,13.2775,12.5275,6.233271,11.705003,5.292446,13.805193874999988,15.395324999999998,15.776000000000005,16.27837500000002,15.911328564440458,16.223408859877516,16.30326923076924,17.202934520272002,15.403603941266473,13.805193874999988,15.395324999999998,15.776000000000005,16.27837500000002,15.8125,7975616,6186971.2,42.325590194671236,3.802951839168657,1.5,2.75,NaN,NaN,0.5432965823655777,1.2890986141975251,484.4027539687459,-0.10436015601939372,0.04000636930115675,0.14436652532055047,57.695075333102714,-4.029758214507121,15.56750648446426,55.14206961224076,29.290423903294993,4865036716
1397223000,15.225,15.5375,15.01,15.055,15.01,17.338749999999997,17.02,13.2775,15.95,13.2775,12.5275,6.233271,11.705003,5.292446,13.828781359999986,15.39955,15.786950000000004,16.244750000000018,15.87774705210946,16.112131825603466,16.202500000000008,17.319212207261195,15.08578779273882,13.828781359999986,15.39955,15.786950000000004,16.244750000000018,15.200833333333332,6743180,6055483.6,38.675282263716056,6.071566745784343,1.5,2.75,NaN,NaN,0.5421682550537507,1.1135658925737988,480.46339887958237,-0.16022053080836904,-0.055909138189910834,0.1043113926184582,58.34341785150294,-8.9231699939504,17.066034897399025,52.89697931082735,30.036985791773624,4858293536
1397482200,15.4125,15.515,15.044975,15.4175,15.049999999999999,17.357,17.02,13.2775,15.95,13.2775,12.5275,6.233271,11.705003,5.292446,13.853243844999986,15.4089,15.810650000000004,16.207625000000014,15.859698148105167,16.04597641364123,16.15788461538462,17.347742147505823,14.968027083263417,13.853243844999986,15.4089,15.810650000000004,16.207625000000014,15.325825000000002,6534544,6095816.4,43.176770853910185,4.33945651420133,1.5,2.75,NaN,NaN,0.5370151654070542,1.0719719183143377,483.4453264259677,-0.1646507904752642,-0.10150209547562206,0.06314869499964215,58.20659044849481,-8.515057113187948,42.00587008245544,25.392266824296865,32.6018630932477,4864828080
1397568600,15.5125,15.76,15.05,15.7275,15.09,17.375249999999998,17.02,13.2775,15.95,13.2775,12.5275,6.233271,11.705003,5.292446,13.880318844999985,15.42235,15.859650000000004,16.16837500000002,15.854513907003003,16.01564532662778,16.14307692307693,17.34908935101097,14.937064495142888,13.880318844999985,15.42235,15.859650000000004,16.16837500000002,15.5125,9842800,6259414.4,46.77488991848418,2.676949453187109,1.5,2.75,NaN,NaN,0.5493712250208359,1.5724793680380067,486.20989820887684,-0.13958856371164813,-0.111337009639918,0.02825155407173012,58.303989369417074,-7.594007050528793,47.10410386509674,21.28641672079497,31.609479414108293,4874670880
1397655000,16.0425,16.2225,15.844,16.2075,15.129999999999999,17.3935,17.02,13.2775,15.95,13.2775,12.5275,6.233271,11.705003,5.292446,13.908481344999986,15.441949999999999,15.912700000000005,16.166625000000018,15.86835649888524,16.03391720028228,16.149038461538467,17.355499494830497,14.942577428246437,13.908481344999986,15.441949999999999,15.912700000000005,16.166625000000018,16.091333333333335,6723608,6125280.8,51.8580895697174,0.895273589309867,1.5,2.75,NaN,NaN,0.5454875660907763,1.0976815952666203,490.32375400652086,-0.08618766773654749,-0.07948303059895423,0.006704637137593249,61.4851991278324,-4.380530973451326,48.89028574352923,19.940896975699822,31.168817280770956,4881394488
1397741400,16.16,16.415,16.0675,16.275,15.17,17.411749999999998,17.02,13.2775,15.95,13.2775,12.5275,6.233271,11.705003,5.292446,13.937243844999987,15.458900000000002,15.968350000000004,16.154000000000018,15.884303302850524,16.05687746692206,16.129423076923082,17.318639292377863,14.940206861468301,13.937243844999987,15.458900000000002,15.968350000000004,16.154000000000018,16.2525,5140412,6018645.8,52.54445403723414,1.9749514922129157,1.5,2.75,NaN,NaN,0.5313455970842923,0.8540811622441713,491.67055340254785,-0.04395235331479756,-0.0482358045059037,-0.004283451191106142,61.70567960339734,-0.5347593582887831,77.58496140090837,4.262228973585231,18.152809625506407,4886534900
1398087000,16.2875,16.465,16.2325,16.46,15.209999999999999,17.43,17.02,13.2775,15.95,13.2775,12.5275,6.233271,11.705003,5.292446,13.966756344999988,15.47565,16.017100000000006,16.160500000000017,15.90687964391521,16.09527008911996,16.09923076923078,17.232076716757803,14.966384821703755,13.966756344999988,15.47565,16.017100000000006,16.160500000000017,16.385833333333334,3591024,5897669.6,54.460781333641606,2.103784114147273,1.5,2.75,NaN,NaN,0.5099994830068427,0.6088886362844064,494.3289942411425,-0.0033307022675363868,-0.008446829025526625,-0.005116126757990239,58.81338336150047,4.16073406106629,100,0,0,4890125924
1398173400,16.495,16.81,16.4775,16.66,15.25,17.448249999999998,17.02,13.2775,15.95,13.2775,12.5275,6.233271,11.705003,5.292446,13.995593829999986,15.494575000000003,16.059000000000005,16.187250000000017,15.936413775526377,16.149053890156154,16.07153846153847,17.12802490701113,15.01505201606581,13.995593829999986,15.494575000000003,16.059000000000005,16.187250000000017,16.649166666666662,6153960,5922860.2,56.505618911570956,3.404956576559653,1.5,2.75,NaN,NaN,0.4985709485063538,1.0390182770142034,496.51939884769934,0.03511493806792051,0.0387775458269104,0.0036626077589898883,54.48838493409542,4.092471102780388,100,0,0,4896279884
1398259800,16.65,16.682475,16.522525,16.5675,15.29,17.466499999999996,17.02,13.2775,15.95,13.2775,12.5275,6.233271,11.705003,5.292446,14.023018829999987,15.512575000000004,16.097800000000003,16.197375000000015,15.9611622549175,16.18890590061747,16.042115384615393,17.01727778953897,15.066952979691818,14.023018829999987,15.512575000000004,16.097800000000003,16.197375000000015,16.590833333333332,3171400,5846883,55.26951406489065,2.237421082808453,1.5,2.75,NaN,NaN,0.47438373789875704,0.5424086645824793,495.7985605557522,0.05143461233721511,0.06795587318050877,0.016521260843293667,54.58472327511605,0.24202087430040325,86.03087572973033,1.7453953651920322,12.22372890507764,4893108484
1398346200,16.8075,16.8075,16.4275,16.665,15.33,17.48475,17.02,13.2775,15.95,13.2775,12.5275,6.233271,11.705003,5.292446,14.049718829999987,15.530600000000003,16.1289,16.230750000000018,15.988763735116814,16.23424819579676,16.065384615384623,17.08350665384912,15.047262576920128,14.049718829999987,15.530600000000003,16.1289,16.230750000000018,16.633333333333333,5161708,5798514.2,56.353346613463565,2.1935467837407385,1.5,2.75,NaN,NaN,0.4676420423345603,0.8901776941410267,496.3861302071452,0.06503878167493793,0.09781973793696608,0.03278095626202815,51.54056171712397,7.655038759689914,85.09730604116058,1.9739550585924373,12.928738900246987,4898270192
1398432600,16.48,16.525,16.13525,16.25,15.37,17.502999999999997,17.02,13.2775,15.95,13.2775,12.5275,6.233271,11.705003,5.292446,14.074293829999988,15.544875000000005,16.150750000000002,16.247250000000015,15.999008294523998,16.23574836762564,16.0998076923077,17.110280661417598,15.089334723197801,14.074293829999988,15.544875000000005,16.150750000000002,16.247250000000015,16.303416666666667,4327060,5706275.4,50.72000573793281,0.32438114837606674,1.5,2.75,NaN,NaN,0.47207832502494884,0.7582984866100223,493.1240289904712,0.043372982847138794,0.08699718482095165,0.04362420197381285,35.21657673104695,7.937562271670544,58.74615499880266,13.334421654350704,27.919423346846646,4893943132
1398691800,16.4425,16.61,15.905,16.4075,15.41,17.52125,17.02,13.2775,15.95,13.2775,12.5275,6.233271,11.705003,5.292446,14.097293829999987,15.561750000000004,16.171400000000002,16.261125000000014,16.015027577091683,16.252105665947006,16.130769230769236,17.152329847998853,15.109208613539618,14.097293829999987,15.561750000000004,16.171400000000002,16.261125000000014,16.3075,7545004,5872746.4,52.65439184040218,0.10092345752967305,1.5,2.75,NaN,NaN,0.48871558752316674,1.2847488187128258,494.1614249978813,0.03717316497586033,0.09009065819363826,0.05291749321777793,28.410816770374428,6.421274525701303,63.471224675346676,10.622857258671937,25.905918065981382,4901488136
1398778200,16.5625,16.7,16.44875,16.6225,15.45,17.539499999999997,17.02,13.2775,15.95,13.2775,12.5275,6.233271,11.705003,5.292446,14.121393814999987,15.582450000000003,16.1914,16.265750000000015,16.038850025048873,16.287381316809196,16.13807692307693,17.17216729601746,15.103986550136401,14.121393814999987,15.582450000000003,16.1914,16.265750000000015,16.590416666666666,3988640,5845284.6,55.237426013075435,1.822790144134747,1.5,2.75,NaN,NaN,0.4747001884143692,0.6823688276871925,496.6525858423354,0.04457691954698549,0.1086386426515098,0.0640617231045243,26.941295131376844,5.690669209982512,59.67096875646712,12.779068403216238,27.549962840316645,4905476776
1398864600,16.55,16.825,16.4775,16.7975,15.49,17.55775,17.02,13.2775,15.95,13.2775,12.5275,6.233271,11.705003,5.292446,14.14559381499999,15.605325000000002,16.213800000000003,16.263000000000012,16.06860100445872,16.335964048541655,16.239423076923085,17.25372305122547,15.2251231026207,14.14559381499999,15.605325000000002,16.213800000000003,16.263000000000012,16.7,4368148,5845374.4,57.28039580325629,1.9456243194668816,1.5,2.75,NaN,NaN,0.4656144606704857,0.7472828429946249,499.741025826933,0.05746470636193955,0.13589260605694875,0.0784278996950092,25.8803874310749,3.640289989202529,79.83690330062218,3.4958018165503506,16.667294882827473,4909844924
1398951000,16.7625,16.915,16.62415,16.785,15.53,17.575999999999997,17.02,13.2775,15.95,13.2775,12.5275,6.233271,11.705003,5.292446,14.170456314999988,15.629825000000004,16.242,16.251250000000017,16.096695082715243,16.37872937725197,16.372500000000006,17.158568601429835,15.586431398570177,14.170456314999988,15.629825000000004,16.242,16.251250000000017,16.774716666666666,4601604,5863231.8,57.080000513712235,1.861130417989925,1.5,2.75,NaN,NaN,0.45313128490830806,0.7848238236120906,501.7046118584307,0.061017393607541576,0.15469964170443617,0.0936822480968946,21.295328443722077,3.1336405529954017,52.07263246403912,17.666930626109185,30.26043690985169,4905243320
1399037400,16.78,16.99475,16.6375,16.7175,15.57,17.59425,17.02,13.2775,15.95,13.2775,12.5275,6.233271,11.705003,5.292446,14.194518814999988,15.648975000000002,16.26365,16.239625000000014,16.121040373589157,16.410993246085116,16.472500000000007,17.050344136557477,15.894655863442539,14.194518814999988,15.648975000000002,16.26365,16.239625000000014,16.78325,4552400,5928128.2,55.94185753196938,1.7016338259374504,1.5,2.75,NaN,NaN,0.4462826217005718,0.7679321105100257,503.5036014738437,0.054883741065500244,0.1622869244287699,0.10740318336326966,21.716088486594135,1.5643985419198072,50.75248478249856,18.596915000319186,30.65060021718226,4900690920
1399296600,16.4675,16.832525,16.3275,16.8075,15.61,17.612499999999997,17.02,13.2775,15.95,13.2775,12.5275,6.233271,11.705003,5.292446,14.217993814999986,15.667850000000001,16.288,16.261875000000014,16.1479603589386,16.44875579407701,16.55557692307693,16.967948832542135,16.143205013611727,14.217993814999986,15.667850000000001,16.288,16.261875000000014,16.65584166666667,3805772,5733404.2,57.168174838663234,1.3821064649751995,1.5,2.75,NaN,NaN,0.4504785058648167,0.6637892371167552,502.87969303106826,0.05292660550533798,0.17356144024494213,0.12063483473960415,21.11430737765954,0.8853541416566678,43.5185454598526,24.10182414142675,32.37963039872065,4904496692
1399383000,16.6775,16.7225,16.3575,16.3825,15.65,17.630749999999995,17.02,13.2775,15.95,13.2775,12.5275,6.233271,11.705003,5.292446,14.239018799999988,15.683924999999999,16.299500000000002,16.290875000000014,16.1571579919214,16.442445718450628,16.56903846153847,16.944888976327867,16.19318794674907,14.239018799999988,15.683924999999999,16.299500000000002,16.290875000000014,16.4875,5472236,5596670.8,50.079461292595205,0.4660959288826603,1.5,2.75,NaN,NaN,0.45044432687447256,0.9777662820546815,499.4619670233506,0.020703098850921975,0.1465137083032566,0.12581060945233463,25.25130841940864,-1.1166440319903348,17.22433242861715,52.663835111448215,30.111832459934625,4899024456
1399469400,16.5425,16.67,16.1625,16.66,15.69,17.648999999999997,17.02,13.2775,15.95,13.2775,12.5275,6.233271,11.705003,5.292446,14.261131299999986,15.70795,16.3165,16.323625000000014,16.176877286355857,16.463165173836284,16.59865384615385,16.935845958621,16.2614617336867,14.261131299999986,15.70795,16.3165,16.323625000000014,16.497500000000002,4638820,5491467,54.083011145456496,0.3605723153597444,1.5,2.75,NaN,NaN,0.45451973209772456,0.8447323820756821,502.3338338461018,0.01598314889913771,0.14578954557625678,0.12980639667711907,27.174630622557828,-0.030003000300024035,17.887548926108785,51.70654649978279,30.405904574108437,4903663276
1399555800,16.585,16.9525,16.4425,16.6025,15.73,17.667249999999996,17.02,13.2775,17.02,13.2775,15.95,6.233271,12.5275,5.292446,14.283293809999986,15.732750000000001,16.3321,16.327375000000018,16.19356837316543,16.47643515728045,16.609615384615388,16.937193009907038,16.28203775932374,14.283293809999986,15.732750000000001,16.3321,16.327375000000018,16.66583333333333,3797008,5406747.2,53.132159019459486,0.7042698130418055,1.5,2.75,NaN,NaN,0.4584826083764586,0.7022721535787728,500.2362161497615,0.007333976823627297,0.1389738677066532,0.1316398908830259,27.034652711576413,2.169230769230764,19.367741574175803,49.63391410154651,30.998344324277678,4899866268
1399642200,16.5875,16.6875,16.375,16.67,15.77,17.685499999999998,17.02,13.2775,17.02,13.2775,15.95,6.233271,12.5275,5.292446,14.306518794999986,15.758425000000003,16.34395,16.386875000000018,16.21225196637463,16.49486990420612,16.61038461538462,16.938478446674054,16.28229078409519,14.306518794999986,15.758425000000003,16.34395,16.386875000000018,16.5775,6406516,5328292.2,54.151220782332906,0.23562327109578673,1.5,2.75,NaN,NaN,0.44805527920671157,1.2023582340322851,502.00276353241856,0.0046359406954450955,0.13743481675233227,0.13279887605688717,21.94338479132233,1.599878104525387,50.547124249568796,18.70804237929429,30.74483337113691,4906272784
1399901400,16.8975,17.1775,16.8775,17.1425,15.809999999999999,17.703749999999996,17.02,13.2775,17.02,13.2775,15.95,6.233271,12.5275,5.292446,14.331613794999985,15.786100000000001,16.36285,16.491250000000015,16.24873228141876,16.556548960948394,16.654615384615393,17.086328635930368,16.22290213330042,14.331613794999985,15.786100000000001,16.36285,16.491250000000015,17.065833333333334,6419744,5312120.4,60.6080048132604,2.793364359631581,1.5,2.75,NaN,NaN,0.4523013306919462,1.208508752926609,506.51033292380697,0.03164498439807173,0.17235510655447683,0.1407101221564051,26.198597187805877,3.128289968416301,56.42525359743831,14.742900362262011,28.83184604029969,4912692528
1399987800,17.205,17.327475,17.150025,17.1925,15.85,17.721999999999998,17.02,13.2775,17.02,13.2775,15.95,6.233271,12.5275,5.292446,14.356888794999985,15.815850000000003,16.3899,16.580000000000016,16.285742780186652,16.617115726572358,16.695192307692317,17.213631019812517,16.176753595572116,14.356888794999985,15.815850000000003,16.3899,16.580000000000016,17.223333333333333,3362740,5153530.2,61.230211663959516,2.89131998802365,1.5,2.75,NaN,NaN,0.43320659278537876,0.6525119422022597,504.64391483465425,0.04882290323212518,0.2017387511965616,0.1529158479644364,25.616448462564676,2.351540407798777,82.82154915195713,2.5763238003100506,14.602127047732827,4916055268
1400074200,17.16,17.1775,16.88,16.96,15.89,17.740249999999996,17.02,13.2775,17.02,13.2775,15.95,6.233271,12.5275,5.292446,14.381538794999985,15.835850000000002,16.39815,16.641625000000012,16.312184239787175,16.649771371660705,16.7498076923077,17.216112567562497,16.283502817052906,14.381538794999985,15.835850000000002,16.39815,16.641625000000012,17.00583333333333,2702004,4796490.4,56.74204064476578,1.4516294364716307,1.5,2.75,NaN,NaN,0.4245846933007088,0.5633293876706185,501.79396356801436,0.04079860126783513,0.20391409954923034,0.1631154982813952,26.869003540298447,1.0425975573428699,64.8312274743111,9.875222398778453,25.293550126910457,4913353264
1400160600,16.8275,16.8625,16.2625,16.49,15.93,17.758499999999998,17.02,13.2775,17.02,13.2775,15.95,6.233271,12.5275,5.292446,14.403838794999983,15.851400000000003,16.3973,16.655750000000015,16.319157406854345,16.634555050550162,16.756153846153858,17.205592022721238,16.306715669586477,14.403838794999983,15.851400000000003,16.3973,16.655750000000015,16.53833333333333,8350128,4877816.4,48.93350580987423,1.6048916619372713,1.5,2.75,NaN,NaN,0.44407864377922973,1.7118577894813751,498.5114683624162,0.002148999302099913,0.1658017474090201,0.16365274810692018,31.653242602330558,-1.360849409301646,47.834534419012535,20.705515690333513,31.45994989065394,4905003136
1400247000,16.535,16.6925,16.3275,16.69,15.969999999999999,17.776749999999996,17.02,13.2775,17.02,13.2775,15.95,6.233271,12.5275,5.292446,14.426988779999983,15.866500000000004,16.397550000000003,16.676500000000015,16.33370025364437,16.639835521926337,16.761346153846162,17.206022420638668,16.316669887053656,14.426988779999983,15.866500000000004,16.397550000000003,16.676500000000015,16.569999999999997,3574108,4799501.2,51.96291585072587,0.878802082718348,1.5,2.75,NaN,NaN,0.4384301692235703,0.7446832183311048,501.92608026834125,-0.010916934639673193,0.15000657980732868,0.16092351444700187,32.564186221804626,-0.6990926669641512,41.240575147307204,26.0158731795279,32.7435516731649,4908577244
1400506200,16.5875,16.8975,16.5325,16.855,16.009999999999998,17.794999999999995,17.02,13.2775,17.02,13.2775,15.95,6.233271,12.5275,5.292446,14.448938779999983,15.880875000000003,16.401,16.696250000000017,16.354143380952433,16.66032737698097,16.765769230769237,17.21293287580737,16.318605585731106,14.448938779999983,15.880875000000003,16.401,16.696250000000017,16.761666666666667,3620228,4800961.4,54.367999349940284,0.6642484517500804,1.5,2.75,NaN,NaN,0.43318515713617256,0.7540631341047649,505.0165527901675,-0.009471319585684812,0.14908436496489585,0.15855568455058067,32.939892824899864,2.8841751869372816,33.49491272530842,33.206503594449174,33.29858368024239,4912197472
1400592600,16.825,16.8305,16.4075,16.5325,16.05,17.813249999999996,17.1925,13.2775,17.02,13.2775,15.95,6.233271,12.5275,5.292446,14.468963779999982,15.890900000000004,16.398350000000004,16.689875000000015,16.361137758169985,16.64815334107802,16.74634615384616,17.210108424613182,16.28258388307914,14.468963779999982,15.890900000000004,16.398350000000004,16.689875000000015,16.590166666666665,5098912,4748209,49.1846167050152,1.0876095516756799,1.5,2.75,NaN,NaN,0.4342076459121604,1.0738600596561778,500.95053907493394,-0.030095452344397172,0.12093636912008421,0.15103182146448138,31.290619679730955,-0.7653061224489872,12.878412265043753,59.48627877730513,27.635308957651105,4907098560
1400679000,16.6725,16.975,16.6675,16.945,16.09,17.831499999999995,17.1925,13.2775,17.02,13.2775,15.95,6.233271,12.5275,5.292446,14.49125127999998,15.902750000000003,16.408850000000005,16.708750000000016,16.384034316673123,16.676424451451542,16.76384615384616,17.238964015274796,16.288728292417524,14.49125127999998,15.902750000000003,16.408850000000005,16.708750000000016,16.8625,4453756,4812326.8,55.08331918288475,0.959960636665964,1.5,2.75,NaN,NaN,0.4347999569184348,0.9254891001999282,503.8439248798223,-0.016496747821508534,0.1304108866875957,0.14690763450910424,33.020289614718195,2.0629423279626633,30.34423056416752,36.45010272519318,33.2056667106393,4911552316
1400765400,16.965,17.1775,16.885,17.0775,16.13,17.849749999999997,17.1925,13.2775,17.02,13.2775,15.95,6.233271,12.5275,5.292446,14.51523877999998,15.916000000000004,16.421800000000005,16.72937500000001,16.41122904935261,16.714622122741872,16.784615384615392,17.288297389584972,16.280933379645813,14.51523877999998,15.916000000000004,16.421800000000005,16.72937500000001,17.046666666666667,2361676,4672325.2,56.8173130473018,1.9504456822402052,1.5,2.75,NaN,NaN,0.42463567428140353,0.5054605360089234,506.6640793131889,0.000007955097357570384,0.14691757838080122,0.14690962328344365,33.008762560483575,2.444511097780437,68.3136139630444,8.1407461331751,23.545639903780497,4913913992
1400851800,17.1225,17.3175,17.0975,17.295,16.169999999999998,17.867999999999995,17.1925,13.2775,17.02,13.2775,15.95,6.233271,12.5275,5.292446,14.540951279999978,15.931600000000005,16.449700000000004,16.781625000000012,16.445886733691722,16.769896206290266,16.854807692307702,17.368992863751362,16.34062252086404,14.540951279999978,15.931600000000005,16.449700000000004,16.781625000000012,17.236666666666668,5002120,4706078.2,59.57602872806666,2.400804144952635,1.5,2.75,NaN,NaN,0.41144741183273176,1.0629062644985372,509.8119501664945,0.02289336100576933,0.1755263245406553,0.15263296353488598,33.49068145293591,0.8896018667055764,71.1434712454855,6.836668698459657,22.019860056054846,4918916112
1401197400,17.475,17.61245,17.455,17.5975,16.21,17.886249999999997,17.1925,13.2775,17.02,13.2775,15.95,6.233271,12.5275,5.292446,14.567613779999979,15.948075000000006,16.487100000000005,16.841125000000016,16.49104803825283,16.848715615215003,16.926923076923085,17.560663966240558,16.293182187605613,14.567613779999979,15.948075000000006,16.487100000000005,16.841125000000016,17.55498333333333,2929904,4475323.2,63.10624225220066,3.3913330287643304,1.5,2.75,NaN,NaN,0.40473331098753645,0.6546798675903451,513.17600005958,0.053950699963128734,0.2200713384887969,0.16612063852566816,31.15485350498453,2.355678348116918,71.21000082208027,6.853409041497425,21.936590136422303,4921846016
1401283800,17.59,17.6813,17.475,17.55,16.25,17.904499999999995,17.1925,13.2775,17.02,13.2775,15.95,6.233271,12.5275,5.292446,14.59448877999998,15.968475000000005,16.514900000000004,16.887500000000017,16.532575566164486,16.915504604242145,16.999807692307705,17.683509329715488,16.316106054899922,14.59448877999998,15.968475000000005,16.514900000000004,16.887500000000017,17.568766666666665,3291000,4440441.2,62.18786616487769,3.260176946402068,1.5,2.75,NaN,NaN,0.3905595030598552,0.7411425693464875,514.2801049545278,0.06604282431644676,0.24867416892122662,0.18263134460477987,31.301481774127016,3.4787735849056594,79.6022977923928,3.5964098347676083,16.801292372839598,4918555016
1401370200,17.69,17.835,17.5475,17.835,16.29,17.922749999999997,17.1925,13.2775,17.02,13.2775,15.95,6.233271,12.5275,5.292446,14.62307627999998,15.992150000000006,16.541350000000005,16.939375000000016,16.583651034158034,17.00307559431432,17.089423076923087,17.874588796437504,16.30425735740867,14.62307627999998,15.992150000000006,16.541350000000005,16.939375000000016,17.739166666666666,3443336,4394200.6,65.43787551625364,3.4094797268143844,1.5,2.75,NaN,NaN,0.3831981099841513,0.7836091961755228,517.5212390916856,0.08668287869699554,0.2909849429760243,0.20430206427902875,30.49468801495149,8.156458459672544,78.48869912743167,3.9739994576532687,17.537301414915056,4921998352
1401456600,17.7825,17.945,17.732525,17.88,16.33,17.940999999999995,17.1925,13.2775,17.02,13.2775,15.95,6.233271,12.5275,5.292446,14.65127626499998,16.017450000000007,16.574100000000005,16.994125000000015,16.634488248504777,17.086592204379624,17.146153846153858,18.037813093298052,16.254494599009664,14.65127626499998,16.017450000000007,16.574100000000005,16.994125000000015,17.852508333333333,4066148,4367427.8,65.9357327398049,3.3398952783351414,1.5,2.75,NaN,NaN,0.3710036021281406,0.9310166501206958,518.2635465806437,0.09608481713005243,0.3244080856915943,0.22832326856154186,22.29971129488417,7.130017974835217,80.89514863287923,3.179532133048898,15.925319234071878,4926064500
1401715800,17.9875,18,17.715,17.97,16.37,17.959249999999997,17.1925,13.2775,17.02,13.2775,15.95,6.233271,12.5275,5.292446,14.68088876499998,16.04082500000001,16.602950000000007,17.056750000000015,16.686861258367333,17.170726280152994,17.20596153846155,18.200408695392976,16.211514381530126,14.68088876499998,16.04082500000001,16.602950000000007,17.056750000000015,17.895,2597344,4269675,66.96079135103165,3.288335364100628,1.5,2.75,NaN,NaN,0.3648604876904163,0.6083235843477548,517.2075900248198,0.10060285519467455,0.35407683755488506,0.2534739823602105,22.20773700104979,6.615247700978928,76.96774481471337,4.482453943449138,18.549801241837496,4928661844
1401802200,17.8375,17.9725,17.795,17.945,16.41,17.977499999999996,17.1925,13.2775,17.02,13.2775,15.95,6.233271,12.5275,5.292446,14.71300126499998,16.063875000000007,16.635250000000006,17.113625000000017,16.736200032549007,17.24446663442414,17.28173076923078,18.3378564621717,16.22560507628986,14.71300126499998,16.063875000000007,16.635250000000006,17.113625000000017,17.904166666666665,2091104,4183941.6,66.36339791826668,2.75095336330595,1.5,2.75,NaN,NaN,0.3514775957125293,0.4997928269362077,514.5413021729382,0.09425459050829804,0.3712922204955831,0.27703762998728504,22.683479922226013,8.5437774081355,56.4089553182114,14.767261816649164,28.823782865139453,4926570740
1401888600,17.835,18.084975,17.7975,18.03,16.45,17.995749999999994,17.1925,13.2775,17.02,13.2775,15.95,6.233271,12.5275,5.292446,14.745963764999981,16.087500000000006,16.673350000000006,17.19600000000002,16.786937286174535,17.319279335907556,17.40019230769232,18.419346296092012,16.381038319292625,14.745963764999981,16.087500000000006,16.673350000000006,17.19600000000002,17.970825,4719296,4146294.6,67.42743182766293,2.8464131793132093,1.5,2.75,NaN,NaN,0.3469059817330629,1.1381960172342795,515.7407918603487,0.08823344204016509,0.3873294325374914,0.2990959904973263,15.98019526260736,6.403068751844207,86.53439103650041,1.6245656734175749,11.841043290082013,4931290036
1401975000,18.1075,18.4625,17.92,18.4125,16.49,18.013999999999996,17.1925,13.2775,17.02,13.2775,15.95,6.233271,12.5275,5.292446,14.78201376499998,16.113800000000005,16.714300000000005,17.28362500000002,16.850684843579455,17.423395589630648,17.53269230769232,18.595034534056854,16.470350081327783,14.78201376499998,16.113800000000005,16.714300000000005,17.28362500000002,18.265,4975596,4163133.4,71.75705870974949,4.012849636285355,1.5,2.75,NaN,NaN,0.3608769830378439,1.1951565136010296,520.3789488219014,0.10151761535606307,0.42599300969240517,0.3244753943363421,14.736457383962872,7.8173034694773875,87.87211713321928,1.330296281276622,10.797586585504103,4936265632
1402061400,18.535,18.683125,18.5025,18.665,16.53,18.032249999999994,17.1925,13.2775,17.02,13.2775,15.95,6.233271,12.5275,5.292446,14.818501264999982,16.148650000000004,16.767650000000007,17.386750000000017,16.92183445755673,17.541643628713445,17.671923076923086,18.81394583340886,16.529900320437314,14.818501264999982,16.148650000000004,16.767650000000007,17.386750000000017,18.616875,2651428,4105854.4,74.19548071542684,4.520188363256581,1.5,2.75,NaN,NaN,0.35443041282085497,0.6457676628766963,524.1589569619008,0.11767793656708869,0.471572815045203,0.3538948784781143,15.037756266794888,7.921364556230109,86.86914893962857,1.5483952031007369,11.582455857270686,4938917060
1402320600,18.665,18.8675,18.615,18.7325,16.57,18.050499999999996,17.1925,13.2775,17.02,13.2775,15.95,6.233271,12.5275,5.292446,14.856338764999983,16.179400000000005,16.823900000000005,17.48987500000002,16.99284094941725,17.655058521216926,17.84115384615386,18.907121473358607,16.77518621894911,14.856338764999983,16.179400000000005,16.823900000000005,17.48987500000002,18.738333333333333,6103244,4090690.8,74.82131459648267,4.292490274162908,1.5,2.75,NaN,NaN,0.34714966904793687,1.4919837011391817,526.4468326141161,0.12271934118948408,0.5072940549649694,0.3845747137754853,15.104309290097165,6.449779798266808,89.33103460127857,1.0394464689091027,9.629518929812312,4945020304
1402407000,18.6525,18.73,18.54,18.73,16.61,18.068749999999994,17.1925,13.2775,17.02,13.2775,15.95,6.233271,12.5275,5.292446,14.892726264999983,16.207550000000005,16.875900000000005,17.569250000000018,17.06096483375383,17.757433900148648,17.97846153846155,19.006498387661814,16.950424689261283,14.892726264999983,16.207550000000005,16.875900000000005,17.569250000000018,18.666666666666668,3627172,3951062.2,74.74900604869582,3.3899368560501832,1.5,2.75,NaN,NaN,0.33610326411594155,0.9180245251517427,524.42677193154,0.11578040687313113,0.5293002223668992,0.4135198154937681,14.460457780876181,6.723646723646722,81.08336613611185,3.092467888254634,15.824165975633509,4941393132
1402493400,18.545,18.595,18.4125,18.5525,16.65,18.086999999999996,17.1925,13.2775,17.02,13.2775,15.95,6.233271,12.5275,5.292446,14.927638764999982,16.234600000000004,16.91635000000001,17.63725000000002,17.11945640890074,17.833154481086872,18.091923076923088,19.01766218672038,17.166183967125797,14.927638764999982,16.234600000000004,16.91635000000001,17.63725000000002,18.52,5716504,4068750.4,69.60559219968158,2.190728997651314,1.5,2.75,NaN,NaN,0.33477445953623136,1.4049778035044864,521.5122817748294,0.09026420047528305,0.5263500660878719,0.4360858656125889,16.397619353086707,4.022988505747112,47.37295522286192,21.061543865173235,31.565500911964836,4935676628
1402579800,18.465,18.5075,18.02025,18.1375,16.689999999999998,18.105249999999995,17.1925,13.2775,17.02,13.2775,15.95,6.233271,12.5275,5.292446,14.96112627499998,16.259600000000006,16.94205000000001,17.69612500000002,17.159379686983062,17.862139768602407,18.15673076923078,18.960111569386704,17.353349969074856,14.96112627499998,16.259600000000006,16.94205000000001,17.69612500000002,18.22175,7816004,4324450.4,59.32701568598972,0.5471863172073486,1.5,2.75,NaN,NaN,0.34887985528364324,1.8073982303045952,519.1325667754521,0.03907929601308602,0.48493498562894644,0.4458556896158604,21.523971291064488,1.4401565995525745,15.515319512709933,55.231338352103016,29.25334213518705,4927860624
1402666200,18.245,18.35975,18.075,18.31,16.73,18.123499999999996,17.1925,13.2775,17.02,13.2775,15.95,6.233271,12.5275,5.292446,14.998213759999981,16.284825000000005,16.96785000000001,17.78712500000002,17.204502052199413,17.904793123973608,18.211538461538474,18.949377141169574,17.473699781907374,14.998213759999981,16.284825000000005,16.96785000000001,17.78712500000002,18.24825,3983328,4106110.4,61.84888055717762,0.6687238630676196,1.5,2.75,NaN,NaN,0.34429915133481154,0.9700976379008222,521.2017582595971,0.01189275403275819,0.46072163215680817,0.44882887812405,21.985878851992407,1.8920422927100717,18.609518090812017,50.69619268724657,30.69428922194141,4931843952
1402925400,18.2225,18.4625,18.17,18.345,16.77,18.141749999999995,18.7325,13.2775,17.02,13.2775,15.95,6.233271,12.5275,5.292446,15.034951244999979,16.310125000000006,16.995750000000008,17.86987500000002,17.249227461917084,17.946717588357075,18.272692307692317,18.90536205243847,17.640022562946164,15.034951244999979,16.310125000000006,16.995750000000008,17.86987500000002,18.325833333333332,5461624,4200486.2,62.35884783404447,0.8472757988244851,1.5,2.75,NaN,NaN,0.34059921195375337,1.300236148853435,521.4160439738828,-0.007628950582260985,0.4392926898962237,0.4469216404784847,21.92150880015935,2.2290331568682005,17.824031487751306,51.94834973219197,30.227618780056712,4937305576
1403011800,18.2725,18.54,18.2125,18.49,16.81,18.159999999999997,18.7325,13.2775,17.02,13.2775,15.95,6.233271,12.5275,5.292446,15.072101229999978,16.340750000000003,17.038300000000007,17.95162500000002,17.29788520850857,17.998458770418306,18.323076923076933,18.911040010112146,17.73511383604172,15.072101229999978,16.340750000000003,17.038300000000007,17.95162500000002,18.414166666666663,5789696,4308959.6,64.47733209056544,1.4506072279343074,1.5,2.75,NaN,NaN,0.3396635539570568,1.3436412817609151,524.2369386561619,-0.01428579267377661,0.42906439963626397,0.4433501923100406,22.031044840222577,2.5513033832501235,39.873471188053045,27.33240489127459,32.79412392067238,4943095272
1403098200,18.51,18.9375,18.375,18.8975,16.849999999999998,18.178249999999995,18.7325,13.2775,17.02,13.2775,15.95,6.233271,12.5275,5.292446,15.111901229999978,16.385450000000006,17.100200000000008,18.069875000000017,17.360615200331765,18.084081744664182,18.401346153846166,19.00327451459958,17.799417793092754,15.111901229999978,16.385450000000006,17.100200000000008,18.069875000000017,18.736666666666668,5676220,4337825,69.64746385666498,2.2815383136681606,1.5,2.75,NaN,NaN,0.3555804429601242,1.308540570447171,527.7325499397022,0.004254471456341835,0.4486682816304679,0.44441381017412607,24.550786585799855,2.634080108621857,68.60939403450881,8.047966549877287,23.34263941561389,4948771492
1403184600,18.9625,19.0075,18.775,18.965,16.89,18.196499999999993,18.7325,13.2775,17.02,13.2775,15.95,6.233271,12.5275,5.292446,15.151301229999978,16.432900000000004,17.15940000000001,18.170875000000017,17.423532251299147,18.167978721362832,18.477884615384625,19.09383243458389,17.861936796185358,15.151301229999978,16.432900000000004,17.15940000000001,18.170875000000017,18.915833333333335,8091400,4519707.2,70.41556801168409,2.6693413610060994,1.5,2.75,NaN,NaN,0.3467889827486869,1.7902487134564822,529.5795178123466,0.015908179836034653,0.46429903496916936,0.4483908551331347,22.25366494182092,1.6072863648540088,100,0,0,4956862892
1403271000,19.0825,19.1175,19.0175,19.0825,16.93,18.214749999999995,18.7325,13.2775,17.02,13.2775,15.95,6.233271,12.5275,5.292446,15.189838729999979,16.478925000000004,17.21050000000001,18.27112500000002,17.48858981007173,18.255075985994942,18.565384615384627,19.176835746062377,17.953933484706877,15.189838729999979,16.478925000000004,17.21050000000001,18.27112500000002,19.0725,4069192,4605083,71.75548539725978,2.9647058513260167,1.5,2.75,NaN,NaN,0.33291119826663784,0.8836305447697685,531.956354081287,0.025789247067154353,0.48062741396707764,0.4548381668999233,21.342001199079906,1.8684105164820384,100,0,0,4960932084
1403530200,19.1,19.113575,18.9625,19.07,16.97,18.232999999999993,18.7325,13.2775,17.02,13.2775,15.95,6.233271,12.5275,5.292446,15.228213729999979,16.529150000000005,17.28230000000001,18.359875000000017,17.55060589595127,18.332687796852568,18.645384615384625,19.227128830105276,18.063640400663974,15.228213729999979,16.529150000000005,17.28230000000001,18.359875000000017,19.048691666666667,5688252,4639389.6,71.38507850591928,2.4198678785994376,1.5,2.75,NaN,NaN,0.3199228983904496,1.226077671942016,531.5191167651894,0.02568620008918182,0.48694591701140055,0.46125971692221873,21.380014845122457,1.81526962092899,77.54919418984565,4.276389113793547,18.174416696360808,4955243832
1403616600,18.9625,19.245,18.6565,18.7225,17.009999999999998,18.251249999999995,18.7325,13.2775,17.02,13.2775,15.95,6.233271,12.5275,5.292446,15.26472623999998,16.571300000000004,17.35565000000001,18.416125000000015,17.596562527482593,18.369812768580896,18.66923076923078,19.2360585975722,18.10240294088936,15.26472623999998,16.571300000000004,17.35565000000001,18.416125000000015,18.874666666666666,6803172,4833053,61.82964902102141,1.4320656912882908,1.5,2.75,NaN,NaN,0.33910697707684606,1.4076344703854893,528.8485221737739,-0.0021067557824616667,0.45862627219414165,0.4607330279766033,24.33467515162296,0.9163185554507571,47.1149883324547,21.28239586999742,31.60261579754788,4948440660
1403703000,18.6075,19.0275,18.5975,18.9625,17.05,18.269499999999994,18.7325,13.2775,17.02,13.2775,15.95,6.233271,12.5275,5.292446,15.30073874999998,16.618600000000004,17.42655000000001,18.486750000000015,17.65012870287543,18.426259171573193,18.692115384615395,19.28004148591701,18.10418928331378,15.30073874999998,16.618600000000004,17.42655000000001,18.486750000000015,18.8625,8431096,5090057.8,65.28578799922678,1.499174333416773,1.5,2.75,NaN,NaN,0.34559933585707137,1.6563851200275173,532.1794737037782,-0.008300578218041976,0.4503573052040508,0.4586578834220928,24.512569386568693,4.5485871812543035,52.11506964129474,17.632066328254744,30.252864030450525,4956871756
1403789400,18.9675,18.9675,18.5515,18.9275,17.09,18.287749999999996,18.7325,13.2775,17.02,13.2775,15.95,6.233271,12.5275,5.292446,15.33532625999998,16.675100000000008,17.49055000000001,18.541375000000016,17.70022169491953,18.473996393328125,18.707115384615392,19.3082004488433,18.106030320387482,15.33532625999998,16.675100000000008,17.49055000000001,18.541375000000016,18.8155,4294620,5132622,64.37042592727735,1.0444183539846748,1.5,2.75,NaN,NaN,0.35062795472442343,0.8367302326179484,533.3665250544328,-0.01816273070683494,0.43595447003854915,0.4541172007453841,19.14159046182983,3.372474057891861,25.365567344135858,42.04305860855906,32.5913740473051,4952577136
1403875800,18.785,19.050025,18.7675,19.0225,17.13,18.305999999999994,19.0825,13.2775,17.02,13.2775,15.95,6.233271,12.5275,5.292446,15.36976376999998,16.729775000000007,17.54685000000001,18.598500000000016,17.752075746099155,18.52623483205878,18.729615384615393,19.353892955257734,18.10533781397305,15.36976376999998,16.729775000000007,17.54685000000001,18.598500000000016,18.946675000000003,4108156,5134722.4,65.77317851049754,1.0726536558113822,1.5,2.75,NaN,NaN,0.3457634579583934,0.8000736320234176,536.9506782105011,-0.02146943824220182,0.4272804029426318,0.44874984118483363,18.867907379458458,3.693104388116664,25.42747417251339,41.96983364412962,32.602692183356986,4956685292
1404135000,19.0125,19.135,18.9575,19.01,17.169999999999998,18.324249999999996,19.0825,13.2775,17.02,13.2775,15.95,6.233271,12.5275,5.292446,15.40461376999998,16.784950000000006,17.60155000000001,18.650500000000015,17.801406108997227,18.57230770519604,18.764807692307702,19.396714031334124,18.13290135328128,15.40461376999998,16.784950000000006,17.60155000000001,18.650500000000015,19.034166666666668,4183076,5214009,65.40827818195012,1.3691596224574707,1.5,2.75,NaN,NaN,0.33374463953279404,0.8022763290205291,539.2725964579479,-0.027305442475581643,0.4146180380903566,0.4419234805659382,19.019404437893787,2.8123309897241926,28.5600252779081,38.41112781142802,33.02884691066388,4952502216
1404221400,19.15,19.5625,19.1375,19.3925,17.21,18.342499999999994,19.0825,13.2775,17.02,13.2775,15.95,6.233271,12.5275,5.292446,15.441037519999979,16.838650000000005,17.66020000000001,18.722875000000016,17.863801947860082,18.65042125708213,18.861346153846164,19.46315629316502,18.259536014527306,15.441037519999979,16.838650000000005,17.66020000000001,18.722875000000016,19.364166666666666,6636888,5441298.2,70.75495390316028,3.064510283252268,1.5,2.75,NaN,NaN,0.3493700224233086,1.2197251016310777,542.4621225862429,-0.009150616058498429,0.4304852104928152,0.4396358265513136,21.15063752284428,2.6193940997486305,62.68595781184861,11.05855965269997,26.255482535451428,4959139104
1404307800,19.39,19.5125,19.3675,19.44,17.25,18.360749999999992,19.0825,13.2775,17.02,13.2775,15.95,6.233271,12.5275,5.292446,15.47663751999998,16.887400000000003,17.715800000000012,18.793375000000015,17.925613636179296,18.725619232598117,18.948269230769238,19.532604436910454,18.363934024628023,15.47663751999998,16.887400000000003,17.715800000000012,18.793375000000015,19.439999999999998,3718340,5391250.4,71.34723123785358,2.5211315822950846,1.5,2.75,NaN,NaN,0.33477216367878654,0.6896989982138466,539.741468109042,0.0017314309565193975,0.44180011524696283,0.44006868429044343,18.158606091966742,2.504613762193522,53.915237964926284,16.416875680084217,29.66788635498951,4962857444
1404394200,19.5975,19.75,19.565,19.725,17.29,18.378999999999994,19.0825,13.2775,17.02,13.2775,15.95,6.233271,12.5275,5.292446,15.512887529999977,16.938375000000004,17.778950000000012,18.859000000000016,17.996177807309518,18.820798353303058,19.054423076923086,19.662721946552892,18.44612420729328,15.512887529999977,16.938375000000004,17.778950000000012,18.859000000000016,19.68,2851672,5285054.2,74.66286290035832,3.2888460858895816,1.5,2.75,NaN,NaN,0.333002723416016,0.5395728959600831,541.7754924210798,0.02263733472852436,0.4683653527010989,0.44572801797257455,19.372617221655027,3.366959255862711,78.24393746339236,4.035728447714881,17.720334088892773,4965709116
1404739800,19.6175,19.6575,19.4375,19.535,17.33,18.397249999999993,19.0825,13.2775,17.02,13.2775,15.95,6.233271,12.5275,5.292446,15.545900029999977,16.982625000000006,17.836350000000014,18.902500000000014,18.056523775650323,18.888817557750386,19.1348076923077,19.698031454161868,18.57158393045353,15.545900029999977,16.982625000000006,17.836350000000014,18.902500000000014,19.543333333333333,3354496,5320207.6,68.93572725526015,2.1241017534062134,1.5,2.75,NaN,NaN,0.32975252888630063,0.6305197564095055,537.9635553547668,0.018365090322040256,0.4686843808751249,0.4503192905530846,20.781520518715805,2.4383848977451485,52.95618567959972,17.02172717439081,30.022087146009472,4962354620
1404826200,19.4075,19.4375,19,19.1575,17.369999999999997,18.415499999999994,19.0825,13.2775,17.02,13.2775,15.95,6.233271,12.5275,5.292446,15.577337529999976,17.022625000000005,17.894500000000015,18.923750000000016,18.099699313860114,18.91440636177416,19.1548076923077,19.701115092173314,18.608500292442084,15.577337529999976,17.022625000000005,17.894500000000015,18.923750000000016,19.198333333333334,6607124,5345401.6,59.21665635024659,0.34338882459369363,1.5,2.75,NaN,NaN,0.34441306253727916,1.2360388413098842,535.4751205671326,-0.013472041191126383,0.4334792390641766,0.446951280255303,24.289508175994385,2.323407664574703,43.203138571561574,24.358287851432365,32.43857357700607,4955747496
1404912600,19.295,19.446375,19.1675,19.3925,17.41,18.433749999999993,19.0825,13.2775,17.02,13.2775,15.95,6.233271,12.5275,5.292446,15.611375029999977,17.062800000000003,17.954200000000014,18.956875000000014,18.150397379983247,18.95993908922424,19.187692307692313,19.735802563088985,18.63958205229564,15.611375029999977,17.062800000000003,17.954200000000014,18.956875000000014,19.33545833333333,4165928,5372339.4,62.73854623740824,1.0689439811146546,1.5,2.75,NaN,NaN,0.34044605807033074,0.7754402113909631,537.5751816163063,-0.021798330284566125,0.41970336739959535,0.4415016976841615,21.82733686468628,2.267633487145681,36.04628858211462,30.693043033854423,33.260668384030964,4959913424
1404999000,18.8425,19.3175,18.7825,19.16,17.45,18.451999999999995,19.0825,13.2775,17.02,13.2775,15.95,6.233271,12.5275,5.292446,15.645062529999976,17.098175000000005,18.004950000000015,18.987250000000014,18.189989639591747,18.97899250929812,19.19365384615385,19.73873540457006,18.64857228773764,15.645062529999976,17.098175000000005,18.004950000000015,18.987250000000014,19.086666666666662,4504052,5311716.8,57.452380771574866,0.4517172078106632,1.5,2.75,NaN,NaN,0.3596999110653071,0.8479465622112986,533.87428588507,-0.04473707602789839,0.38558035264928847,0.43031742867718686,22.616828532892775,1.2283714172500422,13.85979166764011,57.83038739660693,28.309820935752967,4955409372
1405085400,19.1375,19.2825,19.0025,19.255,17.49,18.470249999999993,19.725,13.2775,17.02,13.2775,15.95,6.233271,12.5275,5.292446,15.679675029999975,17.133950000000006,18.054100000000016,19.043125000000014,18.23175475176462,19.005278936984013,19.20788461538462,19.748954944077404,18.66681428669184,15.679675029999975,17.133950000000006,18.054100000000016,19.043125000000014,19.179999999999996,4317448,5136789,58.973475838314535,0.21301838648505414,1.5,2.75,NaN,NaN,0.35400706027492784,0.8404954924175394,534.9700581451123,-0.05462988980677763,0.3620300664187148,0.41665995622549246,22.635837415332073,1.222236824812712,17.781732735208635,51.85421168020177,30.364055584589583,4959726820
1405344600,19.535,19.6125,19.375,19.535,17.53,18.488499999999995,19.725,13.2775,17.02,13.2775,15.95,6.233271,12.5275,5.292446,15.716237529999976,17.17555000000001,18.109100000000016,19.104375000000015,18.282862408558163,19.055728562033153,19.270384615384625,19.75779080420398,18.78297842656527,15.716237529999976,17.17555000000001,18.109100000000016,19.104375000000015,19.507499999999997,3899096,5132577.4,63.154517122213825,1.5659927015099402,1.5,2.75,NaN,NaN,0.354256555969576,0.7596760255383581,537.9959877543398,-0.043896388151024535,0.3617894710367118,0.4056858591877363,23.753984147995126,2.7617043661230856,38.36393996317469,28.56738577506676,33.06867426175856,4963625916
1405431000,19.5625,19.6725,19.17,19.4225,17.57,18.506749999999993,19.725,13.2775,17.02,13.2775,15.95,6.233271,12.5275,5.292446,15.751600039999976,17.213425000000008,18.163200000000014,19.158250000000017,18.327554078810785,19.090659175172853,19.30576923076924,19.764582015680073,18.846956445858407,15.751600039999976,17.213425000000008,18.163200000000014,19.158250000000017,19.421666666666667,5164068,5117699.6,60.487272150117846,0.8535460973591535,1.5,2.75,NaN,NaN,0.3648453734003204,1.0090603989339273,536.1209877543398,-0.04574576377255124,0.34850365447204723,0.39424941824459847,24.191861741975842,0.1546989815650439,42.96041258361597,24.579905518049333,32.45968189833469,4958461848
1405517400,19.6875,19.725,19.4775,19.63,17.61,18.52499999999999,19.725,13.2775,17.02,13.2775,15.95,6.233271,12.5275,5.292446,15.788775039999976,17.25382500000001,18.219650000000016,19.215250000000015,18.378630389445657,19.142024968013533,19.3598076923077,19.7924136666008,18.9272017180146,15.788775039999976,17.25382500000001,18.219650000000016,19.215250000000015,19.610833333333332,6405576,5148493.6,63.545435391595575,1.6755267713747364,1.5,2.75,NaN,NaN,0.3603921324431548,1.2441650893768228,537.7774302232751,-0.03485897950390332,0.3506756938647193,0.3855346733686226,22.20417017270026,0.9773662551440212,48.96373101384674,19.875176238421933,31.161092747731328,4964867424
1405603800,19.4625,19.675,18.8825,18.965,17.65,18.543249999999993,19.725,13.2775,17.02,13.2775,15.95,6.233271,12.5275,5.292446,15.823550049999977,17.28540000000001,18.271300000000014,19.218625000000014,18.401625276134062,19.12516544725034,19.355384615384622,19.802623349403827,18.908145881365417,15.823550049999977,17.28540000000001,18.271300000000014,19.218625000000014,19.174166666666668,12292208,5479293,50.14936754077232,0.6521268426242254,1.5,2.75,NaN,NaN,0.39125698012578664,2.2433930800926323,533.0897139835371,-0.07216158119280586,0.2953326968776153,0.3674942780704212,30.123805727281606,-3.852978453738918,29.12734385575691,37.74980405071125,33.122852093531854,4952575216
1405690200,19.1375,19.5975,19.115,19.5275,17.689999999999998,18.56149999999999,19.725,13.2775,17.02,13.2775,15.95,6.233271,12.5275,5.292446,15.859800049999976,17.322575000000008,18.328650000000017,19.246750000000013,18.44577722608959,19.16348302370269,19.395192307692316,19.802738725711464,18.987645889673168,15.859800049999976,17.322575000000008,18.328650000000017,19.246750000000013,19.41333333333333,5052268,5327336.4,58.180198907535086,1.0499389547893363,1.5,2.75,NaN,NaN,0.40848862440251615,0.9483666171334703,538.2558720520817,-0.059212239219690266,0.29347897904580833,0.3526912182654986,34.06745556705135,-0.03839262861530732,30.825884408624315,35.93044324260703,33.24367234876865,4957627484
1405949400,19.3475,19.48,19.1625,19.425,17.73,18.579749999999994,19.725,13.2775,17.02,13.2775,15.95,6.233271,12.5275,5.292446,15.895825049999978,17.35860000000001,18.385100000000016,19.263875000000017,18.484178119184115,19.18838940239767,19.397692307692317,19.80554060876318,18.989844006621453,15.895825049999978,17.35860000000001,18.385100000000016,19.263875000000017,19.355833333333333,4569080,5352330.8,56.39727035316752,0.5616439051244971,1.5,2.75,NaN,NaN,0.4053822940880506,0.8536617355564047,535.3236670648824,-0.05774856817331542,0.2805055080488543,0.33825407622216974,33.74963949020737,1.3963199791204586,15.873301668124492,54.675159682890325,29.4515386489852,4953058404
1406035800,19.6425,19.785,19.5875,19.6875,17.77,18.597999999999992,19.725,13.2775,17.02,13.2775,15.95,6.233271,12.5275,5.292446,15.934800034999977,17.394700000000007,18.445450000000015,19.294750000000015,18.531367212549444,19.235923745026465,19.416730769230778,19.852829666868356,18.9806318715932,15.934800034999977,17.394700000000007,18.445450000000015,19.294750000000015,19.686666666666667,7157292,5425782.8,59.795289370724035,1.718948121946567,1.5,2.75,NaN,NaN,0.4021407016531898,1.319126154478576,538.6901687110031,-0.0401355532426001,0.28808463466891965,0.32822018791151975,32.24595603549679,1.5212066520562162,38.10299998047977,28.78710010420259,33.10989991531764,4960215696
1406122200,19.76,19.88,19.6575,19.815,17.81,18.616249999999994,19.725,13.2775,17.02,13.2775,15.95,6.233271,12.5275,5.292446,15.973125019999976,17.430875000000007,18.498900000000017,19.349375000000016,18.58170575323378,19.291073864547755,19.423653846153858,19.881426948266412,18.965880744041304,15.973125019999976,17.430875000000007,18.498900000000017,19.349375000000016,19.784166666666664,5907472,5380997.8,61.37000570171926,1.9849353255966713,1.5,2.75,NaN,NaN,0.38930922296367626,1.0978395122183473,540.8673228167108,-0.02184765334771771,0.3009106212268726,0.32275827457459033,31.795951550701236,3.418580375782887,37.27347425694956,29.548674124027865,33.17785161902258,4966123168
1406208600,19.8825,19.939075,19.75275,19.815,17.849999999999998,19.939075,19.725,13.2775,17.02,13.2775,15.95,6.233271,12.5275,5.292446,16.012987519999978,17.47062500000001,18.551350000000017,19.392000000000017,18.630070233499122,19.340971591733684,19.44519230769232,19.946200758175564,18.944183857209076,16.012987519999978,17.47062500000001,18.551350000000017,19.392000000000017,19.83560833333333,4021320,5160509,61.37000570171926,1.7513518996853568,1.5,2.75,NaN,NaN,0.37481034989484224,0.7792487136443323,540.0515232026886,-0.01218238747924355,0.3075302902255359,0.31971267770477946,30.554770471184717,2.9083354972734474,76.58623102753451,4.6162670944178466,18.797501878047637,4966123168
1406295000,19.645,19.697475,19.425,19.545,17.89,19.974490460526315,19.725,13.2775,17.02,13.2775,15.95,6.233271,12.5275,5.292446,16.053600019999976,17.50060000000001,18.603050000000017,19.422875000000015,18.665949832185433,19.36040286871143,19.475000000000012,19.949398404459647,19.000601595540378,16.053600019999976,17.50060000000001,18.603050000000017,19.422875000000015,19.555825000000002,3295972,5110576.6,55.98461707306647,0.30282298983003136,1.5,2.75,NaN,NaN,0.3758953249023535,0.6449315327745992,537.0299955047137,-0.025631293883726203,0.2876735603501217,0.3133048542338479,32.03834237586803,0.051190171487082485,51.848503605284904,17.789538339330534,30.361958055384566,4962827196
1406554200,19.55,19.6425,19.215,19.5525,17.93,20.00990592105263,19.725,13.2775,17.02,13.2775,15.95,6.233271,12.5275,5.292446,16.094100019999974,17.53080000000001,18.664300000000015,19.449375000000018,18.700716505433064,19.378697833596053,19.487307692307702,19.960807190879695,19.01380819373571,16.094100019999974,17.53080000000001,18.664300000000015,19.449375000000018,19.47,4032832,5106810.4,56.09985859551579,0.4573989207820141,1.5,2.75,NaN,NaN,0.37958137312361384,0.7896968330760821,535.1308278957762,-0.0350948811631378,0.26943625277992567,0.30453113394306347,30.960634106191854,0.6693268116874708,81.65180075405041,2.9173785861358708,15.43082065981371,4966860028
1406640600,19.68,19.745,19.305,19.31,17.97,20.045321381578947,19.725,13.2775,17.02,13.2775,15.95,6.233271,12.5275,5.292446,16.129675019999976,17.55712500000001,18.716700000000014,19.464375000000018,18.72460997580824,19.37215518277738,19.498846153846166,19.946483607530315,19.051208700162018,16.129675019999976,17.55712500000001,18.716700000000014,19.464375000000018,19.453333333333333,5821164,5188714.8,51.41269575845973,0.12160808565136645,1.5,2.75,NaN,NaN,0.3838969893290701,1.12188937422423,532.8446924898259,-0.05743887836167533,0.23273253599096932,0.29017141435264465,31.654898415861084,-1.6301579215486515,37.20814932711268,29.60767998494785,33.18417068793948,4961038864
1406727000,19.52,19.5875,19.08,19.315,18.009999999999998,20.080736842105264,19.725,13.2775,17.02,13.2775,15.95,6.233271,12.5275,5.292446,16.164100019999974,17.583450000000013,18.765900000000016,19.460500000000017,18.747762525776544,19.36671183203668,19.503461538461554,19.94209375895165,19.06482931797146,16.164100019999974,17.583450000000013,18.765900000000016,19.460500000000017,19.3275,7657800,5239760.4,51.50266810889442,0.7463378298155823,1.5,2.75,NaN,NaN,0.3927257758055651,1.461479040148477,530.2243910984888,-0.07075897109031293,0.2017227004897535,0.2724816715800664,30.862885130636787,1.845504877405755,42.29351416131459,25.11913888731528,32.58734695137014,4968696664
1406813400,18.91,18.96,18.15,18.155,18.05,20.116152302631576,19.815,13.2775,17.02,13.2775,15.95,6.233271,12.5275,5.292446,16.191937504999977,17.59835000000001,18.798350000000013,19.396250000000016,18.724516936530406,19.251310705176042,19.397307692307706,20.23784886765584,18.556766516959573,16.191937504999977,17.59835000000001,18.798350000000013,19.396250000000016,18.421666666666667,9217780,5514732.4,35.211724874976326,5.206812465192122,1.5,2.75,NaN,NaN,0.4478882203908821,1.6714827359528812,522.9600374910897,-0.15191109838744926,0.08259279859575486,0.23450389698320412,43.117995539305916,-7.028549481500442,21.053607014336563,47.372062645782954,31.574330339880483,4959478884
1406899800,18.0075,18.3375,17.74,17.995,18.09,20.151567763157892,19.815,13.2775,17.02,13.2775,15.95,6.233271,12.5275,5.292446,16.220425004999974,17.61410000000001,18.819350000000014,19.309750000000015,18.69590842921549,19.131662066587847,19.28750000000001,20.41139946169576,18.16360053830426,16.220425004999974,17.61410000000001,18.819350000000014,19.309750000000015,18.02416666666667,7467360,5745516.8,33.6315329364882,5.902320744142837,1.5,2.75,NaN,NaN,0.4585747760772477,1.2996846515182063,519.816867423739,-0.20716100227744066,-0.024447355863596698,0.18271364641384397,37.43889020870941,-7.36164736164736,16.495563779588988,53.737611717885635,29.766824502525367,4952011524
1407159000,18.1125,18.4975,17.8675,18.38,18.13,20.18698322368421,19.815,13.2775,17.02,13.2775,15.95,6.233271,12.5275,5.292446,16.248237504999974,17.633600000000012,18.845400000000012,19.252000000000017,18.6835198633639,19.06007520310329,19.191346153846162,20.39279338272764,17.989898924964685,16.248237504999974,17.633600000000012,18.845400000000012,19.252000000000017,18.24833333333333,4573908,5806487.4,40.54557697029153,4.0101059957389324,1.5,2.75,NaN,NaN,0.47081943492887285,0.787723744995985,522.4561682953544,-0.2080268144780597,-0.07731987168373067,0.13070694279432904,41.07711896453602,-6.641269841269847,15.538251286009746,55.28646033930943,29.175288374680818,4956585432
1407245400,18.15,18.2975,17.65,17.835,18.169999999999998,20.222398684210525,19.815,13.2775,17.02,13.2775,15.95,6.233271,12.5275,5.292446,16.272012489999973,17.65295000000001,18.856200000000015,19.185875000000017,18.650244574604532,18.94340137423631,19.104423076923084,20.50568782685733,17.703158326988838,16.272012489999973,17.65295000000001,18.856200000000015,19.185875000000017,17.9275,6888656,5820564,34.98883431243077,5.489610928257448,1.5,2.75,NaN,NaN,0.4893323324339534,1.1835031794169775,519.1449320134974,-0.23363663645721094,-0.16133885277718463,0.0722977836800263,41.32108061709163,-9.992429977289934,15.003755618732747,56.11350489013751,28.882739491129733,4949696776
1407331800,17.595,18.091375,17.5875,17.8625,18.21,20.25781414473684,19.815,13.2775,17.02,13.2775,15.95,6.233271,12.5275,5.292446,16.294724989999974,17.67430000000001,18.861500000000014,19.109375000000018,18.619352630502394,18.840458386213804,18.97634615384616,20.49865666420232,17.45403564349,16.294724989999974,17.67430000000001,18.861500000000014,19.109375000000018,17.847125000000002,5045448,5864540,35.46941166325986,4.685730778207126,1.5,2.75,NaN,NaN,0.4903710944029568,0.8603314155926978,520.3020158372572,-0.23634489751811272,-0.2231333382176146,0.013211559300498117,40.70323218546607,-9.853646227605351,9.807241804942148,65.05054010016006,25.142218094897785,4954742224
1407418200,18.1125,18.155,17.4438,17.5625,17.4438,20.293229605263157,19.815,13.2775,17.02,13.2775,15.95,6.233271,12.5275,5.292446,16.315799989999974,17.68832500000001,18.861750000000015,19.029500000000017,18.577907429306222,18.71874806371725,18.83307692307693,20.502943515912964,17.163210330240897,16.315799989999974,17.68832500000001,18.861750000000015,19.029500000000017,17.720433333333332,6778584,5978266.6,32.63518446198471,5.250298911223391,1.5,2.75,NaN,NaN,0.5061445876598886,1.13387114586024,518.845993859401,-0.24491853942360295,-0.2929366149790056,-0.04801807555540263,40.28312902322002,-10.143259145561533,11.790160222488996,61.42256553202738,26.787274245483633,4947963640
1407504600,17.6775,18.21,17.5525,18.1675,17.473846913580246,20.328645065789473,19.815,13.2775,17.02,13.2775,15.95,6.233271,12.5275,5.292446,16.338899989999973,17.70487500000001,18.868400000000015,18.975125000000016,18.56181302031382,18.666248248125132,18.716153846153855,20.342637329227095,17.089670363080614,16.338899989999973,17.70487500000001,18.868400000000015,18.975125000000016,17.97666666666667,5899788,6057383.6,42.596913504862286,2.7318265800494985,1.5,2.75,NaN,NaN,0.5169556885413252,0.9739828925478651,520.970993859401,-0.19840583928695288,-0.29602537466409373,-0.09761953537714085,48.054721205384375,-7.083493159442517,36.63743562135452,30.23338808819695,33.12917629044852,4953863428
1407763800,18.385,18.575,18.312525,18.33,17.503893827160493,20.36406052631579,19.815,13.2775,17.02,13.2775,15.95,6.233271,12.5275,5.292446,16.363662499999975,17.72575000000001,18.877400000000016,18.914875000000016,18.55272231363485,18.634224605446548,18.601923076923086,20.10778106625132,17.09606508759485,16.363662499999975,17.72575000000001,18.877400000000016,18.914875000000016,18.405841666666664,5315772,6128217.4,44.9515785863002,0.40554808795745273,1.5,2.75,NaN,NaN,0.5091374250740877,0.8674254930968995,525.2036836248577,-0.14759146895604322,-0.2821088715721949,-0.13451740261615167,48.795051266380405,-5.075090626618335,39.35900226358989,27.66529279448149,32.97570494192861,4959179200
1407850200,18.275,18.4295,18.1,18.2675,17.53394074074074,20.399475986842106,19.815,13.2775,17.02,13.2775,15.95,6.233271,12.5275,5.292446,16.387499999999974,17.743150000000007,18.883350000000018,18.857125000000014,18.541537124864856,18.599298452546876,18.482884615384624,19.821747287370766,17.14402194339848,16.387499999999974,17.743150000000007,18.883350000000018,18.857125000000014,18.265666666666664,3834764,6061752.2,44.2005900607696,1.0876539416973512,1.5,2.75,NaN,NaN,0.4963061804259385,0.6326164240102061,523.0873208023155,-0.11076725189062067,-0.2729764674794275,-0.16220921558880683,48.66301794307074,-5.423246181724064,47.97455767797063,20.605660196886678,31.4197821251427,4955344436
1407936600,18.48,18.69,18.385,18.6475,17.563987654320986,20.434891447368422,19.815,13.2775,17.02,13.2775,15.95,6.233271,12.5275,5.292446,16.412324999999974,17.76632500000001,18.897400000000015,18.808000000000014,18.5456925317329,18.60388907611384,18.41384615384616,19.611644800377842,17.216047507314475,16.412324999999974,17.76632500000001,18.897400000000015,18.808000000000014,18.574166666666667,5777032,6030325,49.70260892605943,0.8271646987768156,1.5,2.75,NaN,NaN,0.49103431039551454,0.9579967912177204,527.1356400694792,-0.056150400953114354,-0.23239721678019976,-0.1762468158270854,50.89267185521114,2.712751308179563,49.98796258510375,19.118641680262154,30.893395734634083,4961121468
1408023000,18.7175,18.89,18.66775,18.8825,17.594034567901232,20.470306907894734,19.815,13.2775,17.02,13.2775,15.95,6.233271,12.5275,5.292446,16.437962499999976,17.793900000000008,18.914450000000016,18.803875000000012,18.558900667743373,18.630423449817286,18.362307692307695,19.407651694462125,17.316963690153266,16.437962499999976,17.793900000000008,18.914450000000016,18.803875000000012,18.813416666666665,2928688,5562149,52.80205783260846,1.6980301702293903,1.5,2.75,NaN,NaN,0.47328185965297775,0.5265389330634617,530.3435847527475,-0.002370160513126107,-0.17920951646849304,-0.17683935595536693,35.156066370908306,4.9319255348707935,81.1432106983387,3.0740134529534857,15.78277584870781,4964050156
1408109400,19.0975,19.15,18.475,18.89,17.624081481481483,20.50572236842105,19.815,13.2775,17.02,13.2775,15.95,6.233271,12.5275,5.292446,16.462512499999974,17.819150000000008,18.924000000000017,18.772000000000013,18.571884955282847,18.655145026025163,18.330000000000002,19.27757788395142,17.382422116048584,16.462512499999974,17.819150000000008,18.924000000000017,18.772000000000013,18.838333333333335,6918984,5655484.8,52.90180976710705,1.4125548254569325,1.5,2.75,NaN,NaN,0.48769029824919347,1.223411298002251,529.7405620635919,0.033553343160080296,-0.13489767700526656,-0.16845102016534685,34.318437093583434,2.7747551686615974,82.21802754007543,2.7514993889761197,15.030473070948462,4970969140
1408368600,19.1975,19.3775,19.1625,19.3325,17.65412839506173,20.541137828947367,19.815,13.2775,17.02,13.2775,15.95,6.233271,12.5275,5.292446,16.490362499999975,17.85250000000001,18.937350000000016,18.767375000000012,18.601712996252147,18.719655023546576,18.331346153846155,19.28455049747351,17.3781418102188,16.490362499999975,17.85250000000001,18.937350000000016,18.767375000000012,19.290833333333335,3983508,5626206.2,58.47772427077497,3.2956917568289765,1.5,2.75,NaN,NaN,0.4876767055171083,0.70802737375676,534.7154992491251,0.08408562965150351,-0.06334398310096745,-0.14742961275247096,34.67998308578361,8.396411550322393,81.59128407993501,2.9347815639178667,15.47393435614712,4974952648
1408455000,19.47,19.695,19.4325,19.625,17.684175308641976,20.576553289473683,19.815,13.2775,17.02,13.2775,15.95,6.233271,12.5275,5.292446,16.520412499999978,17.889550000000007,18.95520000000002,18.76425000000001,18.641841898359907,18.80587835463738,18.444423076923076,19.61182181877832,17.277024335067832,16.520412499999978,17.889550000000007,18.95520000000002,18.76425000000001,19.584166666666665,3945488,5465616,61.705103950531175,4.28903084728738,1.5,2.75,NaN,NaN,0.47873551226588634,0.7218743504849224,537.3843849378859,0.13136113450430514,0.016771805377910454,-0.11458932912639468,26.713422340831013,9.867039888033586,100,0,0,4978898136
1408541400,19.5625,19.875,19.5625,19.7975,17.714222222222222,20.61196875,19.815,13.2775,17.02,13.2775,15.95,6.233271,12.5275,5.292446,16.550699999999978,17.926225000000006,18.976550000000017,18.763375000000014,18.68716182391442,18.900318511338583,18.583076923076923,19.919901740214897,17.24625210593895,16.550699999999978,17.926225000000006,18.976550000000017,18.763375000000014,19.744999999999997,3472768,5343880.8,63.506591453241136,4.257065135571214,1.5,2.75,NaN,NaN,0.4668615471040373,0.6498588067308687,537.6825273348859,0.16615957338163023,0.09311013760064313,-0.0730494357809871,26.23839329889955,12.72597864768683,100,0,0,4982370904
1408627800,19.865,20.0525,19.81775,19.9825,17.74426913580247,20.647384210526315,19.815,13.2775,17.02,13.2775,15.95,6.233271,12.5275,5.292446,16.581199999999978,17.960750000000008,19.005150000000018,18.771750000000015,18.73795939944719,19.003383415020622,18.706346153846155,20.228256157483557,17.184436150208754,16.581199999999978,17.960750000000008,19.005150000000018,18.771750000000015,19.950916666666668,5217816,5403705.6,65.3871835654444,4.514753470786126,1.5,2.75,NaN,NaN,0.45172857945374884,0.9655996063146002,539.9993185139786,0.19173244687817972,0.16661612281673754,-0.025116324061442173,19.82883382121475,9.990367414338797,100,0,0,4987588720
1408714200,19.9275,20.03,19.747575,19.875,17.774316049382715,20.68279967105263,19.815,13.2775,17.02,13.2775,15.95,6.233271,12.5275,5.292446,16.611812499999978,17.990975000000006,19.039900000000017,18.788250000000012,18.782549226919848,19.08639451835199,18.86326923076923,20.413858925810075,17.312679535728385,16.611812499999978,17.990975000000006,19.039900000000017,18.788250000000012,19.884191666666666,4864800,5482147,63.34445708621233,3.5385815982628395,1.5,2.75,NaN,NaN,0.4396354666356239,0.8873895574124517,537.4688029989244,0.19107867874051498,0.21373202436420158,0.02265334562368658,17.28741114672146,8.428805237315885,72.2440567580654,6.345512776969197,21.410430464965405,4982723920
1408973400,20.1875,20.2825,20.09,20.1825,17.804362962962962,20.718215131578948,19.815,13.2775,17.02,13.2775,15.95,6.233271,12.5275,5.292446,16.642987499999975,18.022600000000008,19.077350000000017,18.819750000000013,18.837449257236717,19.190785516604183,19.041730769230767,20.624218324918118,17.459243213543417,16.642987499999975,18.022600000000008,19.077350000000017,18.819750000000013,20.185000000000002,3059184,5433464.6,66.5623708629627,4.131413337641881,1.5,2.75,NaN,NaN,0.43734007616165066,0.563026397558567,540.0297712842724,0.20006965485131722,0.2727404141878331,0.07267075933651589,17.667682301034542,10.483098398795692,71.57289232592231,6.63857558775933,21.78853208631837,4985783104
1409059800,20.24,20.3726,20.21,20.2275,17.83440987654321,20.753630592105264,19.815,13.2775,17.02,13.2775,15.95,6.233271,12.5275,5.292446,16.676924999999976,18.055375000000005,19.115000000000016,18.865625000000016,18.89196105107057,19.289520229308547,19.24673076923077,20.69432477390434,17.799136764557197,16.676924999999976,18.055375000000005,19.115000000000016,18.865625000000016,20.270033333333334,3016956,5293254.2,67.01867553541868,3.9237023956429624,1.5,2.75,NaN,NaN,0.41968007072153257,0.5699624250050186,542.807440658851,0.1974263120172296,0.31945364935805287,0.12202733734082329,16.397534830869475,8.472985654913519,70.19343434439503,7.252835180133402,22.55373047547157,4988800060
1409146200,20.25,20.29725,20.1075,20.21,17.864456790123455,20.789046052631576,19.815,13.2775,17.02,13.2775,15.95,6.233271,12.5275,5.292446,16.708112499999977,18.093850000000007,19.149400000000018,18.910375000000013,18.943648852989373,19.3771849693744,19.403846153846153,20.790897003372443,18.016795304319864,16.708112499999977,18.093850000000007,19.149400000000018,18.910375000000013,20.204916666666666,2183436,5019536,66.6378285744101,3.0863208306628542,1.5,2.75,NaN,NaN,0.40325649424142285,0.4349876163852595,544.6019709547921,0.18319079337305028,0.35101582905713613,0.16782503568408585,16.039144343925148,7.030319078511853,50.46282298679289,18.77208324884271,30.76509376436441,4986616624
1409232600,20,20.2,19.9425,20.1725,17.894503703703702,20.824461513157893,19.815,13.2775,17.02,13.2775,15.95,6.233271,12.5275,5.292446,16.739162499999978,18.137550000000005,19.174900000000015,19.01125000000001,18.991839094048615,19.452929258005412,19.545576923076922,20.83807027054701,18.253083575606833,16.739162499999978,18.137550000000005,19.174900000000015,19.01125000000001,20.105,4418624,4779578.2,65.77525706343116,2.4680479322034343,1.5,2.75,NaN,NaN,0.39355960179560706,0.9244799049422394,542.8164963783595,0.16074189076913944,0.36875239914551017,0.20801050837637072,16.67906178666524,6.789306511381677,16.042159649472413,54.422771876042376,29.535068474485207,4982198000
1409319000,20.2675,20.3425,20.07,20.3325,17.92455061728395,20.85987697368421,19.815,13.2775,17.02,13.2775,15.95,6.233271,12.5275,5.292446,16.771362499999977,18.180825000000006,19.202250000000014,19.12812500000001,19.044414031536906,19.536697900100133,19.704423076923074,20.82582356437367,18.583022589472478,16.771362499999977,18.180825000000006,19.202250000000014,19.12812500000001,20.248333333333335,3545728,4583496.6,67.69656249655459,2.4816609718721883,1.5,2.75,NaN,NaN,0.38491248738163514,0.7735858252845655,546.146675065771,0.1465594321086949,0.39120979851223936,0.24465036640354446,16.2068904446604,5.17263675158412,47.070682823189436,21.287817687607482,31.6414994892031,4985743728
1409664600,20.4275,20.4275,20.077525,20.2925,17.9545975308642,20.895292434210525,19.815,13.2775,17.02,13.2775,15.95,6.233271,12.5275,5.292446,16.801749999999977,18.218475000000005,19.226450000000014,19.223750000000013,19.093358579319773,19.608679052471548,19.83096153846154,20.8088075591809,18.853115517742182,16.801749999999977,18.218475000000005,19.226450000000014,19.223750000000013,20.26584166666667,3406808,4525141.6,66.68862712758143,2.114027058067205,1.5,2.75,NaN,NaN,0.382416952568661,0.7528621866772082,544.869342318454,0.12520411692752836,0.4011555125629549,0.27595139563542653,13.427913755925303,3.401273885350321,20.931149772990484,47.530931070449114,31.537919156560402,4982336920
1409751000,20.53,20.5475,20.1925,20.2675,17.984644444444445,20.93070789473684,19.815,13.2775,17.02,13.2775,15.95,6.233271,12.5275,5.292446,16.830837499999976,18.266350000000003,19.250400000000017,19.34537500000001,19.139403340915077,19.671423904617114,19.9375,20.769739795325286,19.105260204674714,16.830837499999976,18.266350000000003,19.250400000000017,19.34537500000001,20.33583333333333,5068132,4434115.4,66.02694112576529,2.1584288554039825,1.5,2.75,NaN,NaN,0.38045859881375665,1.1429860395604499,543.1429610868418,0.10114437459887793,0.40238186388402397,0.30123748928514604,12.099857759084088,2.3740371258997293,4.388010274975723,77.20795004961326,18.404039675411006,4977268788
1409837400,20.355,20.59,20.0125,20.1525,18.01469135802469,20.966123355263157,19.815,13.2775,17.02,13.2775,15.95,6.233271,12.5275,5.292446,16.858437499999976,18.317325000000004,19.279000000000018,19.45987500000001,19.179132621663506,19.71724067560596,20.034615384615385,20.6103785776365,19.45885219159427,16.858437499999976,18.317325000000004,19.279000000000018,19.45987500000001,20.251666666666665,6745868,4519136.4,62.933617345148,1.5729520096979768,1.5,2.75,NaN,NaN,0.39453298461277403,1.4927338772071583,540.2186279768949,0.07067668294464802,0.3895833429659561,0.3189066600213081,12.514786675484052,0.850744401351173,2.7597644746749186,82.18204416770372,15.058191357621368,4970522920
1409923800,20.15,20.465,19.935025,20.445,18.04473827160494,21.001538815789473,19.815,13.2775,17.02,13.2775,15.95,6.233271,12.5275,5.292446,16.888249999999978,18.367600000000003,19.308650000000018,19.60400000000001,19.228774479637487,19.786551087453013,20.120192307692307,20.570023308173692,19.67036130721092,16.888249999999978,18.367600000000003,19.308650000000018,19.60400000000001,20.281675,3688428,4364628.6,67.14924522625974,1.8107752108228685,1.5,2.75,NaN,NaN,0.4042074142832902,0.8450725910562012,542.7620560864889,0.06363439108658386,0.39844964887953793,0.33481525779295407,13.901565591789199,2.8679245283018884,13.613832060754548,58.23321729394621,28.15295064529925,4974211348
1410183000,20.385,20.47,20.1125,20.2975,18.074785185185185,21.03695427631579,19.815,13.2775,17.02,13.2775,15.95,6.233271,12.5275,5.292446,16.91782499999998,18.413300000000003,19.336050000000018,19.71050000000001,19.270685284357587,19.835212888647963,20.17192307692308,20.526699029224474,19.817147124621684,16.91782499999998,18.413300000000003,19.336050000000018,19.71050000000001,20.293333333333333,4297360,4284507.2,63.24311981879611,1.2037717391044227,1.5,2.75,NaN,NaN,0.4008711704059122,1.0029998315792303,541.3285715038091,0.04341904684241049,0.3890890663459672,0.3456700195035567,14.30832948469077,0.569800569800562,2.9392836443499566,81.57672791028241,15.483988445367638,4969913988
1410269400,20.245,20.2725,19.780075,19.9,18.10483209876543,21.072369736842106,19.815,13.2775,17.02,13.2775,15.95,6.233271,12.5275,5.292446,16.94608749999998,18.450225000000003,19.353600000000018,19.78900000000001,19.295364292814153,19.84138308972911,20.17980769230769,20.50420335254176,19.85541203207362,16.94608749999998,18.450225000000003,19.353600000000018,19.78900000000001,19.984191666666668,7029812,4370209.2,54.10832255288748,0.325995722707901,1.5,2.75,NaN,NaN,0.409196443948347,1.6085756260821564,537.1707648317957,-0.00004656642832862046,0.3456118114681459,0.3456583778964745,16.442756813442887,-1.6190829316524562,2.1834413927206526,84.2539030402676,13.562655567011735,4962884176
1410355800,19.905,20.16,19.7325,20.1325,18.134879012345678,21.107785197368422,19.815,13.2775,17.02,13.2775,15.95,6.233271,12.5275,5.292446,16.97384999999998,18.4888,19.376050000000017,19.88225000000001,19.328193144076344,19.86910850975491,20.19134615384615,20.49697674650925,19.88571556118305,16.97384999999998,18.4888,19.376050000000017,19.88225000000001,20.008333333333333,4145888,4385765.4,57.93544561738817,0.43015548099889733,1.5,2.75,NaN,NaN,0.4105038408091792,0.9453054648112276,538.4886578871167,-0.015601224281750481,0.3261568475442864,0.3417580718260369,18.006799445380846,-0.38347352795646,11.65509689442728,61.56019659486029,26.784706510712425,4967030064
1410442200,19.87,20.1975,19.835,20.1875,18.164925925925925,21.143200657894734,19.815,13.2775,17.02,13.2775,15.95,6.233271,12.5275,5.292446,17.00086249999998,18.526075000000002,19.39195000000002,19.95925000000001,19.36189145215178,19.89943150882587,20.21538461538461,20.460967486826334,19.969801743942888,17.00086249999998,18.526075000000002,19.39195000000002,19.95925000000001,20.073333333333334,3222184,4258023,58.81052838476082,0.25350120748124244,1.5,2.75,NaN,NaN,0.407074995037095,0.7567324084440127,540.5428682511691,-0.02413851211882001,0.3115849316775119,0.3357234437963319,18.095625998283435,0.07435865658694048,32.6745051553605,33.99761514449619,33.32787970014332,4970252248
1410528600,20.1275,20.1325,19.66525,19.8325,18.19497283950617,21.17861611842105,20.445,13.2775,17.02,13.2775,15.95,6.233271,12.5275,5.292446,17.02618749999998,18.5578,19.399800000000017,20.00675000000001,19.380346689322298,19.893057079413882,20.18846153846153,20.5081280621867,19.868795014736364,17.02618749999998,18.5578,19.399800000000017,20.00675000000001,19.87675,6808588,4452018,51.38063393321048,1.1306206338295761,1.5,2.75,NaN,NaN,0.41530178110587385,1.5293262516009594,535.7374436847903,-0.05394013525647595,0.268298274725737,0.3222384099822129,20.750434148043972,-2.4591171769334808,10.563661612562807,63.531507099929705,25.9048312875075,4963443660
1410787800,19.8375,19.885,19.6075,19.7875,18.225019753086418,21.214031578947367,20.445,13.2775,17.02,13.2775,15.95,6.233271,12.5275,5.292446,17.05128749999998,18.589999999999996,19.401050000000016,20.051625000000012,19.396313485819462,19.883004024231607,20.15461538461538,20.537503428876192,19.771727340354566,17.05128749999998,18.589999999999996,19.401050000000016,20.051625000000012,19.76,2504316,4231284.6,50.509530473879956,1.1911076871539408,1.5,2.75,NaN,NaN,0.4054587967411685,0.5918571395552075,532.5412449621653,-0.07560116520948895,0.22773695347035172,0.3033381186798407,19.83138880805899,-2.488604164100032,13.12279791115692,59.07118397803831,27.80601811080475,4960939344
1410874200,19.675,20.3325,19.6475,20.2375,18.255066666666664,21.249447039473683,20.445,13.2775,17.02,13.2775,15.95,6.233271,12.5275,5.292446,17.07816249999998,18.625725,19.415100000000017,20.096875000000015,19.429301192257913,19.91676554573336,20.156730769230766,20.541120318313187,19.772341220148345,17.07816249999998,18.625725,19.415100000000017,20.096875000000015,20.0725,6528444,4358531.4,58.15045193770547,1.1347214018674758,1.5,2.75,NaN,NaN,0.4254260255453707,1.4978540707541994,535.5446443966837,-0.05926226814277802,0.22926028350136818,0.2885225516441462,24.558312160206686,-0.14802022943134371,48.87889702103635,19.94122712317355,31.179875855790094,4967467788
1410960600,20.33,20.594975,20.0225,20.3075,18.285113580246914,21.2848625,20.445,13.2775,17.02,13.2775,15.95,6.233271,12.5275,5.292446,17.105587499999977,18.666299999999996,19.438100000000016,20.131000000000014,19.463740361188975,19.95397835090161,20.167115384615382,20.55985157594021,19.774379193290553,17.105587499999977,18.666299999999996,19.438100000000016,20.131000000000014,20.308325,6052944,4463904.2,59.20555622414995,1.469328919043941,1.5,2.75,NaN,NaN,0.4359295237207014,1.3559753365674827,536.6566512041201,-0.04407790653809823,0.2334251684715234,0.2775030750096216,24.638077320073474,0.7691353430095578,53.39387742543488,16.744275987424665,29.86184658714045,4973520732
1411047000,20.505,20.6475,20.433075,20.6175,18.31516049382716,21.320277960526315,20.445,13.2775,17.02,13.2775,15.95,6.233271,12.5275,5.292446,17.13507499999998,18.708399999999997,19.462600000000013,20.172000000000015,19.50898583722078,20.017170888910982,20.18903846153846,20.64326027477655,19.734816648300367,17.13507499999998,18.708399999999997,19.462600000000013,20.172000000000015,20.566025,4060236,4493277.6,63.58422873511565,2.1636640973013836,1.5,2.75,NaN,NaN,0.4290774148835084,0.9036245612779411,539.3407341155199,-0.014996472938954286,0.2587574838359288,0.27375395677488307,25.69318238018129,0.843727072633893,55.29581349855562,15.482529907548617,29.221656593895755,4977580968
1411133400,20.8275,20.8975,20.459975,20.5825,18.345207407407408,20.8975,20.445,13.2775,17.02,13.2775,15.95,6.233271,12.5275,5.292446,17.165224999999978,18.747999999999998,19.491050000000016,20.202000000000012,19.551084431839573,20.071011756633744,20.21134615384615,20.71001212569433,19.71268018199797,17.165224999999978,18.747999999999998,19.491050000000016,20.202000000000012,20.646658333333335,4706732,4467723.4,62.76510270628757,2.1208203541521082,1.5,2.75,NaN,NaN,0.42968081382040074,1.0534967316911337,536.8145822398463,-0.0007120346705538072,0.2728639134366908,0.2735759481072446,24.551084131534623,1.4041138071191042,62.679064005312085,11.044346231589003,26.27658976309891,4972874236
1411392600,20.47,20.4775,19.975,20.0975,18.375254320987654,20.921460625,20.445,13.2775,17.02,13.2775,15.95,6.233271,12.5275,5.292446,17.19316249999998,18.781,19.507900000000014,20.213125000000012,19.57251249333606,20.07353444647815,20.19826923076923,20.69926970910228,19.697268752436184,17.19316249999998,18.781,19.507900000000014,20.213125000000012,20.183333333333334,4572204,4453093.6,52.64437637084724,0.5657800095134901,1.5,2.75,NaN,NaN,0.4423821842618006,1.0267477872012392,534.1653971164203,-0.02516720611487616,0.2421169404636494,0.26728414657852556,28.093191889211628,0.9924623115577969,54.86633535919489,15.777246150431166,29.35641849037395,4968302032
1411479000,19.88,20.1325,19.745,19.757475,18.4053012345679,20.945421250000003,20.445,13.2775,17.02,13.2775,15.95,6.233271,12.5275,5.292446,17.220274874999976,18.81072475,19.512349500000013,20.191873750000013,19.57976592496994,20.043433546813564,20.167882692307693,20.721460175378773,19.614305209236612,17.220274874999976,18.81072475,19.512349500000013,20.191873750000013,19.878325,6531604,4626714.6,46.93083339507082,1.4437298534086833,1.5,2.75,NaN,NaN,0.43846202824310054,1.4117153454851095,530.4834545542762,-0.06331230695330431,0.18814376288689516,0.25145606984019947,27.466686094821135,-1.862784055631446,21.424450329009886,46.9353417332849,31.640207937705203,4961770428
1411565400,19.775,20.25,19.615,20.2325,18.435348148148147,20.969381875,20.445,13.2775,17.02,13.2775,15.95,6.233271,12.5275,5.292446,17.24742487499998,18.845874749999997,19.52854950000001,20.192123750000015,19.605363339677,20.061439875688464,20.151536538461542,20.683546929704544,19.61952614721854,17.24742487499998,18.845874749999997,19.52854950000001,20.192123750000015,20.0325,6849652,4818349.4,54.3798733000477,0.6916020128898281,1.5,2.75,NaN,NaN,0.4525004547971649,1.421576442754442,532.4873267747456,-0.055879472651316264,0.18160672902605413,0.2374862016773704,30.20245478287886,0.2229102167182747,23.443327389008203,44.37474497093322,32.181927640058575,4968620080
1411651800,20.05,20.0675,19.2275,19.2425,18.465395061728394,20.9933425,20.6175,13.2775,17.02,13.2775,15.95,6.233271,12.5275,5.292446,17.26903737499998,18.87022475,19.520799500000013,20.143748750000015,19.59113340478771,19.983445601813372,20.070382692307696,20.780591485384292,19.3601738992311,17.26903737499998,18.87022475,19.520799500000013,20.143748750000015,19.5125,7332764,5075815.8,41.35235499536092,3.52759633806288,1.5,2.75,NaN,NaN,0.491964708025939,1.4446473806240172,527.3124624500293,-0.11363602536398215,0.09544116997239271,0.20907719533637487,41.77496078181627,-2.9749149123912764,6.976285329325667,70.84213679535314,22.181577875321203,4961287316
1411738200,19.33,19.8275,19.2625,19.6975,18.49544197530864,21.017303125,20.6175,13.2775,17.02,13.2775,15.95,6.233271,12.5275,5.292446,17.29364987499998,18.90337475,19.535449500000013,20.119998750000015,19.59530464381564,19.956212687354956,20.05480576923077,20.78779661505299,19.321814923408553,17.29364987499998,18.90337475,19.535449500000013,20.119998750000015,19.595833333333335,6162308,5163000,47.5692106287041,1.9064564635198362,1.5,2.75,NaN,NaN,0.4986100860240863,1.1935518109626186,531.1476069496973,-0.11674880529322818,0.06314118871983965,0.17988999401306782,43.72416395329161,-0.45483259633607,24.19435287624933,43.453458175276836,32.35218894847383,4967449624
1411997400,19.1825,19.68075,19.13,19.5775,18.525488888888887,21.041263750000002,20.6175,13.2775,17.02,13.2775,15.95,6.233271,12.5275,5.292446,17.320249874999977,18.93254975,19.53644950000001,20.082248750000012,19.594606422489537,19.92014481236877,20.012113461538465,20.785564431247845,19.238662491829086,17.320249874999977,18.93254975,19.53644950000001,20.082248750000012,19.46275,4919772,5231702.2,46.17887986734757,2.3105208759406195,1.5,2.75,NaN,NaN,0.5035307941652232,0.9403769197719243,528.836762948039,-0.12187781255214619,0.02754272832288507,0.14942054087503126,43.83031498657205,-3.261272390364423,21.925961799595147,46.26685744588652,31.807180754518345,4962529852
1412083800,19.6325,19.8025,19.308,19.41,18.555535802469134,21.065224375,20.6175,13.2775,17.02,13.2775,15.95,6.233271,12.5275,5.292446,17.346687374999977,18.96062475,19.53614950000001,20.038123750000015,19.58736695494093,19.87155959214317,19.952305769230772,20.780559819849824,19.12405171861172,17.346687374999977,18.96062475,19.53614950000001,20.038123750000015,19.506833333333333,6757428,5399233.2,44.235398506771936,1.9269834750446444,1.5,2.75,NaN,NaN,0.5028857374391357,1.2515532761207646,525.574135656713,-0.13075523584788312,-0.014023503934822656,0.11673173191306047,41.27972508658058,-4.419549427551401,21.76950350850797,46.468137812610024,31.76235867888201,4955772424
1412170200,19.325,19.3475,18.510025,18.63,18.58558271604938,21.089185,20.6175,13.2775,17.02,13.2775,15.95,6.233271,12.5275,5.292446,17.369324874999975,18.98022475,19.51499950000001,19.956248750000015,19.549823152786384,19.75331582146287,19.859805769230775,20.948548641353312,18.771062897108237,17.369324874999975,18.98022475,19.51499950000001,19.956248750000015,18.829174999999996,9454300,5618541.6,36.526248012845436,5.232899589867498,1.5,2.75,NaN,NaN,0.5312492561934833,1.6826964491995575,520.9420861801917,-0.18030702595495493,-0.1086520505306332,0.07165497542432173,45.89100252564649,-9.63986904328847,3.70327102523175,79.19455716086001,17.10217181390822,4946318124
1412256600,18.5775,18.8375,18.0625,18.6325,18.61562962962963,21.113145625,20.6175,13.2775,17.02,13.2775,15.95,6.233271,12.5275,5.292446,17.39061237499998,18.995124750000002,19.49134950000001,19.880248750000014,19.51384969581437,19.646571457514025,19.77095961538462,21.04204121470473,18.499878016064507,17.39061237499998,18.995124750000002,19.49134950000001,19.880248750000014,18.510833333333334,10017816,5782139,36.56440724888635,5.424181424677918,1.5,2.75,NaN,NaN,0.5486600236082344,1.7325449976211225,522.4075988115693,-0.20240685634624236,-0.18135359500848125,0.02105326133776112,43.81185607243644,-9.474067776023318,23.972566875252106,43.7033897800046,32.32404334474328,4956335940
1412343000,19.0225,19.37,18.845,19.245,18.645676543209877,21.137106250000002,20.6175,13.2775,17.02,13.2775,15.95,6.233271,12.5275,5.292446,17.415749874999975,19.01564975,19.47994950000001,19.820248750000015,19.503306570488316,19.608326556798403,19.694613461538463,20.96366003682114,18.425566886255787,17.415749874999975,19.01564975,19.47994950000001,19.820248750000015,19.153333333333336,8941532,6044794.2,45.248980437394785,1.7077758901275442,1.5,2.75,NaN,NaN,0.5621485933505034,1.4792119804508812,525.3524035589168,-0.16675171949608417,-0.1873863880323441,-0.02063466853625992,50.095298112431806,-4.241821122030099,28.555038796061446,38.38336861254685,33.06159259139171,4965277472
1412602200,19.495,19.5675,18.98025,19.1825,18.675723456790124,21.161066875000003,20.6175,13.2775,17.02,13.2775,15.95,6.233271,12.5275,5.292446,17.436862374999976,19.03787475,19.47269950000001,19.764498750000016,19.490725920665245,19.567771646627126,19.608075000000003,20.851312950180592,18.364837049819414,17.436862374999976,19.03787475,19.47269950000001,19.764498750000016,19.243416666666665,8552804,6257566.4,44.5783274631223,1.174145394648614,1.5,2.75,NaN,NaN,0.5639415509683243,1.3667939664211952,524.9441552684528,-0.13946285144742526,-0.1949632328455415,-0.05550038139811624,48.901751725547754,-2.9101643808229465,25.342976547810654,42.037038001065525,32.61998545112383,4956724668
1412688600,18.875,19.0125,18.295,18.3,18.70577037037037,21.1850275,20.6175,13.2775,17.02,13.2775,15.95,6.233271,12.5275,5.292446,17.453687374999976,19.055974749999997,19.447649500000008,19.684498750000017,19.44403078652151,19.447031489805493,19.42980576923077,20.707100312118175,18.152511226343368,17.453687374999976,19.055974749999997,19.447649500000008,19.684498750000017,18.535833333333333,7886396,6300395.6,36.379293310651256,4.047170691273399,1.5,2.75,NaN,NaN,0.5870528687563011,1.2517302881742856,520.7239033428222,-0.17086094643941493,-0.2690765644473849,-0.09821561800796999,54.4026490164072,-9.55146422834549,24.535603551925085,43.00194456974463,32.46245187833028,4948838272
1412775000,18.32,19.325,18.04,19.26,18.735817283950617,21.208988125,20.6175,13.2775,17.02,13.2775,15.95,6.233271,12.5275,5.292446,17.47408737499998,19.081674749999998,19.44664950000001,19.64087375000002,19.43681389293243,19.429218966966875,19.328075000000002,20.419003391149204,18.2371466088508,17.47408737499998,19.081674749999998,19.44664950000001,19.64087375000002,18.875,10565788,6621390.6,47.657383344793566,2.0722395928038737,1.5,2.75,NaN,NaN,0.6369062352737082,1.595705288855788,525.943330920864,-0.1194234806449059,-0.24749496881410238,-0.12807148816919647,61.9158936677131,0.09094452384046692,54.75362577033575,15.826606401720705,29.41976782794354,4959404060
1412861400,19.1475,19.225,18.0625,18.1,18.765864197530863,21.232948750000002,20.6175,13.2775,17.02,13.2775,15.95,6.233271,12.5275,5.292446,17.48749987499998,19.094124749999995,19.42234950000001,19.536498750000018,19.384389818699788,19.3026266843986,19.174421153846154,20.348124729293446,18.000717578398863,17.48749987499998,19.094124749999995,19.42234950000001,19.536498750000018,18.462500000000002,12361392,7078351,38.72445546888638,4.903021143039648,1.5,2.75,NaN,NaN,0.6769486470398719,1.746366067464018,518.9032670006997,-0.15378398411841193,-0.3203014683172114,-0.16651748419879947,65.38462454156685,-8.11016626475441,23.166511802549728,44.68012470980874,32.153363487641556,4947042668
1412947800,18.085,18.3575,17.4705,17.495,18.79591111111111,21.256909375000003,20.6175,13.2775,17.02,13.2775,15.95,6.233271,12.5275,5.292446,17.497324874999975,19.103749749999995,19.40914950000001,19.41962375000002,19.310296100319405,19.130471762074922,19.000384615384615,20.42153101902912,17.57923821174011,17.497324874999975,19.103749749999995,19.40914950000001,19.41962375000002,17.774333333333335,11338932,7304868.2,35.035879543530825,6.324895563670766,1.5,2.75,NaN,NaN,0.6919523151084526,1.5522432013215515,513.1942747435152,-0.2043504499501975,-0.42195554663654633,-0.21760509668634884,64.19659296149362,-10.637211084152723,5.918116504243257,73.27074004905874,20.811143446698,4935703736
1413207000,17.4725,17.647475,16.585,16.6125,18.825958024691356,21.28087,20.6175,13.2775,17.02,13.2775,15.95,6.233271,12.5275,5.292446,17.501587374999975,19.100424749999995,19.381499500000007,19.26087375000002,19.204500174816683,18.890664927591597,18.721923076923076,20.45306226815187,16.99078388569428,17.501587374999975,19.100424749999995,19.381499500000007,19.26087375000002,16.948325,10701800,7714742.4,30.475798839357637,9.658249502907594,1.5,2.75,NaN,NaN,0.7184182211721345,1.3871882488260399,509.98383385586914,-0.27966736702857964,-0.5671893054720734,-0.2875219384434937,67.92813372606614,-14.412673879443583,5.142829961488433,75.2452741888442,19.61189584966736,4925001936
1413293400,16.875,17.25,16.5125,16.7275,18.856004938271603,21.304830625,20.6175,13.2775,17.02,13.2775,15.95,6.233271,12.5275,5.292446,17.506462374999977,19.096924749999992,19.348449500000008,19.08537375000002,19.107362913059166,18.684649220201923,18.52846153846154,20.525375059239906,16.53154801768317,17.506462374999977,19.096924749999992,19.348449500000008,19.08537375000002,16.830000000000002,13162484,8046444.4,31.722901966158645,8.934187830823124,1.5,2.75,NaN,NaN,0.7197812053741249,1.6358137017637255,513.0252151210183,-0.3022536120453848,-0.6653389535002248,-0.36308534145483995,69.14918675194382,-10.21202361782072,21.414637556904694,46.96747486160161,31.617887581493704,4938164420
1413379800,16,16.467,15.15,16.2775,15.15,21.328791250000002,20.6175,13.2775,17.02,13.2775,15.95,6.233271,12.5275,5.292446,17.509174874999974,19.086749749999992,19.317299500000008,18.883873750000017,18.996387896860767,18.455396913516026,18.265384615384615,20.467506709178767,16.063262521590463,17.509174874999974,19.086749749999992,19.317299500000008,18.883873750000017,15.964833333333331,27269192,9107256.8,29.493482574851058,12.529067332684175,1.5,2.75,NaN,NaN,0.7810468335616874,2.9942267577213806,510.8213224609409,-0.32597336802660193,-0.7705520514880924,-0.44457868346149043,67.68581781587227,-12.639205688984305,3.2756870707678867,80.53181575619955,16.192497173032564,4910895228
1413466200,15.4675,16.64,15.4225,16.280025,15.1022125,21.352751875000003,20.6175,13.2775,17.02,13.2775,15.95,6.233271,12.5275,5.292446,17.510824999999976,19.07357499999999,19.28565000000001,18.66700000000002,18.889863861689758,18.24821863603831,18.01173269230769,20.308483288039426,15.714982096575952,17.510824999999976,19.07357499999999,19.28565000000001,18.66700000000002,16.114175,18260996,9817294.8,29.523411925055385,10.096784785093565,1.5,2.75,NaN,NaN,0.8122220597358527,1.8600843075426439,514.9181241139116,-0.3195381103545255,-0.8440013214046473,-0.5244632110501218,67.68735735455124,-15.406469212782556,18.519769181919724,50.87753439719769,30.602696420882587,4929156224
1413552600,16.8425,17.2125,16.660025,16.8985,15.054425,21.376712500000004,20.6175,13.2775,17.02,13.2775,15.95,6.233271,12.5275,5.292446,17.517767499999977,19.06705999999999,19.27237000000001,18.48280000000002,18.811771161231334,18.11967400403466,17.818540384615382,20.0333776805617,15.603703088669064,17.517767499999977,19.06705999999999,19.27237000000001,18.48280000000002,16.923675,14395492,10301732.8,36.62023677231297,4.361155226274277,1.5,2.75,NaN,NaN,0.8208115554690061,1.39738549615653,516.7080999176382,-0.25450283914729,-0.8425917599842343,-0.5880889208369443,68.95637016869122,-11.906685781311104,38.720114565099884,28.286023787675482,32.99386164722461,4943551716
1413811800,16.78,17.4025,16.765,17.375,15.0066375,21.400673125,20.6175,13.2775,17.02,13.2775,15.95,6.233271,12.5275,5.292446,17.527304999999973,19.06245999999999,19.25652000000001,18.34667500000002,18.755427194124223,18.048752670317075,17.722001923076924,19.89597343237838,15.54803041377547,17.527304999999973,19.06245999999999,19.25652000000001,18.34667500000002,17.180833333333336,8986732,10522459.2,41.507283029727446,2.4009154375223485,1.5,2.75,NaN,NaN,0.8077178729355056,0.8540524443183396,521.4223210194762,-0.16462792047896724,-0.7938738214356533,-0.6292459009566861,72.75278808043022,-5.0546448087431735,56.553155749380885,14.716828413020457,28.730015837598646,4952538448
1413898200,17.7325,18.43,17.69025,18.39,14.95885,21.42463375,20.6175,13.2775,17.02,13.2775,15.95,6.233271,12.5275,5.292446,17.542504999999974,19.067559999999993,19.25772000000001,18.27830125000002,18.741096715923273,18.081252416001163,17.703348076923078,19.849735777623017,15.556960376223136,17.542504999999974,19.067559999999993,19.25772000000001,18.27830125000002,18.170083333333334,10132664,10702512.2,50.29857147177856,3.2282382852516696,1.5,2.75,NaN,NaN,0.8253808820115409,0.9467556598533942,526.4809516236757,-0.029154351456446737,-0.6656888402772445,-0.6365344888207978,77.56596433019305,-4.5171339563862976,55.30854939664204,15.517081098413746,29.1743695049442,4962671112
1413984600,18.5075,18.635,17.9875,18.01,14.9110625,21.448594375000003,20.6175,16.2775,17.02,13.2775,15.95,6.233271,12.5275,5.292446,17.554392499999974,19.067959999999992,19.252570000000006,18.16717625000002,18.7124262564753,18.0744664716201,17.608348076923075,19.57520462994811,15.64149152389804,17.554392499999974,19.067959999999992,19.252570000000006,18.16717625000002,18.210833333333337,8708400,10795449.6,47.42476099694894,2.5374913337976754,1.5,2.75,NaN,NaN,0.8126751047250024,0.8066732116465071,522.9733355120527,0.03883862750645728,-0.5879862044377262,-0.6268248319441835,71.11923506937414,-0.49723756906077266,81.87273831058909,2.8677500374488663,15.259511651962049,4953962712
1414071000,18.54,18.97885,18.4575,18.6375,14.863275,21.472555000000003,20.6175,16.2775,20.6175,13.2775,17.02,6.233271,15.95,5.292446,17.569379999999974,19.07488499999999,19.252370000000006,18.136926250000016,18.70948797190764,18.128088712418183,17.566425,19.41708447518092,15.715765524819076,17.569379999999974,19.07488499999999,19.252370000000006,18.136926250000016,18.691283333333335,9553664,10906494.6,52.273987196291955,4.5901915774687945,1.5,2.75,NaN,NaN,0.8238304543875021,0.8759610076733546,527.8118227657416,0.12517955083392818,-0.4703503934017732,-0.5955299442357014,64.89026067860473,6.530437267790787,79.22097534856405,3.7088250847717577,17.070199566664197,4963516376
1414157400,18.72,19.075,18.515,19.035,14.8154875,21.496515625,20.6175,16.2775,20.6175,13.2775,17.02,6.233271,15.95,5.292446,17.58621749999997,19.084934999999994,19.255420000000004,18.103801250000018,18.72225314947989,18.214461215997403,17.622963461538458,19.600380664571766,15.64554625850515,17.58621749999997,19.084934999999994,19.255420000000004,18.103801250000018,18.875,6223904,10909574.4,55.099213382553074,4.854544497959945,1.5,2.75,NaN,NaN,0.8049854219312519,0.5704992488066262,530.6884049868376,0.20353110416228426,-0.3411160640328461,-0.5446471681951304,61.01572509338723,14.582392776523697,75.50350287195998,5.050180837080605,19.446316290959412,4969740280
1414416600,18.8525,19.25,18.6525,18.972475,14.767700000000001,21.52047625,20.6175,16.2775,20.6175,13.2775,17.02,6.233271,15.95,5.292446,17.602167374999976,19.090534749999996,19.257069500000007,18.07355000000002,18.732065771068914,18.286653004950033,17.600846153846152,19.509773727808334,15.691918579883971,17.602167374999976,19.090534749999996,19.257069500000007,18.07355000000002,18.958325000000002,7811452,11054158.4,54.552182991852575,4.11531691003264,1.5,2.75,NaN,NaN,0.7901650346504482,0.706652801356637,528.6096791950528,0.24294614790552505,-0.24096448331322406,-0.4839106312187491,48.62876655248574,13.420863846958602,50.1967124631529,18.975036749057363,30.82825078778972,4961928828
1414503000,19.185,19.635,19.15,19.6125,14.719912500000001,21.544436875000002,20.6175,16.2775,20.6175,13.2775,17.02,6.233271,15.95,5.292446,17.624329874999976,19.100009749999995,19.262669500000005,18.083675000000017,18.766592603576015,18.412924147335744,17.717192307692308,19.89855656997482,15.535828045409799,17.624329874999976,19.100009749999995,19.262669500000005,18.083675000000017,19.465833333333332,9103988,11171486.4,59.035520351880784,5.585883237204295,1.5,2.75,NaN,NaN,0.7810478893182734,0.8149307687471203,533.7417024157389,0.3001717163441306,-0.10869598578858586,-0.40886770213271645,49.690387334423,20.488404238980195,49.634579357258126,19.382712224893805,30.982708417848055,4971032816
1414589400,19.6725,19.8425,19.150025,19.5475,14.672125000000001,21.568397500000003,20.6175,16.2775,20.6175,13.2775,17.02,6.233271,15.95,5.292446,17.64377987499998,19.10815974999999,19.261119500000007,18.129550000000016,18.797216423043622,18.520978990446626,17.87507692307692,20.257140430550862,15.49301341560298,17.64377987499998,19.10815974999999,19.261119500000007,18.129550000000016,19.513341666666665,8116008,11104571.8,58.40537274144424,4.933511582829719,1.5,2.75,NaN,NaN,0.7747212543669683,0.7308708652773085,531.6012275494859,0.31988351726318115,-0.009013305553740025,-0.3288968228169212,43.61867384064666,20.07045443726285,49.4297422859078,19.532393108064674,31.037864606027515,4962916808
1414675800,19.37,20.08,19.33,19.9325,14.624337500000001,21.592358125000004,20.6175,16.2775,20.6175,13.2775,17.02,6.233271,15.95,5.292446,17.663867374999977,19.120184749999993,19.263819500000007,18.194550000000017,18.841737347630147,18.655409562785042,18.130461538461535,20.625518103691718,15.635404973231354,17.663867374999977,19.120184749999993,19.263819500000007,18.194550000000017,19.780833333333334,7333140,10970338,61.05687358043401,5.51499537369127,1.5,2.75,NaN,NaN,0.7729554504836134,0.6684516010354467,532.9496272744124,0.3430379597633579,0.09990062688727619,-0.2431373328760817,42.061758231586985,17.954256294937437,47.01095465817324,21.346023125445285,31.643022216381485,4970249948
1414762200,20.6375,20.64,20.3275,20.595,14.576550000000001,21.61631875,20.6175,16.2775,20.6175,13.2775,17.02,6.233271,15.95,5.292446,17.687604874999977,19.140609749999992,19.27606950000001,18.262050000000016,18.910492745762298,18.840132461567418,18.427961538461535,21.09902102903073,15.756902047892341,17.687604874999977,19.140609749999992,19.27606950000001,18.262050000000016,20.520833333333332,8760460,10961284.4,65.17123503885296,7.332684046837631,1.5,2.75,NaN,NaN,0.7682800611633552,0.7992183835682614,537.5997215340351,0.3840639379844308,0.2369425896044568,-0.14712134837997398,41.460924163021495,18.53237410071942,51.54442903071967,18.01594455661657,30.43962641266375,4979010408
1415025000,20.675,20.8275,20.4875,20.62,14.528762500000001,21.640279375000002,20.6175,16.2775,20.6175,13.2775,17.02,6.233271,15.95,5.292446,17.712517374999976,19.16543474999999,19.290969500000006,18.333925000000015,18.977532245928483,19.009643655703854,18.761999999999993,21.358879895700277,16.16512010429971,17.712517374999976,19.16543474999999,19.290969500000006,18.333925000000015,20.645,5900380,10828663.2,65.3201326962512,6.811000191684401,1.5,2.75,NaN,NaN,0.7376886282231155,0.5448853557473281,536.5030435034798,0.3925816789090433,0.3436057502563301,-0.04897592865271316,42.37385263492302,12.126155519303973,77.38596852560022,4.360074817805651,18.253956656594127,4984910788
1415111400,20.4725,20.5675,20.1,20.4325,14.480975,21.664240000000003,20.6175,16.2775,20.6175,13.2775,17.02,6.233271,15.95,5.292446,17.735742374999976,19.18665974999999,19.29596950000001,18.440550000000016,19.03458980491168,19.14515378373206,19.081421153846147,21.38334569112478,16.779496616567513,17.735742374999976,19.18665974999999,19.29596950000001,18.440550000000016,20.36666666666667,6554064,10762046.6,63.13991563160253,4.874919135199852,1.5,2.75,NaN,NaN,0.722139440492893,0.6089979205256368,533.8138601112447,0.36582134581268005,0.4083007536131369,0.04247940780045685,36.259682477511554,13.450860632981673,50.430989168365734,18.893808700530773,30.675202131103497,4978356724
1415197800,20.8525,20.87,20.5225,20.795,14.4331875,21.688200625000004,20.6175,16.2775,20.6175,13.2775,17.02,6.233271,15.95,5.292446,17.76064237499998,19.21115974999999,19.30731950000001,18.517300000000017,19.10362549883671,19.302281994805195,19.381151923076914,21.473231538092108,17.28907230806172,17.76064237499998,19.21115974999999,19.30731950000001,18.517300000000017,20.729166666666668,6819452,10574729.8,65.53500806978242,5.455438750796986,1.5,2.75,NaN,NaN,0.7018080518862578,0.6448819146187545,535.954732207689,0.35261815450466244,0.4832521009312849,0.13063394642662246,30.311265986412685,11.576123407109336,79.56666168005283,3.6043503406219637,16.828987979325202,4985176176
1415284200,20.83,21.0775,20.57505,21.05,14.3854,21.71216125,20.6175,16.2775,20.6175,13.2775,17.02,6.233271,15.95,5.292446,17.78875487499998,19.23675974999999,19.324119500000005,18.664800000000017,19.179953910647036,19.46873132863327,19.66384423076922,21.581062147855757,17.746626313682686,17.78875487499998,19.23675974999999,19.324119500000005,18.664800000000017,20.900850000000002,5643280,10238824.2,67.15194282298305,5.611818190045073,1.5,2.75,NaN,NaN,0.6875681910372393,0.5511648495732547,537.9784016706295,0.34094036316786674,0.5568094003864559,0.21586903721858913,27.543657822717627,10.585763068032575,78.64024128279776,3.9174610333769095,17.442297683825323,4990819456
1415370600,21.04,21.175,20.875,21.1,14.3376125,21.736121875000002,20.6175,16.2775,20.6175,13.2775,17.02,6.233271,15.95,5.292446,17.82211737499998,19.25878474999999,19.342669500000007,18.84505000000002,19.255249835719702,19.624090249715817,19.872305769230763,21.779461384695228,17.9651501537663,17.82211737499998,19.25878474999999,19.342669500000007,18.84505000000002,21.05,4432060,9893480.6,67.47416635816732,4.985104939341675,1.5,2.75,NaN,NaN,0.6598847488202937,0.4479778329984293,540.6219798796346,0.3169711389642114,0.6120829609238534,0.295111821959642,27.418726004346823,11.213745175576737,75.07582200750045,5.230912927726664,19.693265064772916,4995251516
1415629800,21.105,21.3125,21.0325,21.3,14.289825,21.760082500000003,20.6175,16.2775,20.6175,13.2775,17.02,6.233271,15.95,5.292446,17.857517374999983,19.28213474999999,19.362019500000006,19.07942500000002,19.335436116671872,19.783700702123834,20.12538269230769,21.84034339800068,18.410421986614697,17.857517374999983,19.28213474999999,19.362019500000006,19.07942500000002,21.215,5717396,9644260.4,68.79286670600285,5.027485329213835,1.5,2.75,NaN,NaN,0.6327501239045584,0.5928288705269716,542.632055510153,0.2954045973345345,0.6643675686278101,0.3689629712932756,26.052716333165893,8.604206500956023,73.67978090507411,5.746070533576232,20.574148561349656,5000968912
1415716200,21.3325,21.4025,21.197525,21.35,14.2420375,21.784043125000004,20.6175,16.2775,20.6175,13.2775,17.02,6.233271,15.95,5.292446,17.891867374999983,19.30480974999999,19.383169500000005,19.310550000000017,19.414438621900427,19.932872063826327,20.334036538461536,21.93003753212512,18.738035544797953,17.891867374999983,19.30480974999999,19.383169500000005,19.310550000000017,21.316675,4769412,9224606.8,69.12982908091793,4.524583675308455,1.5,2.75,NaN,NaN,0.6021947579113757,0.5170314684849223,543.3453380136708,0.26622862793959656,0.7017487562177713,0.43552012827817477,22.466185571541068,9.221128021486134,100,0,0,5005738324
1415802600,21.09,21.375,21.0875,21.295,14.19425,21.80800375,20.6175,16.2775,20.6175,13.2775,17.02,6.233271,15.95,5.292446,17.92810487499998,19.32705974999999,19.403719500000005,19.56142500000002,19.48818612692394,20.062598533938104,20.50788269230769,21.98816591330923,19.027599471306146,17.92810487499998,19.32705974999999,19.403719500000005,19.56142500000002,21.2525,5037312,8113012.8,68.25675610129967,3.8621004866274773,1.5,2.75,NaN,NaN,0.5797165609177062,0.6208928944374401,544.7006817050418,0.22650502557075314,0.7186514102416162,0.492146384670863,22.327747733449616,6.835570048915091,76.69704083460691,4.574198500039308,18.728760665353786,5000701012
1415889000,21.3575,21.56,21.0525,21.3525,14.1464625,21.831964375000002,20.6175,16.2775,20.6175,13.2775,17.02,6.233271,15.95,5.292446,17.96232987499998,19.35335974999999,19.427719500000002,19.81504875000002,19.561296474887705,20.185446292610667,20.69096153846154,21.936469680765065,19.445453396158015,17.96232987499998,19.35335974999999,19.427719500000002,19.81504875000002,21.321666666666665,5433824,7471654.2,68.70179132393048,3.3356335749135484,1.5,2.75,NaN,NaN,0.57455823513787,0.7272584965187495,541.8874476738447,0.18891598448074176,0.7282913652717902,0.5393753807910484,21.379400982911555,3.678077203204663,76.56064041931862,4.624551093934837,18.81480848674654,5006134836
1415975400,21.3275,21.445,21.215,21.365,14.098675,21.855925000000003,20.6175,16.2775,20.6175,13.2775,17.02,6.233271,15.95,5.292446,17.997992374999978,19.377384749999987,19.446119500000002,20.03837375000002,19.632029946460737,20.297784740933462,20.825769230769232,21.948498365538242,19.703040096000223,17.997992374999978,19.377384749999987,19.446119500000002,20.03837375000002,21.341666666666665,4043000,6954029.6,68.8041833859756,2.9220779119167912,1.5,2.75,NaN,NaN,0.5499469326280221,0.5813895298921362,543.0037055947714,0.15133295207966013,0.7285415708906235,0.5772086188109634,13.808353890003133,3.612997090203673,76.20134710293902,4.758380748712909,19.040272148348063,5010177836
1416234600,21.2375,21.4725,21.19075,21.4075,14.050887500000002,21.879885625000004,20.6175,16.2775,20.6175,13.2775,17.02,6.233271,15.95,5.292446,18.038642374999977,19.40218474999999,19.468319500000003,20.23999875000002,19.70165622307012,20.403471908463608,20.968846153846155,21.852023580450744,20.085668727241565,18.038642374999977,19.40218474999999,19.468319500000003,20.23999875000002,21.356916666666667,4699276,6739656.8,69.17344603960811,2.7866380168478946,1.5,2.75,NaN,NaN,0.5307900088688775,0.6972574627242147,540.8823852512118,0.11729346197510371,0.723825446279843,0.6065319843047393,13.765129903534872,4.771809617031679,75.35020812887603,5.085641386971339,19.56415048415264,5014877112
1416321000,21.435,21.8925,21.435,21.7825,14.0031,21.903846250000004,20.6175,16.2775,20.6175,13.2775,17.02,6.233271,15.95,5.292446,18.079779874999975,19.42978474999999,19.505969500000003,20.40962375000002,19.78325793981247,20.53480791718136,21.11115384615385,21.867614774487016,20.354692917820685,18.079779874999975,19.42978474999999,19.505969500000003,20.40962375000002,21.703333333333333,4104516,6438249.4,72.2901801305528,3.991205751560371,1.5,2.75,NaN,NaN,0.5275192939496719,0.6375205036325557,543.8442642616926,0.10821143954456303,0.741796283735443,0.63358484419088,13.074954408284224,4.748737677326266,74.64388213475507,5.361933037940988,19.994184827303936,5018981628
1416407400,21.715,21.78,21.3875,21.6675,13.955312500000002,21.927806875,20.6175,16.2775,20.6175,16.2775,17.02,13.2775,15.95,6.233271,18.12065487499998,19.456359749999987,19.536669500000002,20.592498750000022,19.857149785310018,20.64268335364028,21.19365384615385,21.9408295936411,20.4464780986666,18.12065487499998,19.456359749999987,19.536669500000002,20.592498750000022,21.611666666666668,4393092,6222484,69.95435261183654,2.642198837949041,1.5,2.75,NaN,NaN,0.5180536300961239,0.7060029403048687,540.9109392533794,0.0837310779384366,0.7382486916139257,0.6545176136754891,12.492168986482296,2.933491686460806,77.26460788802477,4.370317497351348,18.36507461462387,5014588536
1416493800,21.365,21.8275,21.35,21.79,13.907525000000001,21.951767500000003,20.6175,16.2775,20.6175,16.2775,17.02,13.2775,15.95,6.233271,18.159492374999978,19.480334749999987,19.5687195,20.75012375000002,19.93294783294492,20.751951605674538,21.28365384615385,22.01443481771945,20.55287287458825,18.159492374999978,19.480334749999987,19.5687195,20.75012375000002,21.65583333333333,3308236,5910212.6,71.02824126916356,2.739182769460482,1.5,2.75,NaN,NaN,0.5151569422321151,0.5597490689252025,543.673693766542,0.06584849175275043,0.7368282283664271,0.6709797366136767,11.468340419679235,3.270142180094776,74.66097016144268,5.3551704705406005,19.983859368016706,5017896772
1416580200,22.4425,22.4675,21.9225,22.1475,13.859737500000001,21.975728125000003,20.6175,16.2775,20.6175,16.2775,17.02,13.2775,15.95,6.233271,18.197404874999975,19.507409749999987,19.615019500000002,20.905748750000022,20.019793015966687,20.884860976562678,21.415576923076927,22.10196141346045,20.729192432693402,18.197404874999975,19.507409749999987,19.615019500000002,20.905748750000022,22.179166666666664,7063340,5952184.4,73.95402941342192,3.9615851658295473,1.5,2.75,NaN,NaN,0.5267528749298213,1.1866803051330197,546.9984138210518,0.06788576706253835,0.7558369454418497,0.6879511783793113,13.565238106469073,3.9788732394366204,78.58040203423188,3.9073215978374045,17.512276367930703,5024960112
1416839400,22.3,22.3725,22.21755,22.325,13.811950000000001,21.999688750000004,20.6175,16.2775,20.6175,16.2775,17.02,13.2775,15.95,6.233271,18.235892374999978,19.53340974999999,19.665769500000003,21.07337500000002,20.110193289850347,21.0220170740329,21.533269230769232,22.27603274167704,20.790505719861425,18.235892374999978,19.53340974999999,19.665769500000003,21.07337500000002,22.305016666666663,8334344,5978329,75.28839829695401,3.839045985781,1.5,2.75,NaN,NaN,0.5051990981491196,1.3940925633232966,549.2958604188132,0.07065972342546734,0.7762758326611454,0.7056161092356781,13.410643869845106,4.566744730679146,82.53426474996289,2.6710620816618538,14.794673168375255,5033294456
1416925800,22.42,22.5,22.185,22.285,13.764162500000001,22.023649375,20.6175,16.2775,20.6175,16.2775,17.02,13.2775,15.95,6.233271,18.271767374999975,19.56090974999999,19.706719500000005,21.207000000000022,20.195479827503274,21.142301162220242,21.62826923076923,22.414152821227436,20.842385640311026,18.271767374999975,19.56090974999999,19.706719500000005,21.207000000000022,22.323333333333334,8815352,5963897.2,74.3638206862012,3.4673454640903247,1.5,2.75,NaN,NaN,0.4916134482813254,1.4781193746934471,550.7187413568872,0.05970861214131218,0.7802518744123184,0.7205432622710062,13.877503296833115,4.64897863348203,47.245741065370794,21.210933984857522,31.543324949771677,5024479104
1417012200,22.3275,22.485,22.2475,22.445,13.716375000000001,22.047610000000002,20.6175,16.2775,20.6175,16.2775,17.02,13.2775,15.95,6.233271,18.308204874999976,19.593784749999987,19.749469500000004,21.35187500000002,20.283696304856086,21.266367718199266,21.73173076923077,22.564902153888823,20.898559384572714,18.308204874999976,19.593784749999987,19.749469500000004,21.35187500000002,22.392500000000002,2821880,5699190.8,75.65185059371787,3.1434914522138215,1.5,2.75,NaN,NaN,0.47346248768980226,0.49513695874158137,553.0615434835106,0.053356414462733204,0.7872387803494227,0.7338823658866895,13.22588406620445,5.116496897318821,64.79092096223238,9.932133521394853,25.276945516372763,5027300984
1417185000,22.3925,22.507525,22.205,22.305,13.668587500000001,22.071570625000003,20.6175,16.2775,20.6175,16.2775,17.02,13.2775,15.95,6.233271,18.342854874999976,19.62290974999999,19.783219500000005,21.470500000000023,20.362963116430358,21.365285078370764,21.80903846153846,22.65404537653415,20.96403154654277,18.342854874999976,19.62290974999999,19.783219500000005,21.470500000000023,22.339175,2486124,5456840,72.2320910479934,2.5054835529736272,1.5,2.75,NaN,NaN,0.46125266714053087,0.4555977452151795,550.119576044229,0.030952810228433103,0.7725733786722309,0.7416205684437978,14.765182194394875,4.399719166861696,51.58205110936549,18.03030298265499,30.387645907979522,5024814860
1417444200,22.04,22.076725,21.709825,21.825,13.620800000000001,22.095531250000004,20.6175,16.2775,20.6175,16.2775,17.02,13.2775,15.95,6.233271,18.373867374999975,19.64955974999999,19.808069500000006,21.53200000000002,20.420297896178187,21.40906745185926,21.84557692307692,22.648035054853548,21.04311879130029,18.373867374999975,19.64955974999999,19.808069500000006,21.53200000000002,21.870516666666663,4555120,5246573,61.900482689578794,0.4762621966872848,1.5,2.75,NaN,NaN,0.4708185480590644,0.8682086382863633,544.9397334567782,-0.02210562412703454,0.7139885382850046,0.7360941624120392,21.0614614859684,1.950251080228894,22.186198015836762,45.917447355416996,31.89635462874624,5020259740
1417530600,21.8425,22.325,21.84,22.2425,13.5730125,22.119491875000005,20.6175,16.2775,20.6175,16.2775,17.02,13.2775,15.95,6.233271,18.406692374999974,19.679434749999988,19.850969500000005,21.61312500000002,20.491756802210414,21.48844198025362,21.918461538461536,22.678655183987612,21.15826789293546,18.406692374999974,19.679434749999988,19.850969500000005,21.61312500000002,22.135833333333334,2600368,5081572.4,66.4019284721356,1.7352659511117812,1.5,2.75,NaN,NaN,0.472902937483417,0.5117250715546234,548.3597669673571,-0.03426976485063604,0.6932569563487441,0.7275267211993801,23.158634594061883,2.111786984964999,7.857823999295287,68.89108199974908,23.251094000955643,5022860108
1417617000,22.3,22.585,22.26,22.5,13.525225,22.143452500000002,20.6175,16.2775,20.6175,16.2775,17.02,13.2775,15.95,6.233271,18.442317374999973,19.709084749999988,19.905820000000006,21.71650000000002,20.57051143741785,21.584780839277084,22.006730769230764,22.749851487800004,21.263610050661523,18.442317374999973,19.709084749999988,19.905820000000006,21.71650000000002,22.448333333333334,4533772,4980557.8,68.84671965349581,2.4190649465944287,1.5,2.75,NaN,NaN,0.4635884419488873,0.9102940236934908,550.4817107702523,-0.030297208707552925,0.6896552103149389,0.7199524190224919,22.129488368754963,3.84215991692627,45.24062838904687,22.720206441391817,32.03916516956131,5027393880
1417703400,22.395,22.625,22.1225,22.415,13.4774375,22.167413125000003,20.6175,16.2775,20.6175,16.2775,17.02,13.2775,15.95,6.233271,18.476217374999973,19.73900974999999,19.949470000000005,21.79750000000002,20.64284432222499,21.663849330774504,22.087499999999995,22.75884766872887,21.41615233127112,18.476217374999973,19.73900974999999,19.949470000000005,21.79750000000002,22.3875,5350400,4907105.2,67.11073535310271,1.7606359862504906,1.5,2.75,NaN,NaN,0.46636783895253836,1.0903373337094953,547.2990370884706,-0.0382072279359742,0.672193384102524,0.7104006120384982,21.93316348729018,2.8682882055988985,17.132096491242,52.80917058816619,30.058732920591815,5022043480
1417789800,22.4975,22.6925,22.4,22.535,13.42965,22.191373750000004,20.6175,16.2775,20.6175,16.2775,17.02,13.2775,15.95,6.233271,18.51094237499997,19.76805974999999,20.015320000000006,21.871750000000024,20.71704650566715,21.746816061176933,22.174230769230768,22.757290947598005,21.59117059086353,18.51094237499997,19.76805974999999,20.015320000000006,21.871750000000024,22.5425,3881964,4819039.4,68.32503451446537,2.0239199191722337,1.5,2.75,NaN,NaN,0.4539487075987857,0.8055472632159845,548.6901032030263,-0.039980655841253765,0.6604247922369311,0.7004054480781848,21.922673570239514,1.7496331414380824,36.690941248237735,30.099169698154725,33.20988905360753,5025925444
1418049000,22.39,22.5775,21.8675,22.0825,13.3818625,22.215334375000005,20.6175,16.2775,20.6175,16.2775,17.02,13.2775,15.95,6.233271,18.54231737499997,19.79923474999999,20.063020000000005,21.92087500000002,20.77059370152334,21.77878596011246,22.19730769230769,22.738788786297064,21.655826598318313,18.54231737499997,19.79923474999999,20.063020000000005,21.92087500000002,22.175833333333333,4392004,4817036.6,59.416600764207935,0.446103221344324,1.5,2.75,NaN,NaN,0.4722380856274439,0.9117647144304447,544.7104675413105,-0.07425930970317052,0.6075813109492216,0.6818406206523921,23.980373525366094,-1.0862262038073895,37.478292423903234,29.356227493157657,33.16548008293912,5021533440
1418135400,21.3575,22.0775,21.2125,22.025,13.334075,22.239295000000002,20.6175,16.2775,20.6175,16.2775,17.02,13.2775,15.95,6.233271,18.573392374999973,19.82420974999999,20.111970000000007,21.95712500000002,20.81978610538517,21.802234916292228,22.224807692307685,22.686266339252604,21.763349045362766,18.573392374999973,19.82420974999999,20.111970000000007,21.95712500000002,21.771666666666665,10628596,5062596.6,58.37504466778445,1.3870212974177683,1.5,2.75,NaN,NaN,0.5006496509397694,2.0994356927431275,547.464026974524,-0.10173743658969647,0.5546688249152716,0.6564062615049681,23.407610335139903,-1.166704061027604,10.904670556691181,62.90728775861176,26.18804168469705,5010904844
1418221800,21.85,21.8725,20.9075,20.9825,13.2862875,22.263255625000003,20.6175,16.2775,20.6175,16.2775,17.02,13.2775,15.95,6.233271,18.599192374999973,19.839784749999993,20.143420000000006,21.93875000000002,20.82616704242889,21.724164924264397,22.1626923076923,22.946407477543964,21.378977137840636,18.599192374999973,19.839784749999993,20.143420000000006,21.93875000000002,21.254166666666666,8655732,5256912.6,43.4898204679454,3.6809883354729913,1.5,2.75,NaN,NaN,0.5447103901583573,1.6465428776578863,541.8501490813026,-0.18614119476234992,0.42372976805203066,0.6098709628143806,35.76635334391109,-6.515927823568717,1.6246242159506235,86.52087726982231,11.854498514227073,5002249112
1418308200,21.2075,21.9075,21.145,21.28,13.238500000000002,22.287216250000004,20.6175,16.2775,20.6175,16.2775,17.02,13.2775,15.95,6.233271,18.625204874999973,19.855709749999992,20.19642000000001,21.93800000000002,20.84396441331403,21.681863502905884,22.09596153846153,23.01032667858196,21.1815963983411,18.625204874999973,19.855709749999992,20.19642000000001,21.93800000000002,21.444166666666664,7442844,5377189.2,47.59644059004342,1.809548603705589,1.5,2.75,NaN,NaN,0.5718739337184744,1.384151407579261,544.4022380089727,-0.21586032836737024,0.34004555235516776,0.555905880722538,36.89978415048681,-4.595382201300151,13.27625761285213,58.78965125513628,27.934091132011588,5009691956
1418394600,20.815,21.17,20.245,20.245,13.1907125,22.311176875000005,22.535,16.2775,20.6175,16.2775,17.02,13.2775,15.95,6.233271,18.645442374999973,19.86000974999999,20.228670000000008,21.88262500000002,20.82047561279191,21.54501935977199,21.93596153846153,23.267011642213536,20.604911434709525,18.645442374999973,19.86000974999999,20.228670000000008,21.88262500000002,20.553333333333338,7490252,5480010.6,37.41071603892673,5.1844182506283145,1.5,2.75,NaN,NaN,0.6049543670242976,1.366831662697879,539.0629556126262,-0.2942913203031455,0.18804173034360616,0.48233305064675164,44.89594500256826,-7.239404352806407,4.319933311740368,77.39708246532393,18.28298422293569,5002201704
1418653800,20.595,20.75,19.6075,19.83,13.142925000000002,22.335137500000002,22.535,16.2775,20.6175,16.2775,17.02,13.2775,15.95,6.233271,18.66539237499997,19.86015974999999,20.24037000000001,21.805875000000018,20.781633431898108,21.38168418265085,21.747115384615373,23.46647444023179,20.027756328998958,18.66539237499997,19.86015974999999,20.24037000000001,21.805875000000018,20.0625,7933868,5674554,34.24610015051988,6.958265178022168,1.5,2.75,NaN,NaN,0.643350483665419,1.3981482950025677,534.84543264292,-0.3589047781218428,0.03370207799444813,0.3926068561162909,44.79752907203815,-10.846352703158374,3.580531628162808,79.5636241923759,16.8558441794613,4994267836
1418740200,19.55,20.699975,19.34,19.3575,19.34,22.359098125000003,22.535,16.2775,20.6175,16.2775,17.02,13.2775,15.95,6.233271,18.679442374999972,19.85828474999999,20.24387000000001,21.703375000000015,20.72578506201975,21.188904736684105,21.509615384615376,23.592333510742723,19.42689725848803,18.679442374999972,19.85828474999999,20.24387000000001,21.703375000000015,19.799158333333335,10262056,5952693,31.027881769804694,6.539554490127597,1.5,2.75,NaN,NaN,0.6945379491178889,1.72393503242986,532.8267697191013,-0.41432202809974356,-0.12529567900838856,0.289026349091355,41.460706304251275,-13.96666666666666,3.909631302689041,78.58550992053247,17.50485877677848,4984005780
1418826600,19.515,20.6475,19.47,20.4925,19.437441860465118,22.383058750000004,22.535,16.2775,20.6175,16.2775,17.02,13.2775,15.95,6.233271,18.699242374999972,19.867684749999988,20.287720000000007,21.63887500000002,20.716636628215053,21.122580476047524,21.3701923076923,23.463901255890043,19.276483359494556,18.699242374999972,19.867684749999988,20.287720000000007,21.63887500000002,20.203333333333333,8040344,6149484.4,44.515987996653394,3.8059096388751046,1.5,2.75,NaN,NaN,0.7370709527523254,1.3074826240717026,539.5819642434082,-0.35753899104901754,-0.15789738971991696,0.19964160132910058,56.93245469824985,-8.576845862145882,19.101027341633568,50.02777767961862,30.871194978747816,4992046124
1418913000,21.41,22.0275,21.1475,21.995,19.53488372093023,22.407019375000004,22.535,16.2775,20.6175,16.2775,17.02,13.2775,15.95,6.233271,18.725829874999974,19.894534749999988,20.342420000000008,21.655250000000017,20.766768525147796,21.205668049757286,21.383269230769223,23.490258866587062,19.276279594951383,18.725829874999974,19.894534749999988,20.342420000000008,21.655250000000017,21.723333333333333,9425180,6401088.8,56.612177258496565,2.7076135075208336,1.5,2.75,NaN,NaN,0.7940658846985879,1.4724338771866436,545.101050894324,-0.20913975326494852,-0.06178309025208506,0.14735666301286346,73.2745559029585,-2.396272465054356,22.83455213041937,45.1127074159324,32.05274045364823,5001471304
1418999400,22.25,22.554975,22.01,22.2775,19.63232558139535,22.430980000000005,22.535,16.2775,20.6175,16.2775,17.02,13.2775,15.95,6.233271,18.75380487499997,19.924159749999987,20.425970000000003,21.679625000000016,20.826012896710626,21.307747283113734,21.38596153846153,23.497420693480542,19.274502383442517,18.75380487499997,19.924159749999987,20.425970000000003,21.679625000000016,22.280825000000004,5274296,6499391.8,58.446504977797154,4.792030690104285,1.5,2.75,NaN,NaN,0.7773451072201171,0.8115060858463711,548.4912825805183,-0.08847746707996501,0.03675982916290721,0.12523729624287222,73.6643809763627,0.883052190648705,43.30318489574548,24.300885739220423,32.39592936503409,5006745600
1419258600,22.3825,22.5975,22.286175,22.5875,19.729767441860464,22.454940625000003,22.535,16.2775,20.6175,16.2775,17.02,13.2775,15.95,6.233271,18.783417374999974,19.968484749999988,20.527820000000006,21.701625000000014,20.895090822329816,21.429628494245758,21.392692307692297,23.51882048019676,19.266564135187835,18.783417374999974,19.968484749999988,20.527820000000006,21.701625000000014,22.490391666666667,3778384,6335144,60.42379833409516,4.567303443599897,1.5,2.75,NaN,NaN,0.7446775995615373,0.5964164350486745,551.0345785582565,0.010431162569580044,0.1382762494548473,0.12784508688526725,73.02142326519535,2.5539160045402953,68.49295568173378,8.04117006525531,23.4658742530109,5010523984
1419345000,22.84,22.84925,22.615125,22.6825,19.82720930232558,22.478901250000003,22.535,16.2775,20.6175,16.2775,17.02,13.2775,15.95,6.233271,18.814729874999973,20.015359749999988,20.649220000000003,21.719500000000018,20.96518529988551,21.548949590031878,21.413269230769217,23.58329970256465,19.243238758973785,18.814729874999973,20.015359749999988,20.649220000000003,21.719500000000018,22.715625000000003,4460720,6141462.8,61.03569360121072,4.9336201447691925,1.5,2.75,NaN,NaN,0.7101827710214277,0.7263285873847514,554.7866613132074,0.07677549548578386,0.22381445624249707,0.14703896075671322,72.95995722416444,8.101989753365897,99.99999999999999,0,0,5014984704
1419431400,22.795,22.88,22.6825,22.7075,19.9246511627907,22.502861875000004,22.535,16.2775,20.6175,16.2775,17.02,13.2775,15.95,6.233271,18.846117374999974,20.05863474999999,20.768820000000005,21.740625000000016,21.033511366556667,21.659287724314556,21.426538461538446,23.62575645057764,19.22732047249925,18.846117374999974,20.05863474999999,20.768820000000005,21.740625000000016,22.756666666666664,1291612,5765275.8,61.20567923653553,4.269637791912902,1.5,2.75,NaN,NaN,0.6735625730913256,0.2240329942237976,554.6199946465408,0.11458905517297663,0.290275279722934,0.17568622454995736,65.33873414805694,6.708176691729315,99.99999999999999,0,0,5016276316
1419604200,22.8725,23.045,22.848675,22.91,20.022093023255813,22.526822500000005,22.535,16.2775,20.6175,16.2775,17.02,13.2775,15.95,6.233271,18.881167374999972,20.10938474999999,20.901470000000007,21.763875000000017,21.107099156103462,21.77840317914174,21.490192307692293,23.80645709056551,19.173927524819078,18.881167374999972,20.10938474999999,20.901470000000007,21.763875000000017,22.93455833333333,2223324,5735348,62.627885686215954,4.495277555386281,1.5,2.75,NaN,NaN,0.6495581035848026,0.38765285035886227,557.8906168651667,0.14360429334232,0.3551915912278574,0.21158729788553737,65.22713712413932,13.163744134354156,99.99999999999999,0,0,5018499640
1419863400,22.825,23.075,22.815025,22.995,20.11953488372093,23.075,22.535,16.2775,20.6175,16.2775,17.02,13.2775,15.95,6.233271,18.917504874999974,20.160709749999988,21.035769500000004,21.798375000000014,21.18113448331509,21.894269543033005,21.56480769230768,24.004389514558294,19.12522587005707,18.917504874999974,20.160709749999988,21.035769500000004,21.798375000000014,22.961675,2677492,5744916.4,63.23711757626645,3.9687604589006096,1.5,2.75,NaN,NaN,0.621730739043031,0.46606283078375166,560.285787444742,0.15775800857458006,0.40878480860376243,0.2510268000291824,54.3956546004223,15.960665658093813,99.99999999999999,0,0,5021177132
1419949800,22.815,22.8825,22.595,22.625,20.216976744186045,23.106557971014492,22.535,16.2775,20.6175,16.2775,17.02,13.2775,15.95,6.233271,18.949829874999974,20.21133474999999,21.150299500000006,21.838375000000017,21.237756660439988,21.963862919887003,21.691153846153835,24.166880324913784,19.215427367393886,18.949829874999974,20.21133474999999,21.150299500000006,21.838375000000017,22.700833333333332,3138384,5674079.6,58.747668238380086,2.297678126243875,1.5,2.75,NaN,NaN,0.605892829111386,0.5531089130297009,557.7564721426423,0.1324582485552963,0.41659961072330276,0.28414136216800645,53.44026486376995,16.879762366008,74.59683152657534,5.442750821697966,19.960417651726694,5018038748
1420036200,22.75,22.8167,21.91,21.93,20.314418604651163,23.138115942028985,22.535,16.2775,20.6175,16.2775,17.02,13.2775,15.95,6.233271,18.976917374999974,20.248959749999987,21.241399500000007,21.822750000000017,21.264903458069792,21.960637879897764,21.741153846153836,24.207884487949084,19.274423204358587,18.976917374999974,20.248959749999987,21.241399500000007,21.822750000000017,22.2189,4766072,5782364.8,51.37030871562188,0.3980678118790616,1.5,2.75,NaN,NaN,0.6273790556034299,0.8242427042998048,554.3892732817175,0.06271342993251017,0.36253314958364413,0.29981971965113396,55.364655069343605,7.014761498109064,29.051505409195112,38.02430092569141,32.924193665113464,5013272676
1420209000,22.2175,22.3825,21.515,21.91,20.411860465116277,23.16967391304348,22.535,16.2775,20.6175,16.2775,17.02,13.2775,15.95,6.233271,19.005254874999974,20.28475974999999,21.311799500000006,21.793250000000018,21.2902013616749,21.955815224669404,21.86923076923076,24.179892000446575,19.558569538014947,19.005254874999974,20.28475974999999,21.311799500000006,21.793250000000018,21.935833333333335,4748964,5793124.4,51.17116550793552,1.3121050860188432,1.5,2.75,NaN,NaN,0.6445305516317562,0.8197586780632572,556.5158639945021,0.01170143474546037,0.31444651308295946,0.3027450783374991,47.80712140145762,-0.3864514662423317,11.69155360010305,61.70204700091856,26.60639939897838,5008523712
1420468200,21.5075,21.581,20.615,20.735,20.509302325581395,23.20123188405797,22.535,16.2775,20.6175,16.2775,17.02,13.2775,15.95,6.233271,19.026292374999972,20.30943474999999,21.366299500000004,21.70925000000002,21.268428759256278,21.83954710803422,21.93884615384615,24.045047268672242,19.832645039020058,19.026292374999972,20.30943474999999,21.366299500000004,21.70925000000002,20.977,7138500,5882529.4,41.09239920293167,5.550613390221355,1.5,2.75,NaN,NaN,0.6909926550866309,1.213508597169102,551.4277514870108,-0.0986311281922817,0.17945616809714693,0.27808729628942863,40.042249950840954,-6.924026484120752,1.628285227414309,86.54307792046225,11.82863685212344,5001385212
1420554600,20.86,21.0375,19.850025,20.1625,20.606744186046512,23.23278985507246,22.995,16.2775,20.6175,16.2775,17.02,13.2775,15.95,6.233271,19.045454874999972,20.32458474999999,21.3967995,21.590625000000017,21.225059003991326,21.679828335840487,22.000769230769226,23.828712994227736,20.172825467310716,19.045454874999972,20.32458474999999,21.3967995,21.590625000000017,20.35000833333333,9798372,6178349.8,37.24335281200234,6.688316988400053,1.5,2.75,NaN,NaN,0.7264556797233003,1.5859205640962577,548.4682547916832,-0.20168591575835312,0.02597990159148722,0.22766581734984034,39.92357278294504,-10.73602656336468,0,99.99999999999999,0,4991586840
1420641000,20.645,21.0125,20.46,20.9125,20.704186046511627,23.264347826086954,22.995,16.2775,20.6175,16.2775,17.02,13.2775,15.95,6.233271,19.06939237499997,20.34488474999999,21.4343495,21.53212500000002,21.21280178814853,21.606749446712822,22.03307692307692,23.765604149909436,20.300549696244403,19.06939237499997,20.34488474999999,21.4343495,21.53212500000002,20.794999999999998,7011632,6309331.2,44.56853542820166,3.6442964234508213,1.5,2.75,NaN,NaN,0.7352802740287787,1.111311449302265,553.3152082416844,-0.20991828906348864,-0.034732043979520455,0.17518624508396818,46.44964132783543,-7.803372644108892,4.832883255885718,76.0623667616286,19.10474998248568,4998598472
1420727400,21.435,22.09,21.415,22.025,20.801627906976744,23.295905797101447,22.995,16.2775,20.6175,16.2775,17.02,13.2775,15.95,6.233271,19.097692374999973,20.376234749999988,21.4954,21.53212500000002,21.244652698417212,21.646582832740172,22.035384615384608,23.767782737768105,20.30298649300111,19.097692374999973,20.376234749999988,21.4954,21.53212500000002,21.843333333333334,7421308,6148966.8,53.27989555194933,1.6591719134036855,1.5,2.75,NaN,NaN,0.7668673973124372,1.2069195104452346,558.73285322756,-0.1346739061365077,0.006843862413333568,0.14151776854984127,57.591697863814666,-3.0056148849499107,20.688427315685267,47.932937477507046,31.378635206807687,5006019780
1420813800,22.1625,22.167475,21.235,21.465,20.89906976744186,23.32746376811594,22.995,16.2775,20.6175,16.2775,17.02,13.2775,15.95,6.233271,19.125029874999974,20.397559749999985,21.532449999999997,21.556250000000016,21.25329376906752,21.62928922962206,21.972884615384608,23.724354158976553,20.221415071792663,19.125029874999974,20.397559749999985,21.532449999999997,21.556250000000016,21.622491666666665,8157812,6124070.8,49.097175366438144,0.30533732669537694,1.5,2.75,NaN,NaN,0.7786965117901203,1.332089759641577,555.665773713725,-0.11748043816645741,-0.005332779158230494,0.11214765900822692,58.944620064935094,-6.307289393278046,17.05467143956302,52.99011616173074,29.95521239870623,4997861968
1421073000,21.515,21.5825,20.7475,20.9625,20.996511627906976,23.359021739130434,22.995,16.2775,20.6175,16.2775,17.02,13.2775,15.95,6.233271,19.150242374999976,20.41093474999999,21.560750000000002,21.54037500000002,21.241890091849186,21.56578549346758,21.847884615384608,23.63758575733954,20.058183473429676,19.150242374999976,20.41093474999999,21.560750000000002,21.54037500000002,21.0975,7129456,6108401.4,45.63516921554952,2.755062615247297,1.5,2.75,NaN,NaN,0.7827181895193975,1.1671557799066707,552.8143819864085,-0.13363619170820373,-0.054897580627027764,0.07873861108117597,58.974796190757246,-8.838878016960217,18.16797571950481,51.30250698168224,30.52951729881295,4990732512
1421159400,21.43,21.835,20.31,20.775,21.093953488372094,23.390579710144927,22.995,16.2775,20.6175,16.2775,17.02,13.2775,15.95,6.233271,19.173467374999976,20.42070974999999,21.577600000000007,21.566875000000017,21.223580676482552,21.49047258932781,21.701153846153836,23.505802347391057,19.896505344916616,19.173467374999976,20.42070974999999,21.577600000000007,21.566875000000017,20.973333333333333,10916472,6279712.4,44.37773197010594,3.281484841857804,1.5,2.75,NaN,NaN,0.8357383188394406,1.7383713305087027,551.6356226028995,-0.14944053189969225,-0.10806205379343936,0.0413784781062529,58.43222628497868,-8.176795580110504,16.882518495722614,53.15982904571353,29.957652458563846,4979816040
1421245800,20.0275,20.475,19.7075,20.405,21.191395348837208,23.42213768115942,22.995,16.2775,20.6175,16.2775,17.02,13.2775,15.95,6.233271,19.192842374999977,20.424934749999988,21.573800000000006,21.595625000000016,21.191479473483238,21.387094247487063,21.524038461538453,23.35067317562286,19.697403747454047,19.192842374999977,20.424934749999988,21.573800000000006,21.595625000000016,20.195833333333336,11448456,6455441.8,41.922892862038196,5.225716301315243,1.5,2.75,NaN,NaN,0.8522927246366233,1.773458169818834,549.044138573683,-0.17550224182878912,-0.17799932417973352,-0.0024970823509443893,58.50708143264457,-6.953944368445046,3.4767942640399703,79.86024438679374,16.662961349166288,4968367584
1421332200,20.6375,20.7625,19.8125,19.855,21.288837209302326,23.453695652173913,22.995,16.2775,20.6175,16.2775,17.02,13.2775,15.95,6.233271,19.207854874999974,20.42473474999999,21.55850000000001,21.620500000000014,21.139068513738795,21.241180509631153,21.289038461538453,23.128001943065623,19.450074980011284,19.207854874999974,20.42473474999999,21.55850000000001,21.620500000000014,20.143333333333334,11251060,6504892,38.51249365123009,5.2315729351438485,1.5,2.75,NaN,NaN,0.8592718157340072,1.7296305611223062,547.1026878868946,-0.21771404886932638,-0.2746396434376024,-0.056925594568276,58.04272595792665,-9.379278868096758,0,100,0,4957116524
1421418600,19.77,20.6825,19.697525,20.600025,21.38627906976744,23.485253623188406,22.995,16.2775,20.6175,16.2775,17.02,13.2775,15.95,6.233271,19.225754999999978,20.42890999999999,21.56185050000001,21.625876250000015,21.117929552415706,21.18011808014247,21.104809615384607,22.684879529068866,19.524739701700348,19.225754999999978,20.42890999999999,21.56185050000001,21.625876250000015,20.326683333333335,7074408,6456595.2,45.035248882210354,3.2454645052435254,1.5,2.75,NaN,NaN,0.8682506146101497,1.0956870890713422,552.4110873139924,-0.1846939267813021,-0.28779300304490363,-0.10309907626360153,63.92050895360425,-0.6509524957800855,2.5467666216039464,82.9212507510011,14.53198262739497,4964190932
1421764200,20.8475,20.957475,20.1775,20.7425,21.483720930232558,23.5168115942029,22.995,16.2775,20.6175,16.2775,17.02,13.2775,15.95,6.233271,19.244717499999975,20.43405999999999,21.56080050000001,21.563251250000015,21.103206824869993,21.138440167747948,20.960001923076916,22.2798745277192,19.64012931843463,19.244717499999975,20.43405999999999,21.56080050000001,21.563251250000015,20.625825,5662128,6268442.6,46.210403444875865,1.606931246528186,1.5,2.75,NaN,NaN,0.8619452135665676,0.9032750814372936,549.5256336760649,-0.14428323687764252,-0.2834531223606547,-0.13916988548301215,55.972724674468196,2.87662740235585,9.837830786704886,64.89926487922547,25.26290433406964,4969853060
1421850600,20.575,21.2375,20.422525,21.065,21.581162790697675,23.54836956521739,22.995,16.2775,20.6175,16.2775,17.02,13.2775,15.95,6.233271,19.268229999999974,20.44260999999999,21.561100500000013,21.502626250000016,21.101708518012344,21.131445866057668,20.893463461538452,22.092729847327213,19.694197075749692,19.268229999999974,20.44260999999999,21.561100500000013,21.502626250000016,20.908341666666672,6768376,6343146.6,48.874931894035555,0.40269064749586386,1.5,2.75,NaN,NaN,0.8585901983118128,1.067037611900693,552.4235569296508,-0.08954105177536317,-0.2510962002022161,-0.16155514842685295,53.51366545974269,0.7292289300657494,29.825538695299556,36.973368827332436,33.201092477368,4976621436
1421937000,21.34,22.05,20.8275,21.995,21.67860465116279,23.57992753623188,22.995,16.2775,20.6175,16.2775,17.02,13.2775,15.95,6.233271,19.299192499999975,20.46083499999999,21.57900050000001,21.473001250000017,21.136739556521665,21.21368911690932,20.900001923076914,22.12207582246358,19.67792802369025,19.299192499999975,20.46083499999999,21.57900050000001,21.473001250000017,21.624166666666667,9117468,6610100.8,55.69124504683052,3.354382782647653,1.5,2.75,NaN,NaN,0.8845837555752548,1.3793235951863245,557.3462469170793,0.010287474008492864,-0.14869580591623688,-0.15898327992472974,55.09180195073114,-0.13620885357547144,66.80779552560516,8.863241989711037,24.3289624846838,4985738904
1422023400,21.885,22,21.5875,21.6275,21.776046511627907,23.611485507246375,22.995,16.2775,20.6175,16.2775,17.02,13.2775,15.95,6.233271,19.327304999999978,20.47378499999999,21.585550500000014,21.420251250000018,21.15598506410905,21.253099677203668,20.968655769230757,22.245010465554785,19.69230107290673,19.327304999999978,20.47378499999999,21.585550500000014,21.420251250000018,21.738333333333333,6044524,6689291,52.70108607345879,2.6793285366315556,1.5,2.75,NaN,NaN,0.8508634873198796,0.9036120569429555,556.0590776454884,0.05031520234595918,-0.09608927699228076,-0.14640447933823994,47.318417885015386,0.7570463545306378,79.45700220031671,3.610005228084188,16.932992571599108,4979694380
1422282600,21.57,21.8275,21.28375,21.7975,21.87348837209302,23.643043478260868,22.995,16.2775,20.6175,16.2775,17.02,13.2775,15.95,6.233271,19.353654999999975,20.48883499999999,21.594500500000013,21.37475125000002,21.181142512575363,21.304947326993794,21.094424999999987,22.350300692341943,19.83854930765803,19.353654999999975,20.48883499999999,21.594500500000013,21.37475125000002,21.63625,3482672,6798844,53.93325745113117,2.01335086972993,1.5,2.75,NaN,NaN,0.8289268096541739,0.5122447286626962,559.3977987814219,0.0849499454939911,-0.040217047470751055,-0.12516699296474215,44.97542595716483,3.9833035181872436,75.49595532822381,5.06289347409142,19.441151197684764,4983177052
1422369000,21,21.3625,20.6125,20.9225,21.97093023255814,23.67460144927536,22.995,16.2775,20.6175,16.2775,17.02,13.2775,15.95,6.233271,19.380867499999976,20.49538499999999,21.58705050000001,21.27537625000002,21.170999668944958,21.268523772042006,21.095194230769216,22.35063543549396,19.839753026044473,19.380867499999976,20.49538499999999,21.58705050000001,21.27537625000002,20.965833333333332,9183164,7146836,47.12802447314858,1.2533399333506603,1.5,2.75,NaN,NaN,0.8543606089645899,1.2849272041502002,558.6197207612945,0.04750578273890835,-0.06578476454110671,-0.11329054728001506,49.3875781875355,0.70998796630566,40.24592651719735,26.98411951618077,32.76995396662189,4973993888
1422455400,21.3625,21.4125,20.06,20.105,22.068372093023257,23.706159420289854,22.995,16.2775,20.6175,16.2775,17.02,13.2775,15.95,6.233271,19.40611749999998,20.49490999999999,21.56210050000001,21.13087625000002,21.129195760358883,21.15771198422848,20.947501923076913,22.18223112111396,19.712772725039866,19.40611749999998,20.49490999999999,21.56210050000001,21.13087625000002,20.525833333333335,8742632,7450093,41.81889527565886,2.694814333320351,1.5,2.75,NaN,NaN,0.8899419940385479,1.1734930020336658,553.7377812560022,-0.02959191656940814,-0.15028044299177523,-0.12068852642236709,54.31755126608078,-1.4702278853222284,15.19700028580564,55.83635427974442,28.966645434449937,4965251256
1422541800,20.175,20.77,19.6875,20.67,22.16581395348837,23.737717391304347,22.995,16.2775,20.6175,16.2775,17.02,13.2775,15.95,6.233271,19.432379999999977,20.49715999999999,21.54820050000001,21.03312625000002,21.111188083482062,21.11126322382577,20.88634807692307,22.09087714232925,19.68181901151689,19.432379999999977,20.49715999999999,21.54820050000001,21.03312625000002,20.375833333333336,6866616,7636504.6,46.319835704750524,3.0720306841875633,1.5,2.75,NaN,NaN,0.9036961373215088,0.8991831157935792,556.7407827575033,-0.03920672938536379,-0.16969693815407183,-0.13049020876870804,56.089514770095555,4.104759506421563,10.711442680030187,63.37912765138094,25.909429668588864,4972117872
1422628200,20.22,20.725,19.8,19.8975,22.26325581395349,23.76927536231884,22.995,16.2775,20.6175,16.2775,17.02,13.2775,15.95,6.233271,19.453229999999976,20.49315999999999,21.518000500000014,20.931501250000018,21.06359247236512,20.995666726318554,20.804424999999995,22.117104784316737,19.491745215683252,19.453229999999976,20.49315999999999,21.518000500000014,20.931501250000018,20.140833333333337,9065060,7851454,41.58316134329112,3.5730254132400456,1.5,2.75,NaN,NaN,0.9052178417985439,1.1545708603782179,552.7283022279555,-0.09128731722228811,-0.24459935529656818,-0.15331203807428007,58.386402564491405,-3.4103113952531507,9.24772459891157,66.15631249644626,24.595962904642175,4963052812
1422887400,20.09,20.655,19.415,20.6075,19.415,23.800833333333333,22.995,16.2775,20.6175,16.2775,17.02,13.2775,15.95,6.233271,19.47522999999998,20.50023499999999,21.49450050000001,20.86637625000002,21.045706493056684,20.95869846666917,20.79154038461538,22.108404042580258,19.474676726650504,19.47522999999998,20.50023499999999,21.49450050000001,20.86637625000002,20.225833333333334,6718436,7949927.6,46.952445965972245,2.9871146185959367,1.5,2.75,NaN,NaN,0.9291308530986481,0.8450939855100065,557.0504030545854,-0.07243673079891214,-0.24385795157292023,-0.1714212207740081,57.98743113805197,-0.6508376521634229,14.069364723427178,57.52885410046676,28.401781176106066,4969771248
1422973800,20.9575,21.515,20.8175,21.4975,19.41741935483871,23.832391304347826,22.995,16.2775,20.6175,16.2775,17.02,13.2775,15.95,6.233271,19.50134249999998,20.513884999999988,21.491100500000012,20.904501250000017,21.063423885485832,21.010012898414963,20.875578846153847,22.222150063934848,19.529007628372845,19.50134249999998,20.513884999999988,21.491100500000012,20.904501250000017,21.276666666666667,7803460,7983175.6,52.807941313462315,1.9672205134265917,1.5,2.75,NaN,NaN,0.9275857921630303,0.9774882065728331,562.3636665743791,0.0015362400453032832,-0.169500920717379,-0.17103716076268227,62.85757477293482,2.0531687633515188,40.06759301698542,27.060259504422874,32.872147478591714,4977574708
1423060200,21.205,21.685,21.095,21.265,19.419838709677418,23.863949275362316,22.995,16.2775,22.995,16.2775,20.6175,13.2775,17.02,6.233271,19.525367499999977,20.524659999999987,21.480600500000016,20.959626250000017,21.071328831153053,21.034297384280205,20.98404038461538,22.20566761334611,19.762413155884648,19.525367499999977,20.524659999999987,21.480600500000016,20.959626250000017,21.348333333333336,6949300,7840722,51.2174409036069,2.083721755110802,1.5,2.75,NaN,NaN,0.9034725212942424,0.8863086843277953,559.2631983475129,0.03454223914312057,-0.12785936183378155,-0.16240160097690212,62.85498709848353,-3.318936121845876,42.931402962602654,24.61544621160134,32.453150825796,4970625408
1423146600,21.5125,21.97,21.5,21.925,19.42225806451613,23.89550724637681,22.995,16.2775,22.995,16.2775,20.6175,13.2775,17.02,6.233271,19.55169249999998,20.54558499999999,21.476150500000013,21.010251250000017,21.10480613189215,21.119126204824948,21.085961538461536,22.381291223940426,19.790631852982646,19.55169249999998,20.54558499999999,21.476150500000013,21.010251250000017,21.798333333333332,5911992,7785740,55.33038164176971,3.423307357621444,1.5,2.75,NaN,NaN,0.8892959126303678,0.7593359141199166,561.398073591571,0.09701924120697575,-0.04112754946818242,-0.13814679067515817,60.11138989842283,1.3755635186683592,41.95498203530106,25.43398999046418,32.61102797423477,4976537400
1423233000,22.04,22.2675,21.53,21.71,19.424677419354836,23.927065217391302,22.995,16.2775,22.995,16.2775,20.6175,13.2775,17.02,6.233271,19.577404999999978,20.564809999999987,21.463850500000014,20.994501250000017,21.128539224759123,21.175399899603523,21.160384615384608,22.479190669466867,19.84157856130235,19.577404999999978,20.564809999999987,21.463850500000014,20.994501250000017,21.83583333333333,6533584,7741353.8,53.740841347193225,2.9820985110298,1.5,2.75,NaN,NaN,0.8784533474424842,0.8439846787521842,558.2868861688195,0.11863136697905649,0.01014241804866245,-0.10848894893039404,59.54024989422114,-0.4014221814428195,46.333830551495055,21.879998352812134,31.786171095692808,4970003816
1423492200,21.4275,21.75,21.285,21.4275,19.427096774193547,23.958623188405795,22.995,16.2775,22.995,16.2775,20.6175,13.2775,17.02,6.233271,19.601217499999976,20.576709999999984,21.44670050000001,20.99262625000002,21.140263176729352,21.199409432974615,21.188269230769226,22.513144238829327,19.863394222709125,19.601217499999976,20.576709999999984,21.44670050000001,20.99262625000002,21.487499999999997,5257624,7596344.4,51.64155415833124,1.2363828327865816,1.5,2.75,NaN,NaN,0.8489209654823068,0.6921255439655948,555.863645977824,0.10891915944065207,0.027660000370421045,-0.08125915907023103,59.7922544109524,2.4136694945632646,23.787432289922744,43.898748925279854,32.31381878479741,4964746192
1423578600,21.825,22.2035,21.495,22.105,19.429516129032258,23.99018115942029,22.995,16.2775,22.995,16.2775,20.6175,13.2775,17.02,6.233271,19.630492499999978,20.594684999999984,21.43990050000001,21.04975125000002,21.178095993328203,21.2856561536437,21.196730769230765,22.543333881074936,19.850127657386594,19.630492499999978,20.594684999999984,21.43990050000001,21.04975125000002,21.9345,4913780,7485560.6,56.07326901363972,3.213728339612678,1.5,2.75,NaN,NaN,0.8437123250907135,0.6564344693168338,557.928680557702,0.14109930507275342,0.09511497227071075,-0.04598433280204267,56.714161346954555,9.947774185525988,17.95023936854108,51.61274692580758,30.437013705651335,4969659972
1423665000,22.06,22.325,21.795,22.1575,19.431935483870966,24.02173913043478,22.995,16.2775,22.995,16.2775,20.6175,13.2775,17.02,6.233271,19.659242499999976,20.610084999999984,21.436950500000012,21.11887625000002,21.216503993589843,21.36868890091573,21.237499999999994,22.663550220283007,19.81144977971698,19.659242499999976,20.610084999999984,21.436950500000012,21.11887625000002,22.0925,4178944,7148684.2,56.40666034464014,2.857397448822855,1.5,2.75,NaN,NaN,0.8213043018699481,0.5845752705092218,556.021457445426,0.1576421959294209,0.15106841210973343,-0.00657378381968745,49.03221002266733,7.196419932268975,42.20675157467617,25.188513939020574,32.60473448630326,4973838916
1423751400,22.47,22.81,22.39625,22.775,19.434354838709677,24.053297101449274,22.995,16.2775,22.995,16.2775,20.6175,13.2775,17.02,6.233271,19.690004999999978,20.632009999999987,21.455950500000014,21.237376250000022,21.2776214840373,21.502623291304708,21.3126923076923,22.938074465759534,19.687310149625063,19.690004999999978,20.632009999999987,21.455950500000014,21.237376250000022,22.660416666666663,4485280,6800525.4,60.23000377542281,4.783132628870091,1.5,2.75,NaN,NaN,0.8092468517363803,0.6595490401373988,560.0816481447469,0.19921443436699465,0.24244425913905587,0.04322982477206122,49.00190981473146,14.461615780876983,39.18188948865947,27.809477790216082,33.008632721124464,4978324196
1423837800,22.825,23.085,22.7375,23.0825,19.436774193548388,24.084855072463768,22.995,16.2775,22.995,16.2775,20.6175,13.2775,17.02,6.233271,19.721429999999977,20.661859999999987,21.47275050000001,21.39875125000002,21.348401033682897,21.65308773975188,21.478846153846142,23.335820135048866,19.621872172643418,19.721429999999977,20.661859999999987,21.47275050000001,21.39875125000002,22.968333333333334,4304240,6453184.4,62.01653491969512,4.82364631565152,1.5,2.75,NaN,NaN,0.7762649337552103,0.6669947320891683,562.677190882839,0.23405777175914105,0.3358020394709875,0.10174426771184648,38.4172838019234,12.010190464636649,73.53832862959017,5.803526916948616,20.658144453461205,4982628436
1424183400,22.9525,23.24725,22.85,23.1825,19.439193548387095,24.11641304347826,22.995,16.2775,22.995,16.2775,20.6175,13.2775,17.02,6.233271,19.753417499999976,20.69611024999999,21.48640050000001,21.52787500000002,21.420326483342393,21.7987460502517,21.71557692307691,23.59613244027241,19.83502140588141,19.753417499999976,20.69611024999999,21.48640050000001,21.52787500000002,23.09325,2864268,6242677.4,62.60484987180336,4.782511133389971,1.5,2.75,NaN,NaN,0.749192438486981,0.4588204413702364,560.1061230870799,0.2490813887654817,0.4130960036686986,0.1640146149032169,36.506305588341476,7.838120711710675,100,0,0,4985492704
1424269800,23.0275,23.20975,22.921275,23.19,19.441612903225806,24.147971014492754,22.995,16.2775,22.995,16.2775,20.6175,13.2775,17.02,6.233271,19.785779999999978,20.725685249999987,21.501900500000012,21.65025000000002,21.489725444779946,21.931246426418205,21.909423076923062,23.837817341037592,19.981028812808532,19.785779999999978,20.725685249999987,21.501900500000012,21.65025000000002,23.107008333333336,2683592,6093750.6,62.65157317786311,3.9259318963968193,1.5,2.75,NaN,NaN,0.7162840500236252,0.44038428484421405,561.7500151006809,0.2444239854048556,0.4695445966592864,0.22512061125443078,31.250727041016585,9.052433576299086,100,0,0,4988176296
1424356200,22.9525,23.269,22.887525,23.1475,19.444032258064514,24.179528985507243,22.995,16.2775,22.995,16.2775,20.6175,13.2775,17.02,6.233271,19.81747999999998,20.76473524999999,21.51415050000001,21.754375000000017,21.55473621165132,22.04708010009266,22.159423076923062,23.80102542951143,20.517820724334694,19.81747999999998,20.76473524999999,21.51415050000001,21.754375000000017,23.101341666666666,2597200,5885191.8,62.177479951683594,3.440129347532797,1.5,2.75,NaN,NaN,0.6923691178790803,0.4413110206535665,560.631981111931,0.22392707364758863,0.5050294533139166,0.28110237966632795,29.69314977728952,5.575826681870012,82.41984375353593,2.69043309208227,14.889723154381784,4985579096
1424442600,22.9575,23.5625,22.715,23.5525,19.446451612903225,24.211086956521736,22.995,16.2775,22.995,16.2775,20.6175,13.2775,17.02,6.233271,19.853329999999975,20.803285249999984,21.54355050000001,21.83225000000002,21.63307988962578,22.19045342389336,22.385961538461522,23.917509948582595,20.85441312834045,19.853329999999975,20.803285249999984,21.54355050000001,21.83225000000002,23.276666666666667,5070016,5682819.2,64.90301840749689,3.9437554483205557,1.5,2.75,NaN,NaN,0.7034498951734317,0.8921656349721631,563.9111287128732,0.22262477633520167,0.55938335008533,0.33675857375012835,26.944121961423598,8.486872409028086,83.25273451646602,2.4542969389190574,14.292968544614915,4990649112
1424701800,23.4525,23.5425,23.2925,23.5425,19.448870967741936,24.24264492753623,22.995,16.2775,22.995,16.2775,20.6175,13.2775,17.02,6.233271,19.887742499999977,20.842935249999986,21.573900500000008,21.92800000000002,21.707959109640456,22.319219764474944,22.54326923076922,24.097405627881262,20.989132833657177,19.887742499999977,20.842935249999986,21.573900500000008,21.92800000000002,23.459166666666665,2275728,5494379.4,64.7788917598678,3.3841327090130413,1.5,2.75,NaN,NaN,0.6717749026610436,0.41419200137507795,563.2987562771774,0.2064298226904921,0.5947958521132435,0.3883660294227514,25.26002250392604,9.870493524676244,61.745215558651935,11.607897549796313,26.646886891551752,4988373384
1424788200,23.5125,23.815,23.395,23.735,19.451290322580643,24.274202898550723,22.995,16.2775,22.995,16.2775,20.6175,13.2775,17.02,6.233271,19.923404999999978,20.88618524999999,21.628950500000006,22.02487500000002,21.7874509092624,22.454055977382094,22.73326923076922,24.21825095121536,21.24828751032308,19.923404999999978,20.88618524999999,21.628950500000006,22.02487500000002,23.648333333333326,3018436,5471167.6,66.12206633370633,3.811966467864421,1.5,2.75,NaN,NaN,0.6537909810423976,0.5516986904221323,566.033481748638,0.19420198840703368,0.6311185149315435,0.4369165265245098,21.390079805150897,7.373897308301284,62.385869087424915,11.247932800060289,26.366198112514795,4991391820
1424874600,23.675,23.8775,23.5425,23.67,19.453709677419354,23.8775,22.995,16.2775,22.995,16.2775,20.6175,13.2775,17.02,6.233271,19.958404999999978,20.93658524999999,21.676750500000008,22.16225000000002,21.861276363801128,22.569860170012372,22.86749999999999,24.351438366955666,21.383561633044312,19.958404999999978,20.93658524999999,21.676750500000008,22.16225000000002,23.69666666666667,2923676,5158193.2,65.2176633512538,3.206349776722882,1.5,2.75,NaN,NaN,0.6310201966822264,0.5668023446659578,567.9849122004043,0.16822599691436124,0.6471990226674613,0.4789730257531001,17.821555950227424,6.82613110684871,36.746141039668856,30.133319753921544,33.1205392064096,4988468144
1424961000,23.64,23.695,23.3425,23.5825,19.456129032258062,23.898076923076925,22.995,16.2775,22.995,16.2775,20.6175,13.2775,17.02,6.233271,19.990604999999977,20.986085249999988,21.74350050000001,22.336125000000017,21.928775329926573,22.666302058582623,23.01153846153845,24.376872371756217,21.646204551320682,19.990604999999977,20.986085249999988,21.74350050000001,22.336125000000017,23.540000000000003,2834628,4862793,63.949623391002156,2.163322047463667,1.5,2.75,NaN,NaN,0.6111258969192102,0.5829217900083347,566.3686681291208,0.13317531271486793,0.645442166646685,0.512266853931817,18.69631428233339,3.545554335894626,35.511563968885696,31.303080315539436,33.185355715574865,4985633516
1425047400,23.55,23.6425,23.3275,23.3425,19.458548387096773,23.91865384615385,22.995,16.2775,22.995,16.2775,20.6175,13.2775,17.02,6.233271,20.02135499999998,21.02706024999999,21.813750500000012,22.46975000000002,21.984215513066708,22.730701862527134,23.15884615384614,24.178153262743418,22.139539044948865,20.02135499999998,21.02706024999999,21.813750500000012,22.46975000000002,23.4375,2372604,4638092.4,60.47633351312728,1.5590333378852508,1.5,2.75,NaN,NaN,0.5899740471392665,0.5115473766758074,567.38227419672,0.08423847450853195,0.617564947067482,0.53332647255895,15.220181053739482,1.1263944546734608,6.809556298955181,71.264247369595,21.92619633144982,4983260912
1425306600,23.3825,23.8009,23.3625,23.78275,19.460967741935484,23.93923076923077,22.995,16.2775,22.995,16.2775,20.6175,13.2775,17.02,6.233271,20.055468749999978,21.07306274999999,21.90225550000001,22.66401250000002,22.054746277260172,22.830896923238836,23.28790384615383,24.154168229727645,22.421639462580018,20.055468749999978,21.07306274999999,21.90225550000001,22.66401250000002,23.64871666666666,2714312,4320555,64.30608051976958,2.2118381177639823,1.5,2.75,NaN,NaN,0.580575900915033,0.6282322525694037,569.2274365953875,0.07238338320215187,0.6238057015616398,0.551422318359488,16.82091784952636,2.589237571443973,22.693966301402735,45.258704626165155,32.0473290724321,4985975224
1425393000,23.61,23.64475,23.1375,23.485,19.46338709677419,23.959807692307695,22.995,16.2775,22.995,16.2775,20.6175,13.2775,17.02,6.233271,20.090443749999977,21.12491274999999,21.962105500000007,22.80788750000002,22.110834658544086,22.893192454358946,23.39001923076922,23.962280953488765,22.817757508049674,20.090443749999977,21.12491274999999,21.962105500000007,22.80788750000002,23.422416666666663,4570556,4213161,60.06687030826056,0.9701885009736946,1.5,2.75,NaN,NaN,0.5851954794211022,1.0848282322939948,566.9048882602111,0.037129463666329854,0.5978341479424003,0.5607046842760705,18.987432058515758,1.2721000431220273,3.6665692800844067,79.28405604470737,17.049374675208234,4981404668
1425479400,23.225,23.2765,22.830025,23.195,19.465806451612902,23.980384615384615,22.995,16.2775,22.995,16.2775,20.6175,13.2775,17.02,6.233271,20.12296874999998,21.16426274999999,21.986105500000008,22.89276250000002,22.153350946444316,22.921936030134283,23.422326923076916,23.8899019842915,22.95475186186233,20.12296874999998,21.16426274999999,21.986105500000008,22.89276250000002,23.100508333333334,3907248,4018350.4,56.18212973024444,0.4992766001124422,1.5,2.75,NaN,NaN,0.5901797308910235,0.972351241444748,564.1606921584541,-0.010532358040292844,0.5475392367257044,0.5580715947659972,20.566182633687163,0.20520574576087885,3.2447126907465638,80.58557288704336,16.16971442221008,4977497420
1425565800,23.325,23.3825,23.065,23.255,19.46822580645161,24.00096153846154,22.995,16.2775,22.995,16.2775,20.6175,13.2775,17.02,6.233271,20.15496874999998,21.21581274999999,22.00565550000001,22.99226250000002,22.196552870113166,22.953656408216734,23.435596153846145,23.872636177469293,22.998556130222997,20.15496874999998,21.21581274999999,22.00565550000001,22.99226250000002,23.234166666666667,2823268,3812048.8,56.80457716748602,0.15480552331544092,1.5,2.75,NaN,NaN,0.5707026072559503,0.7406169616716345,565.7222927768032,-0.04111251328464138,0.5066809531601955,0.5477934664448368,20.57653577413518,-1.263135548243284,14.756938787052944,56.395667292893805,28.847393920053243,4980320688
1425652200,22.905,23.0825,22.145,22.2775,19.47064516129032,24.021538461538462,22.995,16.2775,22.995,16.2775,20.6175,13.2775,17.02,6.233271,20.183693749999982,21.263637749999994,21.999455500000007,23.00988750000002,22.19972726736363,22.88926055981514,23.36598076923076,24.11736719192751,22.61459434653401,20.183693749999982,21.263637749999994,21.999455500000007,23.00988750000002,22.501666666666665,6672404,3850069.4,45.47164513822807,3.4672687179788393,1.5,2.75,NaN,NaN,0.6092238495948111,1.7330607079446412,558.7461429313178,-0.12550027112493745,0.39091812753866506,0.5164183986636025,29.570320356035218,-5.373261123500056,9.235710874060151,66.06394549350867,24.700343632431178,4973648284
1425907800,22.3425,22.6875,22.3125,22.5525,19.473064516129032,24.042115384615386,23.78275,16.2775,22.995,16.2775,20.6175,13.2775,17.02,6.233271,20.21173124999998,21.32303774999999,21.99685550000001,23.05201250000002,22.2135614921729,22.85718812554703,23.316942307692297,24.18241856950617,22.451466045878426,20.21173124999998,21.32303774999999,21.99685550000001,23.05201250000002,22.5175,2712904,3659035.4,48.579737075109506,2.186400269116849,1.5,2.75,NaN,NaN,0.5949935746237532,0.74142600533463,560.2115331254479,-0.15897218170012134,0.31770317153845085,0.4766753532385722,31.224479949634592,-4.982093954076263,8.113349538007062,68.45291813891367,23.433732323079266,4976361188
1425994200,22.0075,22.0425,21.455,21.4575,19.47548387096774,24.06269230769231,23.78275,16.2775,22.995,16.2775,20.6175,13.2775,17.02,6.233271,20.23363124999998,21.37033774999999,21.97185550000001,23.053512500000018,22.18391202189161,22.72388449454255,23.1869423076923,24.50469386233502,21.869190753049576,20.23363124999998,21.37033774999999,21.97185550000001,23.053512500000018,21.651666666666667,6690776,3730693,39.03804087629899,5.536603246678064,1.5,2.75,NaN,NaN,0.6308868907220566,1.7934405216403493,554.8399256689535,-0.24584424242268832,0.1693700502102118,0.4152142926329001,39.381331415158144,-9.347275031685687,6.904600206221774,71.06850636527098,22.02689342850723,4969670412
1426080600,21.5525,21.6175,21.272525,21.2975,21.272525,24.083269230769233,23.78275,16.2775,22.995,16.2775,20.6175,13.2775,17.02,6.233271,20.25364374999998,21.42053774999999,21.939605500000006,23.01313750000002,22.149150766131157,22.588038352205164,23.01348076923076,24.64855110953771,21.37841042892381,20.25364374999998,21.42053774999999,21.939605500000006,23.01313750000002,21.395841666666666,4090792,3689543.6,37.8676541866179,5.550186669922544,1.5,2.75,NaN,NaN,0.6104646128133382,1.1087528549601635,557.1759030069122,-0.3014026613252897,0.03846096597628801,0.3398636273015777,39.151610619751246,-9.689388317608396,7.0095324929404965,70.83354655775943,22.15692094930007,4965579620
1426167000,21.53,22.1375,21.52,22.125,21.34396826923077,24.103846153846156,23.78275,16.2775,22.995,16.2775,20.6175,13.2775,17.02,6.233271,20.276281249999982,21.478987499999988,21.922205500000008,23.01151250000002,22.148203677263268,22.543939461518956,22.9044423076923,24.57257839504164,21.23630622034296,20.276281249999982,21.478987499999988,21.922205500000008,23.01151250000002,21.9275,4315672,3696380,46.75817137554573,2.6386584423856947,1.5,2.75,NaN,NaN,0.6268599976123854,1.167540133860696,560.9784263366854,-0.2707149314037868,0.0014699630468442137,0.272184894450631,48.1332288274463,-5.215808075398955,9.820573721232691,65.0473377221513,25.132088556616,4969895292
1426253400,22,22.0625,21.3075,21.7,21.41541153846154,24.12442307692308,23.78275,16.2775,22.995,16.2775,20.6175,13.2775,17.02,6.233271,20.29703124999998,21.52700249999999,21.90370550000001,22.957762500000022,22.13062706246863,22.463564274707625,22.747903846153836,24.45634469561122,21.03946299669645,20.29703124999998,21.52700249999999,21.90370550000001,22.957762500000022,21.69,7766380,3860435,43.32896808159394,3.9336527462313473,1.5,2.75,NaN,NaN,0.6404771406400721,2.0117888269068125,557.1944229911952,-0.266893097619404,-0.061431477573623994,0.20546162004578,48.684404169516846,-8.757397693706578,9.066575451984384,66.51456363006447,24.418860917951147,4962128912
1426512600,21.985,22.6025,21.9725,22.5875,21.48685480769231,24.145000000000003,23.78275,16.2775,22.995,16.2775,20.6175,13.2775,17.02,6.233271,20.32079374999998,21.57912749999999,21.91685550000001,22.93301250000002,22.148543648254172,22.475367677116424,22.6646346153846,24.288621360018176,21.040647870751023,20.32079374999998,21.57912749999999,21.91685550000001,22.93301250000002,22.3875,4949464,3892696.2,51.35241707286161,0.49856745605872327,1.5,2.75,NaN,NaN,0.6591930591657812,1.2714745116765083,560.4089732448596,-0.19574164678004585,-0.03921543842927733,0.15652620835076853,54.096906408762074,-3.82158824781776,14.127700026472759,57.46957663303088,28.40272334049637,4967078376
1426599000,22.2675,22.5075,22.0525,22.37,21.55829807692308,24.165576923076927,23.78275,16.2775,22.995,16.2775,20.6175,13.2775,17.02,6.233271,20.343243749999978,21.61892749999999,21.926055500000007,22.89238750000002,22.157228211067736,22.465332660248194,22.571365384615373,24.11085339410455,21.031877375126196,20.343243749999978,21.61892749999999,21.926055500000007,22.89238750000002,22.310000000000002,4714528,3985209.2,49.5027035304811,0.4707012979640305,1.5,2.75,NaN,NaN,0.6503221263682254,1.1830064027755431,558.6867917529984,-0.15619155669830848,-0.03871323752211708,0.11747831917619139,53.975946322705234,-3.5568010347057526,16.26820821791656,54.14733193572874,29.584459846354704,4962363848
1426685400,22.1875,23.435,21.9375,23.175,21.62974134615385,24.186153846153847,23.78275,16.2775,22.995,16.2775,20.6175,13.2775,17.02,6.233271,20.369268749999982,21.67057749999999,21.974855500000007,22.891637500000023,22.19714083024155,22.532920025938843,22.558480769230755,24.074563150561747,21.042398387899762,20.369268749999982,21.67057749999999,21.974855500000007,22.891637500000023,22.849166666666665,7736852,4237872.2,55.84242405560961,1.9665038744696766,1.5,2.75,NaN,NaN,0.7108348316276378,1.8256454264949282,564.2200246838144,-0.07291231498928563,0.026337925439584353,0.09925024042886998,58.305925284909584,-0.34401204042140743,43.65459176921342,24.048354747083017,32.297053483703564,4970100700
1426771800,23,23.1151,22.7075,22.8375,21.70118461538462,24.20673076923077,23.78275,16.2775,22.995,16.2775,20.6175,13.2775,17.02,6.233271,20.39373124999998,21.712577499999995,22.02835550000001,22.87613750000002,22.222252954545805,22.561927642516096,22.485769230769215,23.84228397396986,21.12925448756857,20.39373124999998,21.712577499999995,22.02835550000001,22.87613750000002,22.8867,5855440,4400784.2,52.84682642761202,1.3927279744634113,1.5,2.75,NaN,NaN,0.6934537722256637,1.330544678832468,561.0801686915476,-0.03933562267471072,0.050080712085481593,0.08941633476019231,58.85359879119235,2.513747054202665,21.67643320832114,46.63213760195746,31.691429189721404,4964245260
1426858200,23.2275,23.655,23.2,23.4475,21.772627884615385,24.227307692307694,23.78275,16.2775,22.995,16.2775,20.6175,13.2775,17.02,6.233271,20.420818749999977,21.756702499999996,22.079055500000013,22.87088750000002,22.270301858289105,22.64626786703837,22.482884615384595,23.831021286945422,21.13474794382377,20.420818749999977,21.756702499999996,22.079055500000013,22.87088750000002,23.43416666666667,7083580,4501462.4,57.30481412474875,3.6002569145180336,1.5,2.75,NaN,NaN,0.7023142170666878,1.5736174981712607,566.2140894989951,0.02188521919192296,0.11677285875009602,0.09488763955817306,54.41154350807183,3.9685179026715582,54.163736461429835,16.25727081730984,29.57899272126032,4971328840
1427117400,23.4625,23.6825,23.32,23.32,21.844071153846155,23.6825,23.78275,16.2775,22.995,16.2775,20.6175,13.2775,17.02,6.233271,20.44535624999998,21.80017775,22.10495550000001,22.85976250000002,22.311466491297377,22.710432832082336,22.492499999999982,23.86242279400644,21.122577205993522,20.44535624999998,21.80017775,22.10495550000001,22.85976250000002,23.44083333333333,3964472,4585899.6,56.11071932383761,3.13345553413201,1.5,2.75,NaN,NaN,0.678041772990496,0.8644916692027014,568.5214276891635,0.050108172841328597,0.1575228556098338,0.10741468276850522,54.50946937873668,8.679948735873241,36.55563907162211,30.303360183887982,33.14100074448991,4967364368
1427203800,23.25,23.4475,22.89275,22.91,21.915514423076925,23.671666666666667,23.78275,16.2775,22.995,16.2775,20.6175,13.2775,17.02,6.233271,20.46658124999998,21.833152749999996,22.133855500000013,22.81851250000002,22.33493839359944,22.729439229026877,22.46596153846152,23.788311629516688,21.143611447406354,20.46658124999998,21.833152749999996,22.133855500000013,22.81851250000002,23.08341666666667,3142852,4592120.4,52.334200542722044,1.2298930524052514,1.5,2.75,NaN,NaN,0.6692352177768893,0.6844010448854956,566.7072440887739,0.03802649887474699,0.15494780636193894,0.11692130748719196,45.45573912771381,7.571311186759012,40.23750482032326,26.964150466286377,32.79834471339036,4964221516
1427290200,23.0175,23.1025,21.9025,21.92,21.986957692307694,23.660833333333333,23.78275,16.2775,22.995,16.2775,20.6175,13.2775,17.02,6.233271,20.482518749999983,21.856877749999995,22.153005500000013,22.73101250000002,22.318666299732797,22.652349778643366,22.438461538461524,23.789894593324085,21.087028483598964,20.482518749999983,21.856877749999995,22.153005500000013,22.73101250000002,22.308333333333334,6795464,4785709.8,44.539076328341594,2.4551562532926474,1.5,2.75,NaN,NaN,0.707146987935683,1.4199490324298394,563.857771004966,-0.03578490863494552,0.07219017169351005,0.10797508032845557,53.70581034587602,-0.9265536723163764,9.942037899096864,64.78685879216489,25.271103308738233,4957426052
1427376600,21.67,22.100125,21.3875,21.76,22.058400961538464,23.650000000000002,23.78275,16.2775,22.995,16.2775,20.6175,13.2775,17.02,6.233271,20.497668749999985,21.875152749999998,22.17270550000001,22.63988750000002,22.296757817390336,22.567364085439237,22.377499999999984,23.77361549004315,20.98138450995682,20.497668749999985,21.875152749999998,22.17270550000001,22.63988750000002,21.749208333333332,5020696,4895013.2,43.413609213519884,3.656599426737807,1.5,2.75,NaN,NaN,0.7075382745117056,1.025675681528295,561.2969718508557,-0.09136777926258118,-0.006234643749770896,0.08513313551281028,48.925930833498185,0.276497695852545,10.839685822639867,63.11559286865686,26.04472130870326,4952405356
1427463000,21.71,21.975,21.645,21.89,22.129844230769233,23.639166666666668,23.78275,16.2775,22.995,16.2775,20.6175,13.2775,17.02,6.233271,20.514356249999988,21.888102749999998,22.202405500000012,22.56726250000002,22.280806530433853,22.50285322015931,22.410769230769215,23.736440881459455,21.085097580078976,20.514356249999988,21.888102749999998,22.202405500000012,22.56726250000002,21.83666666666667,3301136,4941439.8,44.63770041895996,2.8079615903427415,1.5,2.75,NaN,NaN,0.6805712549037268,0.6680514452488119,563.8122314025213,-0.1138962420354869,-0.05723716703154835,0.056659075003938554,47.71487464183402,-3.087991145545094,2.6821455060931405,82.5054513454181,14.812403148488778,4955706492
1427722200,22.2875,22.8125,22.2875,22.7,22.201287500000003,23.628333333333334,23.78275,16.2775,22.995,16.2775,20.6175,13.2775,17.02,6.233271,20.53716874999999,21.908902749999996,22.259305500000014,22.51312500000002,22.297245490024682,22.52162910395366,22.51865384615383,23.68280361081309,21.354504081494568,20.53716874999999,21.908902749999996,22.259305500000014,22.51312500000002,22.599999999999998,3756584,4993553.4,51.65513658499224,1.1268828194270208,1.5,2.75,NaN,NaN,0.6978518795534605,0.7522867383374732,566.6910082820032,-0.07087025911981447,-0.03192874889582953,0.03894151022398494,46.626176927841676,1.4751899865891742,12.993471957590152,59.270076413448265,27.736451628961596,4959463076
1427808600,22.375,22.65,22.0875,22.11,22.272730769230773,23.6175,23.78275,16.2775,22.995,16.2775,20.6175,13.2775,17.02,6.233271,20.556168749999983,21.92567775,22.289505000000013,22.44437500000002,22.289902529631558,22.48242633214855,22.517499999999984,23.68323680892913,21.351763191070837,20.556168749999983,21.92567775,22.289505000000013,22.44437500000002,22.2825,5349844,5032517.8,46.98357493484722,0.6807668998732853,1.5,2.75,NaN,NaN,0.6917553167282133,1.0630551570031208,563.9711571166918,-0.07819471445731646,-0.058801882847660636,0.019392831609655825,48.87615321750422,-4.595469255663436,10.679576981531465,63.328064798469974,25.992358219998568,4954113232
1427895000,22.085,22.095,21.4875,21.895,22.344174038461542,23.60666666666667,23.78275,16.2775,22.995,16.2775,20.6175,13.2775,17.02,6.233271,20.573918749999983,21.936677749999998,22.31255500000001,22.379375000000017,22.274416155920516,22.42648096718202,22.532499999999985,23.660171187754777,21.404828812245192,20.573918749999983,21.936677749999998,22.31255500000001,22.379375000000017,21.825833333333335,6756384,5174974.6,45.37322825603611,2.595475411012078,1.5,2.75,NaN,NaN,0.6868085083904837,1.3055878573780826,564.9208732765594,-0.0925840434869103,-0.09633722274898204,-0.0037531792620717486,43.06620173413905,-4.126984126984123,10.724118116948215,63.24621479505918,26.029667087992607,4947356848
1427981400,21.825,22.27,21.775,22.0725,22.41561730769231,23.595833333333335,23.78275,16.2775,22.995,16.2775,20.6175,13.2775,17.02,6.233271,20.591831249999988,21.94690275,22.33270500000001,22.32025000000002,22.26649787529618,22.392768494117064,22.4928846153846,23.645942166409842,21.33982706435936,20.591831249999988,21.94690275,22.33270500000001,22.32025000000002,22.03916666666667,2657956,5166709,46.98865304636204,1.2525481240683614,1.5,2.75,NaN,NaN,0.6731079006483063,0.5144388816943242,568.002188822638,-0.08538773526102102,-0.11048784833834802,-0.025100113077327003,43.305791478808565,-5.864164623094146,26.12280814692219,41.11998009188595,32.75721176119186,4950014804
1428327000,21.7475,22.73825,21.71,22.54,22.48706057692308,23.585,23.78275,16.2775,22.995,16.2775,20.6175,13.2775,17.02,6.233271,20.610043749999985,21.96130275,22.34360500000001,22.33337500000002,22.277223448813977,22.406790542296392,22.505961538461523,23.657002101907583,21.354920975015464,20.610043749999985,21.96130275,22.34360500000001,22.33337500000002,22.329416666666663,4580984,5062138,51.091048316293616,1.2947514093304204,1.5,2.75,NaN,NaN,0.6984751934591416,0.9049504379374881,571.8737374648339,-0.046337471727274385,-0.08302195273641999,-0.036684481009145606,42.04297388778269,-3.3447684391080665,29.996511225219507,36.812968501988586,33.19052027279189,4954595788
1428413400,22.555,22.8474,22.3475,22.3575,22.55850384615385,23.574166666666667,23.78275,16.2775,23.78275,16.2775,22.995,13.2775,20.6175,6.233271,20.627006249999987,21.971877749999997,22.358205000000012,22.32362500000002,22.280371548860487,22.402096204934832,22.44307692307691,23.528494520569573,21.357659325584244,20.627006249999987,21.971877749999997,22.358205000000012,22.32362500000002,22.517466666666667,8103228,5331654.2,49.481236380136906,1.0678347753609614,1.5,2.75,NaN,NaN,0.6842912510692029,1.519833750658473,571.1122089686122,-0.030744714472471166,-0.07511537409973457,-0.0443706596272634,42.10591254820884,-2.41161065037101,8.391700811197646,67.78648558109197,23.821813607710375,4946492560
1428499800,22.46,22.75,22.29275,22.585,22.629947115384617,23.563333333333333,23.78275,16.2775,23.78275,16.2775,22.995,13.2775,20.6175,6.233271,20.644518749999985,21.98422775,22.373955000000013,22.38000000000002,22.292317762630663,22.419515613988658,22.423653846153833,23.488995278213952,21.358312414093714,20.644518749999985,21.98422775,22.373955000000013,22.38000000000002,22.54258333333333,3964716,5195351.2,51.531424899489075,0.7543907010819656,1.5,2.75,NaN,NaN,0.668074018849974,0.7631276207082978,573.5536807201845,-0.004436750218461585,-0.04991659740034038,-0.045479847181878794,41.86733140483473,3.033759124087587,24.055937564979555,43.59793077429691,32.34613166072353,4950457276
1428586200,22.5375,22.9725,22.3375,22.9,22.701390384615387,23.552500000000002,23.78275,16.2775,23.78275,16.2775,22.995,13.2775,20.6175,6.233271,20.663668749999985,22.00027775,22.41350500000002,22.46012500000002,22.316148438605932,22.465276031704022,22.381538461538447,23.31702381163041,21.446053111446485,20.663668749999985,22.00027775,22.41350500000002,22.46012500000002,22.736666666666668,3760260,5178824.6,54.29708510079377,1.4771951106142784,1.5,2.75,NaN,NaN,0.6657115889321188,0.7260836754347696,572.9763304509949,0.03280234907180536,-0.004476910842122095,-0.03727925991392746,32.377226574910296,5.23897058823528,53.87459089501712,16.419235100537836,29.706174004445028,4954217536
1428672600,22.9775,23.27,22.915,23.25,22.772833653846156,23.541666666666668,23.78275,16.2775,23.78275,16.2775,22.995,13.2775,20.6175,6.233271,20.686306249999983,22.01925275,22.476405000000018,22.516375000000018,22.352770068464523,22.54001164773221,22.376153846153834,23.290538076502354,21.461769615805313,20.686306249999983,22.01925275,22.476405000000018,22.516375000000018,23.145,3034764,5114779.2,57.21814431019816,2.7603902158246334,1.5,2.75,NaN,NaN,0.6445893325798246,0.5933323573381232,576.2929552413502,0.0770995919568839,0.059095230032177426,-0.018004361924706478,31.97472676220575,6.21288259479214,55.035318612558015,15.651010723444791,29.313670663997176,4957252300
1428931800,23.195,23.4375,22.9275,22.935,22.844276923076926,23.530833333333334,23.78275,16.2775,23.78275,16.2775,22.995,13.2775,20.6175,6.233271,20.70616874999999,22.034952750000002,22.521705000000015,22.57812500000002,22.37560261479925,22.57762958604343,22.378076923076907,23.297037778203194,21.45911606795062,20.70616874999999,22.034952750000002,22.521705000000015,22.57812500000002,23.099999999999998,2737048,4863312.6,53.88038986825393,2.083492295158309,1.5,2.75,NaN,NaN,0.634975808824123,0.5627949969738734,573.6970471654087,0.08088413583400603,0.08310080786780105,0.0022166720337950287,34.03064935811164,1.0352422907488963,35.010950094538536,31.735659318255465,33.253390587205985,4954515252
1429018200,22.9075,23.1375,22.6175,23.0625,22.915720192307695,23.52,23.78275,16.2775,23.78275,16.2775,22.995,13.2775,20.6175,6.233271,20.72684374999999,22.051502750000004,22.585005000000013,22.60187500000002,22.40253976716006,22.62380772070596,22.46596153846152,23.411034873958535,21.520888202964507,20.72684374999999,22.051502750000004,22.585005000000013,22.60187500000002,22.939166666666665,3308124,4781245.6,55.024019933016376,1.5228592104205942,1.5,2.75,NaN,NaN,0.6267632510509713,0.6918958524113465,575.4818872166286,0.08713267772321381,0.1111325191878123,0.023999841464598486,27.525163612266915,4.308005427408415,81.86128512465423,2.8638762982796866,15.274838577066092,4957823376
1429104600,23.28,23.575,23.22,23.3875,22.987163461538465,23.50916666666667,23.78275,16.2775,23.78275,16.2775,22.995,13.2775,20.6175,6.233271,20.74866874999999,22.067552750000004,22.640605000000015,22.65275000000002,22.44116565864398,22.696540318733962,22.59115384615383,23.55987746194266,21.622430230365,20.74866874999999,22.067552750000004,22.640605000000015,22.65275000000002,23.394166666666667,2891716,4690105,57.8904317451394,2.933055114312752,1.5,2.75,NaN,NaN,0.6186015902616162,0.6165567721831388,577.4914429327622,0.10700344254609805,0.15775414464722104,0.050750702101122994,21.678736417736793,6.816624800182689,80.61473486194625,3.2464484024365445,16.13881673561721,4960715092
1429191000,23.2625,23.555,23.172525,23.35,23.058606730769235,23.498333333333335,23.78275,16.2775,23.78275,16.2775,22.995,13.2775,20.6175,6.233271,20.77036874999999,22.08437775,22.677655000000012,22.66150000000002,22.476806221050097,22.758774574092634,22.703461538461525,23.659437758115747,21.747485318807303,20.77036874999999,22.08437775,22.677655000000012,22.66150000000002,23.359175000000004,3704268,4488475.8,57.43557824920809,2.3624945929745915,1.5,2.75,NaN,NaN,0.6017354052429293,0.8252841643927322,575.6449533418022,0.1109929088465633,0.18949183815932713,0.07849892931276382,20.003289175323584,5.787744931475817,47.29461542912135,21.152173114498144,31.553211456380506,4957010824
1429277400,22.875,22.97,22.2425,22.5475,23.130050000000004,23.4875,23.78275,16.2775,23.78275,16.2775,22.995,13.2775,20.6175,6.233271,20.786143749999987,22.091952750000004,22.70330500000001,22.647000000000023,22.479578526106955,22.738653186083813,22.691730769230755,23.65132480321553,21.73213673524598,20.786143749999987,22.091952750000004,22.70330500000001,22.647000000000023,22.586666666666662,5561968,4473802.2,48.62983529726485,1.5272940770645214,1.5,2.75,NaN,NaN,0.6378614477255774,1.2432306461827927,571.0013320834732,0.055745662377973904,0.1481810072852312,0.0924353449072573,30.940427604765674,0.03327417923691342,16.14761656008831,54.30952898873956,29.542854451172143,4951448856
1429536600,22.9225,23.2925,22.88,23.1525,23.201493269230774,23.476666666666667,23.78275,16.2775,23.78275,16.2775,22.995,13.2775,20.6175,6.233271,20.80470624999999,22.102002750000008,22.72785500000001,22.63225000000002,22.505967603514527,22.778067168361545,22.771923076923063,23.69728611139231,21.846560042453817,20.80470624999999,22.102002750000008,22.72785500000001,22.63225000000002,23.10833333333333,3237476,4281497,54.316287728931755,1.4064272791368202,1.5,2.75,NaN,NaN,0.6455142014594648,0.7561551485379997,574.2638568414804,0.055962450085815754,0.162388407514527,0.10642595742871123,32.298429743560554,3.5558537403555768,33.46286727422044,33.231895146260364,33.3052375795192,4954686332
1429623000,23.425,23.4875,22.970025,23.0775,23.272936538461543,23.465833333333332,23.78275,16.2775,23.78275,16.2775,22.995,13.2775,20.6175,6.233271,20.82146874999999,22.109527750000005,22.75520500000001,22.620125000000023,22.52838063867082,22.80658458089854,22.8628846153846,23.647307102985035,22.078462127784167,20.82146874999999,22.109527750000005,22.75520500000001,22.620125000000023,23.178341666666668,2501444,4208345.6,53.52528135452402,1.2151862927482784,1.5,2.75,NaN,NaN,0.6363685442123603,0.5944008020634047,575.2014713033575,0.04740809438887436,0.16568607541480418,0.11827798102592982,31.81942283939473,2.1806508744742072,14.852337252745754,56.27385074707088,28.873812000183353,4952184888
1429709400,23.215,23.4875,22.855025,23.43,23.344379807692313,23.455000000000002,23.78275,16.2775,23.78275,16.2775,22.995,13.2775,20.6175,6.233271,20.840943749999994,22.120977750000005,22.79525500000001,22.64612500000002,22.56373826068373,22.865957477955824,22.967307692307678,23.659004217411162,22.275611167204193,20.840943749999994,22.120977750000005,22.79525500000001,22.64612500000002,23.257508333333334,2893644,4195885.2,56.71580378011845,1.8513802469253042,1.5,2.75,NaN,NaN,0.6360904339114775,0.6896385058390062,576.9423143035,0.06097858803740619,0.19450121607268755,0.13352262803528137,32.34756861835225,2.31441048034935,14.877096381268332,56.23500964725044,28.887893971481226,4955078532
1429795800,23.27,23.857475,23.2225,23.585,23.415823076923083,23.444166666666668,23.78275,16.2775,23.78275,16.2775,22.995,13.2775,20.6175,6.233271,20.86308124999999,22.132377750000003,22.82485500000001,22.72937500000002,22.60378774065692,22.93443771815051,23.04769230769229,23.764500031987634,22.330884583396948,20.86308124999999,22.132377750000003,22.82485500000001,22.72937500000002,23.554991666666666,3531940,4032709,58.07862173039027,2.7458261217777755,1.5,2.75,NaN,NaN,0.6360107600606577,0.8758231749426998,579.7305818821634,0.07496214978406099,0.2272253152653576,0.15226316548129662,31.77650882532968,1.440860215053767,39.55250572702397,27.505486154560376,32.94200811841566,4958610472
1429882200,23.7725,23.855,23.5795,23.76,23.487266346153852,23.433333333333334,23.78275,16.2775,23.78275,16.2775,22.995,13.2775,20.6175,6.233271,20.884918749999994,22.14692775000001,22.856905000000012,22.82937500000002,22.64912939788606,23.01306269737427,23.155576923076904,23.84608441160688,22.465069434546926,20.884918749999994,22.14692775000001,22.856905000000012,22.82937500000002,23.7315,3410488,3952198.6,59.62430166414588,2.4841221169795076,1.5,2.75,NaN,NaN,0.6102599914848964,0.8629343677212982,580.4833545348724,0.08957707257237152,0.26423450619676103,0.1746574336243895,30.987735720816673,3.597122302158286,81.25467171277649,3.042348652669395,15.702979634554119,4962020960
1430141400,23.9925,24.03,23.3875,23.45,23.558709615384622,24.03,23.78275,16.2775,23.78275,16.2775,22.995,13.2775,20.6175,6.233271,20.90636874999999,22.16317775000001,22.87040500000001,22.90737500000002,22.680536088165038,23.054675773814814,23.222115384615368,23.84307570216902,22.601155067061715,20.90636874999999,22.16317775000001,22.87040500000001,22.90737500000002,23.622500000000002,4161752,3995229.4,55.70602991649753,1.7917995491481358,1.5,2.75,NaN,NaN,0.6125628492359754,1.0416803600814513,577.9025503077534,0.0726658506079787,0.2654897468843629,0.1928238962763842,30.894355439484237,1.6802168021680186,49.67726526523425,19.450218581076413,30.872516153689332,4957859208
1430227800,23.4575,23.698875,22.975,23.665,23.630152884615388,24.04447916666667,23.78275,16.2775,23.78275,16.2775,22.995,13.2775,20.6175,6.233271,20.92841874999999,22.17740275000001,22.88205500000001,22.95562500000002,22.719142516080133,23.112801890594355,23.280961538461522,23.913549441935263,22.64837363498778,20.92841874999999,22.17740275000001,22.88205500000001,22.95562500000002,23.446291666666667,3145124,3964656.4,57.77840031593615,1.4578617659653135,1.5,2.75,NaN,NaN,0.6205137171476913,0.7932904349542119,580.5627989947981,0.07021981940730432,0.28059867053551457,0.21037885112821025,31.102570024018384,1.1865312667022976,72.23807014143114,6.402515694477299,21.359414164091547,4961004332
1430314200,23.3125,23.625,23.0625,23.385,23.701596153846157,24.058958333333333,23.78275,16.2775,23.78275,16.2775,22.995,13.2775,20.6175,6.233271,20.947668749999995,22.186252750000012,22.88610500000001,23.019375000000018,22.74525457427307,23.13872552006156,23.29134615384614,23.92598904369297,22.656703263999308,20.947668749999995,22.186252750000012,22.88610500000001,23.019375000000018,23.3575,4552432,3924785.8,54.22052483639075,0.51700740153595,1.5,2.75,NaN,NaN,0.6192270230657133,1.159918587149393,577.1253447108805,0.04521872577524405,0.26690225834726533,0.22168353257202128,31.174941289896875,0.1498929336188443,41.109752674667654,26.25859255563105,32.63165476970127,4956451900
1430400600,23.1725,23.314225,22.405,22.69,23.773039423076927,24.0734375,23.78275,16.2775,23.78275,16.2775,22.995,13.2775,20.6175,6.233271,20.964006249999994,22.189002750000014,22.87610500000001,23.05912500000002,22.743087728223145,23.095989756246173,23.272499999999983,23.960646898449838,22.58435310155013,20.964006249999994,22.189002750000014,22.87610500000001,23.05912500000002,22.803075000000003,5361676,3855050.4,46.557104455944085,2.1695277631468413,1.5,2.75,NaN,NaN,0.6449965214181624,1.3908186518132162,572.7435642508392,-0.01919623849127744,0.1976882344579245,0.21688447294920193,35.68156923125,0.6319991129837093,14.739167734771828,56.57962349972311,28.681208765505055,4951090224
1430487000,23.0075,23.4275,22.955,23.3925,23.844482692307697,24.08791666666667,23.78275,16.2775,23.78275,16.2775,22.995,13.2775,20.6175,6.233271,20.982818749999993,22.197577750000015,22.88100500000001,23.12512500000002,22.768554876135962,23.12422882707987,23.297884615384596,23.97746549910249,22.618303731666703,20.982818749999993,22.197577750000015,22.88100500000001,23.12512500000002,23.25833333333333,3911728,3917739,53.683086884931946,0.34411119738087864,1.5,2.75,NaN,NaN,0.6516039127454364,0.99846569666841,575.0665787571212,-0.01570937713467377,0.19724775153085972,0.21295712866553348,33.862811274610785,1.0366051182377645,16.148269298005456,54.411602682015534,29.440128019979007,4955001952
1430746200,23.585,23.84,23.525,23.6175,23.915925961538466,24.102395833333336,23.78275,16.2775,23.78275,16.2775,22.995,13.2775,20.6175,6.233271,21.006081249999994,22.212927750000013,22.88230500000001,23.17900000000002,22.80184684177769,23.171207034024647,23.315576923076907,24.015247597933612,22.615906248220202,21.006081249999994,22.212927750000013,22.88230500000001,23.17900000000002,23.66083333333333,2504160,3813897.8,55.719599838125646,1.6597630629170061,1.5,2.75,NaN,NaN,0.6370250618350483,0.6565881235726873,577.329057902039,-0.00028288361330400247,0.2126035241489035,0.2128864077622075,30.970994899505047,2.3399415014624596,33.1672230578219,33.502069329509794,33.33070761266831,4957506112
1430832600,23.5125,23.655,22.74925,22.7875,23.987369230769236,24.116875,23.78275,16.2775,23.78275,16.2775,22.995,13.2775,20.6175,6.233271,21.022381249999995,22.22055275000001,22.86720500000001,23.20050000000002,22.801284220531503,23.134663506974682,23.272307692307677,24.02562717080693,22.518988213808424,21.022381249999995,22.22055275000001,22.86720500000001,23.20050000000002,23.06391666666667,5709320,3694202.4,47.43410359249458,1.450571610667015,1.5,2.75,NaN,NaN,0.6562197002754021,1.5454811030386424,572.728333321425,-0.045508532820291436,0.1560007417368432,0.20150927455713463,37.830181350406875,-2.742210840802383,11.2134604543555,62.34811092116202,26.43842862448249,4951796792
1430919000,23.02,23.134375,22.097525,22.525,22.097525,24.131354166666668,23.78275,16.2775,23.78275,16.2775,22.995,13.2775,20.6175,6.233271,21.03788124999999,22.23597775000001,22.843005000000012,23.19750000000002,22.790449545216543,23.076600315834238,23.270576923076906,24.030622857534297,22.510530988619514,21.03788124999999,22.23597775000001,22.843005000000012,23.19750000000002,22.585633333333334,5902932,3791113.2,45.147553820650856,3.324608594993493,1.5,2.75,NaN,NaN,0.6834075788271589,1.5570445113588272,570.9900012573122,-0.09005871943062305,0.08893587526885582,0.17899459469947887,36.680310338155074,-4.494382022471919,10.054750485119486,64.48468141797616,25.460568096904353,4945893860
1431005400,22.475,22.95,22.3525,22.7825,22.11867884615385,24.145833333333336,23.78275,16.2775,23.78275,16.2775,22.995,13.2775,20.6175,6.233271,21.053356249999993,22.25100275000001,22.825255000000013,23.191625000000023,22.790137798345306,23.048590761945263,23.242115384615367,24.044261175492863,22.43996959373787,21.053356249999993,22.25100275000001,22.825255000000013,23.191625000000023,22.694999999999997,2841000,3745150.2,47.80550657720137,1.6321393628147884,1.5,2.75,NaN,NaN,0.6772713231966475,0.7585810577103156,573.5219884026409,-0.09845969754967748,0.05591997276238203,0.1543796703120595,37.27775136050041,-4.11405723905725,27.187096034490267,39.886272746397594,32.92663121911213,4948734860
1431091800,23.42,23.755,23.4125,23.6725,22.139832692307692,24.1603125,23.78275,16.2775,23.78275,16.2775,22.995,13.2775,20.6175,6.233271,21.072643749999994,22.28527775000001,22.82705500000001,23.21275000000002,22.824740237625882,23.108010689379046,23.2878846153846,24.11475509671732,22.461014134051876,21.072643749999994,22.28527775000001,22.82705500000001,23.21275000000002,23.613333333333333,5646424,3875733.2,55.78100108462181,2.1158995654775037,1.5,2.75,NaN,NaN,0.6983590858254585,1.4568660195701808,578.4005127697011,-0.04317357702624833,0.1004126990292491,0.14358627605549742,44.14680732807696,0.9488272921108748,32.906479716583185,33.76437217455228,33.329148108864544,4954381284
1431351000,23.625,23.7725,23.313775,23.335,22.16098653846154,24.174791666666668,23.78275,16.2775,23.78275,16.2775,22.995,13.2775,20.6175,6.233271,21.090243749999996,22.32032775000001,22.82690500000001,23.23275000000002,22.84475042438565,23.129628718961996,23.280576923076904,24.103966152108477,22.45718769404533,21.090243749999996,22.32032775000001,22.82690500000001,23.23275000000002,23.473758333333336,2749268,3876344.2,52.50458806674873,1.2618201546538685,1.5,2.75,NaN,NaN,0.6812423654093543,0.7092424867740073,575.0083649741788,-0.029105587712686426,0.10720429141463939,0.1363098791273258,44.281650720916716,-1.394464398901324,19.603936467895746,49.359321632796956,31.036741899307287,4951632016
1431437400,23,23.346,22.6775,23.115,22.182140384615387,24.189270833333335,23.78275,16.2775,23.78275,16.2775,22.995,13.2775,20.6175,6.233271,21.108093749999995,22.357902750000008,22.81355000000001,23.235375000000023,22.855348446958764,23.128235507632283,23.24442307692306,24.05229814782048,22.43654800602564,21.108093749999995,22.357902750000008,22.81355000000001,23.235375000000023,23.046166666666664,4905672,3956221.6,50.42539308605931,0.6457581002043258,1.5,2.75,NaN,NaN,0.6803321964515435,1.2399891856411682,573.3000420108785,-0.034044878739213025,0.09375378070330953,0.12779865944252256,44.089814648356786,-1.154586273252098,20.96591120041138,47.53578886995476,31.498299929633855,4946726344
1431523800,23.305,23.5525,23.055,23.1425,22.20329423076923,24.20375,23.78275,16.2775,23.78275,16.2775,22.995,13.2775,20.6175,6.233271,21.126043749999994,22.384402750000007,22.80670000000001,23.22312500000002,22.86660929217607,23.129594030714923,23.19692307692306,23.94861643156196,22.44522972228416,21.126043749999994,22.384402750000007,22.80670000000001,23.22312500000002,23.25,3053720,3964321.8,50.68826425036507,0.4102792348724466,1.5,2.75,NaN,NaN,0.6672727538478618,0.7703007359291569,575.6632210952087,-0.03476617209320265,0.08434094432601924,0.11910711641922189,43.69138306411319,1.9942706037902027,49.105719304627705,19.79045464449221,31.10382605088009,4949780064
1431610200,23.54,23.895,23.43,23.855,22.22444807692308,24.218229166666667,23.78275,16.2775,23.78275,16.2775,22.995,13.2775,20.6175,6.233271,21.14876874999999,22.40300275000001,22.81990000000001,23.24837500000002,22.90536971209073,23.198680313503978,23.22807692307691,24.049480866255795,22.406672979898023,21.14876874999999,22.40300275000001,22.81990000000001,23.24837500000002,23.72666666666667,4099916,3984104.2,57.04372628405143,2.359176143214102,1.5,2.75,NaN,NaN,0.6733604142873003,1.0290684666329761,579.6619708998351,0.010988444021029761,0.1328426714455091,0.12185422742447934,42.717307205925785,1.9771294218232431,53.08807128636969,16.96708752668054,29.944841186949777,4953879980
1431696600,23.9025,23.9975,23.7425,23.935,22.245601923076922,24.232708333333335,23.78275,16.2775,23.78275,16.2775,22.995,13.2775,20.6175,6.233271,21.171868749999994,22.41957775000001,22.833500000000008,23.31775000000002,22.945747370440113,23.26880599793217,23.248846153846138,24.12520579064929,22.372486517042987,21.171868749999994,22.41957775000001,22.833500000000008,23.31775000000002,23.891666666666666,2511924,3831602,57.70289604067794,2.21980750961267,1.5,2.75,NaN,NaN,0.6434775275524931,0.6555806161495896,581.7118538725972,0.04308500996800063,0.17571048988448013,0.1326254799164795,39.520046943188056,1.3443421191912734,43.4057299093463,24.234275404003043,32.35999468665065,4956391904
1431955800,23.87,24.265,23.8573,24.16,22.26675576923077,24.247187500000003,23.78275,16.2775,23.78275,16.2775,22.995,13.2775,20.6175,6.233271,21.201893749999996,22.435302750000005,22.87115000000001,23.368125000000024,22.993365120618932,23.353681617176726,23.308461538461525,24.310226401209608,22.306696675713443,21.201893749999996,22.435302750000005,22.87115000000001,23.368125000000024,24.094099999999997,2219296,3780693,59.58147042688835,2.9395986709141155,1.5,2.75,NaN,NaN,0.626636275584458,0.5870077258322747,583.3589857672131,0.07409378144717027,0.22524270672544233,0.15114892527827206,39.50571836868796,6.023038946790998,65.36896994921791,9.626139417740138,25.00489063304195,4958611200
1432042200,24.2325,24.31465,24.0225,24.1225,22.287909615384617,24.261666666666667,23.78275,16.2775,23.78275,16.2775,22.995,13.2775,20.6175,6.233271,21.232531249999997,22.449702750000007,22.90255000000001,23.420375000000025,23.037644919810347,23.426902415540848,23.418653846153834,24.439030125513213,22.398277566794455,21.232531249999997,22.449702750000007,22.90255000000001,23.420375000000025,24.153216666666665,2594904,3785366,59.11026088848203,2.429547319400358,1.5,2.75,NaN,NaN,0.6027443987569967,0.6855094064880384,580.8560463188139,0.08587420191981804,0.2584916776780446,0.17261747575822656,31.542535101363544,7.092119866814651,79.61597665952367,3.5725897160754365,16.811433624400923,4956016296
1432128600,24.1925,24.3875,23.9375,24.0725,22.30906346153846,24.3875,23.78275,16.2775,23.78275,16.2775,22.995,13.2775,20.6175,6.233271,21.260993749999997,22.46335275000001,22.95485000000001,23.452500000000022,23.078227471974646,23.488387899775052,23.470961538461527,24.548716574246452,22.393206502676602,21.260993749999997,22.46335275000001,22.95485000000001,23.452500000000022,24.132500000000004,3259396,3803653.6,58.4465406099882,2.135786167346793,1.5,2.75,NaN,NaN,0.5918340845600684,0.8569118912405693,581.4241583876449,0.08399166991477772,0.2776070631516987,0.19361539323692098,30.077759989177135,5.662240754965446,49.01124867387134,19.87652143486817,31.11222989126048,4952756900
1432215000,24.0175,24.375,23.96,24.2875,22.33021730769231,24.408529411764704,23.78275,16.2775,23.78275,16.2775,22.995,13.2775,20.6175,6.233271,21.29325625,22.477127750000008,23.01465000000001,23.487625000000026,23.125649924054073,23.56449381408219,23.522499999999987,24.684168230142774,22.3608317698572,21.29325625,22.477127750000008,23.01465000000001,23.487625000000026,24.2075,2053152,3729714.2,60.50038803919443,2.210672045577873,1.5,2.75,NaN,NaN,0.5792030785200634,0.5504850747008979,583.0728493284163,0.09036439633671922,0.30657088865782,0.21620649232110078,29.969171802581922,2.5979512092090062,40.018897439470365,27.133742359356848,32.8473602011728,4954810052
1432301400,24.1425,24.305,24.09,24.1075,22.351371153846156,24.429558823529412,23.78275,16.2775,23.78275,16.2775,22.995,13.2775,20.6175,6.233271,21.324481249999998,22.48825275000001,23.054300000000012,23.505000000000027,23.16415384860097,23.616208688931508,23.62403846153845,24.740868691839196,22.507208231237705,21.324481249999998,22.48825275000001,23.054300000000012,23.505000000000027,24.1675,3253096,3721844.6,57.91929881586121,1.7320926331202655,1.5,2.75,NaN,NaN,0.5531885729114874,0.8740547630602309,580.703895910025,0.07616335401422569,0.3114106848388829,0.2352473308246572,22.794623251373494,3.3104778230126457,14.040671235334036,57.609310724471726,28.35001804019425,4951556956
1432647000,23.9175,23.945525,23.176,23.365,22.372525,24.450588235294116,23.78275,16.2775,23.78275,16.2775,22.995,13.2775,20.6175,6.233271,21.35349375,22.49565275000001,23.087600000000013,23.50075000000003,23.172030168263678,23.592284051890413,23.688653846153837,24.62652298452553,22.750784707782145,21.35349375,22.49565275000001,23.087600000000013,23.50075000000003,23.495508333333333,4937716,3760642.8,48.69134763359108,1.7687559459543596,1.5,2.75,NaN,NaN,0.5802108177035242,1.3129978736613859,575.8817423914234,0.01374048654000895,0.2524229389996684,0.23868245245965944,28.523518050024787,1.0815487778498811,2.003781286138033,84.96659262580752,13.02962608805443,4946619240
1432733400,23.535,24.09,23.395,23.99,22.393678846153847,24.47161764705882,23.78275,16.2775,23.78275,16.2775,22.995,13.2775,20.6175,6.233271,21.38260625,22.516252750000007,23.11565000000001,23.517000000000028,23.204107416567062,23.630161761234184,23.78153846153845,24.5691798736562,22.9938970494207,21.38260625,22.516252750000007,23.11565000000001,23.517000000000028,23.825,3112700,3759021.6,55.16653761694669,0.9243975259963436,1.5,2.75,NaN,NaN,0.5905529021532726,0.8280612167804515,579.9632973535782,0.011604761057003837,0.25318840378091423,0.2415836427239104,31.382490680785533,3.6620935508264023,13.13889061137336,59.04721758519617,27.813891803430476,4949731940
1432819800,23.885,23.9614,23.6375,23.9325,22.414832692307694,24.49264705882353,23.78275,16.2775,23.78275,16.2775,22.995,13.2775,20.6175,6.233271,21.410618749999998,22.536477750000007,23.14690000000001,23.544375000000027,23.23267183160365,23.65895587921188,23.80153846153845,24.590292441076233,23.012784482000665,21.410618749999998,22.536477750000007,23.14690000000001,23.544375000000027,23.8438,2888788,3675839.4,54.48527653885188,0.3947504364105625,1.5,2.75,NaN,NaN,0.5735491234280387,0.7858852592961488,577.6468191152666,0.003785801323592991,0.24631589437840162,0.24253009305480863,31.554877807745836,0.3248794801928341,13.82003703627607,57.92627743404815,28.253685529675767,4946843152
1432906200,23.8925,23.8925,23.36,23.465,22.43598653846154,24.513676470588234,24.2875,16.2775,23.78275,16.2775,22.995,13.2775,20.6175,6.233271,21.43660625,22.563777750000007,23.15270000000001,23.583125000000027,23.24178274016821,23.64048389071551,23.81153846153845,24.579398971861526,23.043677951215376,21.43660625,22.563777750000007,23.15270000000001,23.583125000000027,23.5725,3533340,3584422.6,49.16877778037965,0.7562600029096876,1.5,2.75,NaN,NaN,0.5734741860403217,0.9857487228207968,574.2798123297258,-0.033359287518227615,0.20083098365702412,0.23419027117525174,28.86782888218187,-1.9636515562983032,3.8978360191582486,78.62123868664656,17.480925294195185,4943309812
1433165400,23.7425,23.8675,23.2925,23.6025,22.457140384615386,24.534705882352938,24.2875,16.2775,23.78275,16.2775,22.995,13.2775,20.6175,6.233271,21.46138125,22.59817775000001,23.168000000000006,23.593625000000028,23.255928515063577,23.636866377314036,23.84903846153845,24.51847720022338,23.179599722853517,21.46138125,22.59817775000001,23.168000000000006,23.593625000000028,23.587499999999995,3552444,3566458.4,50.69270253271894,0.5784813472961671,1.5,2.75,NaN,NaN,0.5735831727517272,0.996070499518514,575.7000566809182,-0.04825249983340199,0.17387464638349925,0.22212714621690124,29.060197038473337,-2.3075331125827856,17.81701960620824,51.80667648635877,30.376303907433005,4946862256
1433251800,23.4125,23.815,23.1775,23.52,22.478294230769233,24.555735294117646,24.2875,16.2775,23.78275,16.2775,22.995,13.2775,20.6175,6.233271,21.484568750000005,22.62425275000001,23.169450000000005,23.588750000000026,23.266284259570888,23.62573624614127,23.87807692307691,24.447716329416078,23.308437516737744,21.484568750000005,22.62425275000001,23.169450000000005,23.588750000000026,23.504166666666666,4184068,3650453.8,49.72935773841451,0.8018442414131142,1.5,2.75,NaN,NaN,0.5781486604123184,1.146177497164873,577.4901128463133,-0.062347849065019306,0.1441923348856271,0.2065401839506464,28.246254751341507,-2.4976681521401147,19.427503844788017,49.551189978104226,31.021306177107753,4942678188
1433338200,23.75,23.9775,23.535,23.7275,22.499448076923077,24.57676470588235,24.2875,16.2775,23.78275,16.2775,22.995,13.2775,20.6175,6.233271,21.50875625,22.641277750000008,23.177600000000005,23.635750000000026,23.28437115135242,23.635428032223054,23.86826923076922,24.443522969483993,23.293015492054444,21.50875625,22.641277750000008,23.177600000000005,23.635750000000026,23.74666666666667,3149000,3522437.8,52.190298598314726,0.20627305458373665,1.5,2.75,NaN,NaN,0.5695308989542957,0.8939831386092894,578.1086665591404,-0.056554985808045355,0.13584645169058973,0.1924014374986351,29.008433523180578,-1.4331706303873815,19.434556326149085,49.54153144150288,31.023912232348014,4945827188
1433424600,23.4575,23.675,22.995,23.17,22.520601923076924,24.59779411764706,24.2875,16.2775,23.78275,16.2775,22.995,13.2775,20.6175,6.233271,21.52794375,22.65832775000001,23.182800000000007,23.668000000000028,23.27988600816213,23.591101552963714,23.809423076923068,24.491859757125127,23.12698639672101,21.52794375,22.65832775000001,23.182800000000007,23.668000000000028,23.28,6186936,3536638,45.71503759510992,2.228597986593329,1.5,2.75,NaN,NaN,0.5811715490289887,1.7493834540034914,573.6980556749098,-0.0872918602940645,0.08328661213105448,0.17057847242511898,31.668795179774104,-4.601132269686051,13.599759724995733,58.25751612241369,28.142724152590574,4939640252
1433511000,23.0825,23.2635,22.75,22.99,22.541755769230768,24.618823529411763,24.2875,16.2775,23.78275,16.2775,22.995,13.2775,20.6175,6.233271,21.54476875,22.678602750000003,23.204200000000004,23.678375000000027,23.268517929410674,23.533853786014788,23.719423076923064,24.495376965933115,22.943469187913013,21.54476875,22.678602750000003,23.204200000000004,23.678375000000027,23.001166666666666,5020840,3645630,43.824452153082994,2.3089781296557312,1.5,2.75,NaN,NaN,0.5763378669554895,1.3772214953245392,571.9263647061207,-0.11502346504983235,0.02679914111282855,0.1418226061626609,30.651745733128102,-4.63548688167584,11.818323918013618,61.2758083350687,26.905867746917682,4934619412
1433770200,22.955,23.015,22.5425,22.575,22.562909615384616,24.639852941176468,24.2875,16.2775,23.78275,16.2775,22.995,13.2775,20.6175,6.233271,21.55865625,22.69660275,23.220500000000005,23.62350000000003,23.241321147865158,23.442534377822902,23.600384615384602,24.548234096606834,22.65253513416237,21.55865625,22.69660275,23.220500000000005,23.62350000000003,22.710833333333337,3946832,3560650.4,39.743482013566606,3.1854988237657986,1.5,2.75,NaN,NaN,0.5689208764586688,1.1084581625873746,568.6097399157653,-0.15415267766827162,-0.05086824092267861,0.103284436745593,31.512158400253238,-3.3811256152364613,2.324775218564011,83.72433479929467,13.950889982141312,4930672580
1433856600,22.5775,22.77,22.32,22.5425,22.32,24.660882352941176,24.2875,16.2775,23.78275,16.2775,22.995,13.2775,20.6175,6.233271,21.571456249999997,22.71797775,23.233550000000005,23.583875000000027,23.213916396968486,23.356816818030246,23.482692307692297,24.54041384574993,22.424970769634662,21.571456249999997,22.71797775,23.233550000000005,23.583875000000027,22.54416666666667,4368048,3641589.4,39.43378619165081,3.2351915701738765,1.5,2.75,NaN,NaN,0.5604265281401924,1.1994894317300022,566.8387102195888,-0.17361287055871633,-0.1137316514528024,0.059881219105913916,27.33378824160485,-6.033764068361809,2.32423251872482,83.72633899690831,13.94942848436688,4926304532
1433943000,22.905,23.52,22.8275,23.37,22.329672826086956,24.68191176470588,24.2875,16.2775,23.78275,16.2775,22.995,13.2775,20.6175,6.233271,21.588931249999995,22.753127749999997,23.246950000000002,23.596625000000028,23.220037322577564,23.358072359170222,23.412115384615372,24.362621011503276,22.46160975772747,21.588931249999995,22.753127749999997,23.246950000000002,23.596625000000028,23.239166666666666,6863420,3739476.8,50.096540674209415,0.8108203860143505,1.5,2.75,NaN,NaN,0.5902174904158929,1.835395796545656,568.6723944399942,-0.12444587773466027,-0.09567612806241144,0.02876974967224884,31.44855899545323,-2.3503603885929176,8.611298049700421,67.3134513185028,24.075250631796777,4933167952
1434029400,23.55,23.74475,23.454,23.59,22.339345652173915,24.702941176470585,24.2875,16.2775,23.78275,16.2775,22.995,13.2775,20.6175,6.233271,21.60596875,22.7830275,23.27655,23.619000000000028,23.23454566286864,23.380160705915916,23.37230769230768,24.24298042411749,22.501634960497867,21.60596875,22.7830275,23.27655,23.619000000000028,23.59625,3692572,3771419.4,52.49124550738115,1.1265323295557528,1.5,2.75,NaN,NaN,0.5748269553861862,0.9790934415832936,571.2823525216726,-0.07332770288378085,-0.06288987893247722,0.010437823951303628,32.193082542828655,0.5327082889409759,26.718311099404264,40.420088599969205,32.86160030062652,4936860524
1434115800,23.26,23.31615,22.9425,23.0575,22.34901847826087,24.723970588235293,24.2875,16.2775,23.78275,16.2775,22.995,13.2775,20.6175,6.233271,21.620118749999996,22.8061775,23.2998,23.579125000000026,23.22760269569732,23.349431114876307,23.34865384615383,24.235395104453904,22.461912587853757,21.620118749999996,22.8061775,23.2998,23.579125000000026,23.105383333333336,4469672,3789907.2,46.6553870507941,1.0692878960058332,1.5,2.75,NaN,NaN,0.5800178871443159,1.1793618587811332,568.5647828012817,-0.07152192748887704,-0.07896458540979268,-0.007442657920915634,32.87856407946167,-2.3090774282385262,27.999118168349497,38.96985103992123,33.031030791729265,4932390852
1434375000,22.625,22.865,22.325,22.7225,22.358691304347825,24.744999999999997,24.2875,16.2775,23.78275,16.2775,22.995,13.2775,20.6175,6.233271,21.632681249999997,22.822752499999996,23.312800000000003,23.518500000000028,23.207794746846446,23.289723389649993,23.251153846153834,24.112757037403494,22.389550654904173,21.632681249999997,22.822752499999996,23.312800000000003,23.518500000000028,22.6375,7172688,4022945.4,43.387322680029364,2.5204754654746067,1.5,2.75,NaN,NaN,0.5909094666340078,1.782944406851756,567.1421316949971,-0.08795186891901748,-0.11738249406968748,-0.029430625150670003,33.244945433864885,-3.3907312925170046,21.33305568822458,47.00387695327153,31.66306735850388,4925218164
1434461400,22.6875,23.155,22.6225,23.12,22.368364130434784,24.766029411764702,24.2875,16.2775,23.78275,16.2775,22.995,13.2775,20.6175,6.233271,21.647418749999996,22.834002499999997,23.3244,23.46650000000003,23.204351815597565,23.273559257302374,23.188653846153834,23.95623900901755,22.421068683290116,21.647418749999996,22.834002499999997,23.3244,23.46650000000003,22.965833333333336,3422436,4083102.4,48.038348600317455,1.001270941992991,1.5,2.75,NaN,NaN,0.5867373618744359,0.8381949960402659,569.9138176423321,-0.06800342084505392,-0.1144349012069874,-0.04643148036193348,35.39049177038074,-2.5603203034453617,40.08354198538446,27.013587498219767,32.90287051639576,4928640600
1434547800,23.26,23.4675,22.83,23.23,22.37803695652174,24.78705882352941,24.2875,16.2775,23.78275,16.2775,22.995,13.2775,20.6175,6.233271,21.661906249999994,22.850027499999996,23.34185,23.42187500000003,23.2053576267506,23.26941075660691,23.17057692307691,23.92218073095954,22.418973115194284,21.661906249999994,22.850027499999996,23.34185,23.42187500000003,23.175833333333337,6564328,4281573.6,49.280153117237305,0.3230858774666343,1.5,2.75,NaN,NaN,0.5903632645976907,1.5331578090821563,570.9557937868356,-0.04449201840351831,-0.10204650336633136,-0.057554484962813054,35.02712948873691,0.25895554596460385,39.23077946963477,27.76726703613252,33.0019534942327,4935204928
1434634200,23.48,24.1375,23.43,23.9325,22.387709782608695,24.808088235294115,24.2875,16.2775,23.78275,16.2775,22.995,13.2775,20.6175,6.233271,21.680106249999994,22.871377499999994,23.368799999999997,23.41487500000003,23.23387301393685,23.332562113120538,23.195961538461525,24.022733617698552,22.369189459224497,21.680106249999994,22.871377499999994,23.368799999999997,23.41487500000003,23.833333333333332,6645056,4450856.6,56.439897395536796,2.7109658570255197,1.5,2.75,NaN,NaN,0.6130158885549984,1.4929836202766003,572.6472509072889,0.017933440364696497,-0.035137684506942435,-0.05307112487163893,36.368401134269625,4.099608525445857,46.35004126820117,21.83797058902186,31.811988142776965,4941849984
1434720600,23.8725,23.8825,23.5075,23.5075,22.39738260869565,24.82911764705882,24.2875,16.2775,23.78275,16.2775,22.995,13.2775,20.6175,6.233271,21.696306249999992,22.897227499999996,23.380949999999995,23.37587500000003,23.244603483978544,23.349222864251914,23.19499999999999,24.02029015876468,22.3697098412353,21.696306249999992,22.897227499999996,23.380949999999995,23.37587500000003,23.632500000000004,2579240,4477161,51.686300906044615,1.2941136620363094,1.5,2.75,NaN,NaN,0.5995861822296416,0.5760882845178005,570.1783973078955,0.029481740153547903,-0.016218949679704053,-0.045700689833251956,37.91863693830963,4.130675526024368,52.36306737551208,17.42947021224365,30.207462412244283,4939270744
1434979800,24.01,24.2275,23.92,23.99,22.40705543478261,24.2275,24.2875,16.2775,23.78275,16.2775,22.995,13.2775,20.6175,6.233271,21.715493749999993,22.936077499999993,23.395749999999992,23.370000000000026,23.273834719900954,23.410249258132684,23.215192307692295,24.102150076044452,22.328234539340137,21.715493749999993,22.936077499999993,23.395749999999992,23.370000000000026,24.045833333333334,4541980,4541605.2,56.196898003673816,2.572682416047424,1.5,2.75,NaN,NaN,0.6081871692132385,1.000082525887543,572.924180591896,0.0663831764560783,0.037278280736845915,-0.02910489571923238,36.75001241434849,6.421204391704549,88.16027430813156,1.2681886199415786,10.571537071926851,4943812724
1435066200,24.1,24.175,23.890425,24.0475,22.416728260869565,24.22022727272727,24.2875,16.2775,23.78275,16.2775,22.995,13.2775,20.6175,6.233271,21.73350624999999,22.96985249999999,23.417999999999992,23.40412500000003,23.304174534806798,23.47093980497719,23.282692307692294,24.27314182012914,22.292242795255447,21.73350624999999,22.96985249999999,23.417999999999992,23.40412500000003,24.03764166666667,2542188,4421828.8,56.715520269389074,2.164828976178307,1.5,2.75,NaN,NaN,0.5850720142694357,0.5749177806250663,575.0433571043434,0.0899672254762095,0.08335413612602949,-0.006613089350180006,36.52865918977782,2.899015832263579,87.72909639173268,1.3580443738896537,10.91285923437766,4946354912
1435152600,23.93,24.0875,23.52,23.5275,22.42640108695652,24.212954545454544,24.2875,16.2775,23.78275,16.2775,22.995,13.2775,20.6175,6.233271,21.749656249999994,23.006152499999995,23.427299999999992,23.381000000000025,23.312932396186923,23.476326490217456,23.324038461538446,24.307009895628312,22.34106702744858,21.749656249999994,23.006152499999995,23.427299999999992,23.381000000000025,23.71166666666667,2460684,4389228,50.851805329071965,0.8208267862504575,1.5,2.75,NaN,NaN,0.5838168703930473,0.5606188605376617,571.9205378652583,0.06690812496791354,0.07702206685971191,0.01011394189179838,34.42693096990421,-0.26494277236117,67.45359672146667,8.544271387911236,24.002131890622078,4943894228
1435239000,23.7225,23.77,23.2925,23.305,22.43607391304348,24.205681818181816,24.2875,16.2775,23.78275,16.2775,22.995,13.2775,20.6175,6.233271,21.766681249999998,23.033127499999992,23.42564999999999,23.349625000000024,23.31262132182665,23.46000968162532,23.380192307692294,24.263989755637287,22.4963948597473,21.766681249999998,23.033127499999992,23.42564999999999,23.349625000000024,23.455833333333334,2605876,4375082.4,48.53933532024526,0.3467713654780857,1.5,2.75,NaN,NaN,0.5762228082221154,0.5956175819682847,569.1257550810673,0.034656055949995226,0.053434011829292416,0.01877795587929719,34.385735420996596,1.0734034479019785,31.98901172869941,34.700654232552246,33.31033403874835,4941288352
1435325400,23.46,23.53285,23.075,23.295,22.445746739130435,24.19840909090909,24.2875,16.2775,24.2875,16.2775,23.78275,13.2775,22.995,6.233271,21.78249375,23.051102499999992,23.424549999999996,23.341125000000027,23.311930289598155,23.44429447385148,23.43807692307691,24.182396834255908,22.69375701189791,21.78249375,23.051102499999992,23.424549999999996,23.341125000000027,23.30095,3094936,4353162.2,48.432733803270246,0.7420790142412246,1.5,2.75,NaN,NaN,0.5677676076348214,0.7109627111987694,566.631694339415,0.011814984519122895,0.03354668652820081,0.021731702009077914,31.523553610603837,2.51952910111124,29.977147411648026,36.810968234866365,33.21188435348561,4938193416
1435584600,22.7225,22.9575,21.8125,21.83,22.45541956521739,24.191136363636364,24.2875,16.2775,24.2875,16.2775,23.78275,13.2775,22.995,6.233271,21.79070625,23.056752499999995,23.410199999999996,23.252500000000026,23.25381537628058,23.29055214300848,23.319615384615368,24.45632934997924,22.182901419251497,21.79070625,23.056752499999995,23.410199999999996,23.252500000000026,22.2,8873496,4619214.8,35.96959533983963,5.260753046317107,1.5,2.75,NaN,NaN,0.6331056356609057,1.9209966161348462,558.7144393334632,-0.09681171883236778,-0.09928294653138181,-0.00247122769901403,48.99696446818494,-5.579584775086517,2.2168990284135663,84.13460274024708,13.64849823133937,4929319920
1435671000,22.4375,22.4675,21.785,21.9925,22.46509239130435,24.183863636363636,24.2875,16.2775,24.2875,16.2775,23.78275,13.2775,22.995,6.233271,21.80150625,23.05742749999999,23.386999999999997,23.176125000000027,23.204352028191146,23.166928129388623,23.196730769230758,24.520037211755845,21.87342432670567,21.80150625,23.05742749999999,23.386999999999997,23.176125000000027,22.081666666666667,9398368,4879929.8,37.87912506883486,4.408042222652531,1.5,2.75,NaN,NaN,0.6366338045422697,1.9259227868400894,561.8482090793943,-0.14942890168756634,-0.18925735480847194,-0.03982845312090562,47.732267790691964,-5.3271631510977215,16.284387262031956,54.063139158498416,29.652473579469632,4938718288
1435757400,22.5875,22.655,22.2,22.465,22.474765217391305,24.17659090909091,24.2875,16.2775,24.2875,16.2775,23.78275,13.2775,22.995,6.233271,21.814893749999996,23.06497749999999,23.374749999999995,23.113000000000024,23.17535783100718,23.100077831351612,23.151153846153832,24.530144022088905,21.77216367021876,21.814893749999996,23.06497749999999,23.374749999999995,23.113000000000024,22.44,6888896,5066924.6,43.18476883048241,2.6317337942260517,1.5,2.75,NaN,NaN,0.6384813899321077,1.3595813128934267,565.0354550042275,-0.1440580680325969,-0.21990103816165174,-0.07584297012905485,49.85364099494443,-6.131829102684638,37.48509770677651,29.360771705108597,33.1541305881149,4945607184
1435843800,22.6625,22.7262,22.26,22.41,22.48443804347826,24.16931818181818,24.2875,16.2775,24.2875,16.2775,23.78275,13.2775,22.995,6.233271,21.825756249999994,23.07480249999999,23.354349999999997,23.075000000000024,23.14534379841866,23.03435613312765,23.12711538461537,24.545489109579506,21.70874165965123,21.825756249999994,23.07480249999999,23.354349999999997,23.075000000000024,22.4654,3220544,4918605,42.727310396940965,2.2249004952856373,1.5,2.75,NaN,NaN,0.6261755763655283,0.6547677644372744,564.6046801090569,-0.135958497205514,-0.24579109163594737,-0.10983259443043336,45.24192690682501,-4.668722748059131,36.30322267675536,30.462811525983295,33.23396579726134,4942386640
1436189400,21.9125,22.52,21.848575,22.2275,22.494110869565215,24.162045454545453,24.2875,16.2775,24.2875,16.2775,23.78275,13.2775,22.995,6.233271,21.835356249999997,23.07602749999999,23.327199999999994,23.036875000000027,23.10934992397087,22.957512691877398,23.058461538461525,24.555770070540564,21.561153006382487,21.835356249999997,23.07602749999999,23.327199999999994,23.036875000000027,22.198691666666665,4530580,4894092,41.16892306740583,3.211010046931082,1.5,2.75,NaN,NaN,0.6294076780537049,0.9257243223053429,561.1467699226664,-0.13440007489008066,-0.2778326880430342,-0.14343261315295353,44.69150169486606,-7.346811171321382,32.08061713775877,34.62143010802941,33.29795275421182,4937856060
1436275800,22.3025,22.69,21.395,22.625,21.395,24.154772727272725,24.2875,21.83,24.2875,16.2775,23.78275,13.2775,22.995,6.233271,21.845393749999992,23.080702499999994,23.304499999999994,23.039375000000028,23.090355809305347,22.925844816460504,23.01192307692306,24.52256119202307,21.501284961823053,21.845393749999992,23.080702499999994,23.304499999999994,23.039375000000028,22.236666666666668,8124664,5102983.6,45.805367666123665,2.3544809739072328,1.5,2.75,NaN,NaN,0.6769499867641546,1.5921399394660019,563.2721502131816,-0.0997026428403327,-0.2680609167033694,-0.1683582738630367,44.16439221595358,-5.915375818692169,69.93344351451299,7.375352877411682,22.691203608075345,4945980724
1436362200,22.1225,22.228,21.4175,21.5025,21.346315789473685,24.1475,24.2875,21.83,24.2875,16.2775,23.78275,13.2775,22.995,6.233271,21.84999374999999,23.067977499999994,23.265549999999994,22.987375000000025,23.02808695403847,22.79028816727379,22.824999999999985,24.43202903137817,21.2179709686218,21.84999374999999,23.067977499999994,23.265549999999994,22.987375000000025,21.715999999999998,7502928,5259727.6,36.94967067302435,4.495997842174388,1.5,2.75,NaN,NaN,0.7148464162810007,1.4264860408360311,557.6209107087448,-0.14282882473329864,-0.34689430477966,-0.20406548004636135,50.616908672581175,-8.606949314631807,32.97632969255495,33.7109382217369,33.31273208570814,4938477796
1436448600,22.2875,22.38625,21.595,21.6075,21.297631578947367,24.140227272727273,24.2875,21.83,24.2875,16.2775,23.78275,13.2775,22.995,6.233271,21.85754374999999,23.053227499999995,23.224399999999996,22.899250000000027,22.972377661723236,22.677641675152476,22.67884615384614,24.35511216837942,21.00258013931286,21.85754374999999,23.053227499999995,23.224399999999996,22.899250000000027,21.862916666666667,6830188,5258066,38.15416420069006,3.0889557695516285,1.5,2.75,NaN,NaN,0.7269109579752149,1.2989924432291264,560.3942404808222,-0.153810876315099,-0.3963290754402351,-0.2425181991251361,50.87737229390619,-7.283844668526059,32.26742302317084,34.43018163067988,33.30239534614927,4945307984
1436535000,22.43,22.58,22.12,22.4175,21.248947368421053,24.132954545454545,24.2875,21.83,24.2875,16.2775,23.78275,13.2775,22.995,6.233271,21.870843874999988,23.045577499999993,23.205049999999996,22.840625000000028,22.950617753420364,22.652866277518907,22.5578846153846,24.055681518215614,21.06008771255359,21.870843874999988,23.045577499999993,23.205049999999996,22.840625000000028,22.372500000000002,8656536,5506264.2,46.62515384380702,0.4322797632753027,1.5,2.75,NaN,NaN,0.7444530324055564,1.572125071659293,564.8907269763648,-0.09872789337092935,-0.3659280658387978,-0.2672001724678684,57.090996528849026,-3.766902768834519,56.45680745581786,14.730274232219037,28.812918311963113,4953964520
1436794200,22.9375,23.20925,22.8975,23.1575,21.200263157894735,24.125681818181818,24.2875,21.83,24.2875,16.2775,23.78275,13.2775,22.995,6.233271,21.885468874999987,23.045252499999993,23.214399999999998,22.84562500000003,22.958730782697998,22.700926632040915,22.489423076923064,23.77492680017135,21.203919353674777,21.885468874999987,23.045252499999993,23.214399999999998,22.84562500000003,23.088083333333334,3819944,5473777.8,52.96368156201704,2.4685214484906934,1.5,2.75,NaN,NaN,0.747831387233731,0.6978624525094899,569.0797148072876,-0.009366383292184755,-0.27890815158309934,-0.2695417682909146,60.81150159762531,6.081081081081084,75.13488473733975,5.165251531936955,19.6998637307233,4957784464
1436880600,23.165,23.5925,23.1425,23.4625,21.15157894736842,24.11840909090909,24.2875,21.83,24.2875,16.2775,23.78275,13.2775,22.995,6.233271,21.906568874999984,23.048402499999995,23.215799999999998,22.882625000000026,22.97848643827847,22.7734574289894,22.484423076923065,23.754146174910233,21.214699978935897,21.906568874999984,23.048402499999995,23.215799999999998,22.882625000000026,23.399166666666662,5274540,5378870.4,55.31888570149967,3.5388945180726905,1.5,2.75,NaN,NaN,0.7265577167170362,0.9806036598316256,571.4821743970699,0.0690564296093249,-0.1832212312792585,-0.2522776608885834,45.07824882775097,6.684096851199268,72.72225097174416,6.142579749409487,21.135169278846377,4963059004
1436967000,23.475,23.665,23.2575,23.4425,21.102894736842103,24.111136363636362,24.2875,21.5025,24.2875,16.2775,23.78275,13.2775,22.995,6.233271,21.925293874999984,23.047302499999997,23.2123,22.898750000000028,22.99668304854206,22.837175769085647,22.494999999999987,23.793845641329238,21.196154358670736,21.925293874999984,23.047302499999997,23.2123,22.898750000000028,23.455,4928184,5454157.8,55.12396832906305,2.853113113170849,1.5,2.75,NaN,NaN,0.7037678798086764,0.9035646163372831,569.0240138670212,0.11561389128557603,-0.10776029678161336,-0.2233741880671894,45.31309198298729,4.35121299799688,79.90847713585073,3.461135105978067,16.630387758171178,4958130820
1437053400,23.8375,24,23.7675,23.9475,21.05421052631579,24.103863636363634,24.2875,21.5025,24.2875,16.2775,23.78275,13.2775,22.995,6.233271,21.947143874999984,23.051352499999997,23.235500000000002,22.934625000000025,23.03396998781492,22.942920933934634,22.545192307692293,24.00435495157466,21.086029663809928,21.947143874999984,23.051352499999997,23.235500000000002,22.934625000000025,23.905,5479572,5399920,59.04771804540405,4.14561164959972,1.5,2.75,NaN,NaN,0.6933201741080567,1.0147505888976134,573.1338083824323,0.1729989151343967,-0.00712554414919353,-0.18012445928359022,45.31984311366457,6.860776439089698,79.33713382222122,3.6487783914764567,17.014087786302344,4963610392
1437139800,24,24.0825,23.8375,24.0575,21.005526315789474,24.096590909090907,24.2875,21.5025,24.2875,16.2775,23.78275,13.2775,22.995,6.233271,21.970381374999985,23.054577499999997,23.266149999999996,22.940875000000027,23.074108419665315,23.049071321178953,22.71653846153845,24.31592841550592,21.117148507570978,21.970381374999985,23.054577499999997,23.266149999999996,22.940875000000027,23.992500000000003,2383448,5186839.6,59.870781918350126,3.7106563386223446,1.5,2.75,NaN,NaN,0.6612973045289099,0.45951835487644543,569.9288529801787,0.2085599506841847,0.08057547907164064,-0.12798447161254406,44.99711310692637,8.233044651895183,72.97507322568804,6.036558980083366,20.988367794228594,4965993840
1437399000,24.1425,24.2825,23.9725,24.1025,20.956842105263156,24.2825,24.2875,21.5025,24.2875,16.2775,23.78275,13.2775,22.995,6.233271,21.997743874999983,23.058902499999995,23.292549999999995,22.970625000000027,23.114437501247068,23.149397862019054,22.87884615384614,24.576613483407364,21.181078824284917,21.997743874999983,23.058902499999995,23.292549999999995,22.970625000000027,24.11916666666666,2951228,5205439,60.22298418193584,3.824070540664621,1.5,2.75,NaN,NaN,0.636204639919702,0.5669508373837442,566.6558006910869,0.2239544664606042,0.1519586114632112,-0.071995854997393,44.11239149614619,6.530386740331488,73.28977481749317,5.942198334410295,20.76802684809653,4968945068
1437485400,24.03,24.135,23.6875,23.8075,20.908157894736842,24.285394736842104,24.2875,21.5025,24.2875,16.2775,23.78275,13.2775,22.995,6.233271,22.023618874999983,23.061152499999995,23.295249999999996,22.961500000000026,23.14161642276679,23.212074256112476,22.982115384615376,24.72923041996524,21.235000349265512,22.023618874999983,23.061152499999995,23.295249999999996,22.961500000000026,23.87666666666667,3415976,5149138.8,56.7091690061695,2.2913151522055286,1.5,2.75,NaN,NaN,0.6227257370682949,0.6634072478294817,564.1758813375595,0.20369354914986376,0.18262108143993672,-0.021072467709927045,45.06925805907138,10.71968375770259,44.92045750791692,23.05405631265382,32.02548617942926,4965529092
1437571800,23.5,23.8,23.5,23.6625,20.859473684210524,24.28828947368421,24.2875,21.5025,24.2875,16.2775,23.78275,13.2775,22.995,6.233271,22.045706374999988,23.06435249999999,23.301799999999993,22.942250000000026,23.162043229717113,23.254971946006528,23.07846153846153,24.826891095852893,21.330031981070164,22.045706374999988,23.06435249999999,23.301799999999993,22.942250000000026,23.65416666666667,2295444,5136801.6,55.010180724007526,1.1650114230380588,1.5,2.75,NaN,NaN,0.6002096129919883,0.44686249903052516,562.406114270486,0.17125499867679186,0.19299628063606278,0.02174128195927092,29.326031315867606,9.510586601874348,57.63974891440218,14.044952397537697,28.31529868806011,4963233648
1437658200,23.7475,23.75,23.13665,23.275,20.81078947368421,24.291184210526314,24.2875,21.5025,24.2875,16.2775,23.78275,13.2775,22.995,6.233271,22.066168874999985,23.059274999999992,23.304999999999996,22.929625000000026,23.16647290698311,23.256879379720193,23.159038461538447,24.838356705146133,21.479720217930762,22.066168874999985,23.059274999999992,23.304999999999996,22.929625000000026,23.387216666666667,2962644,5161899.6,50.64352072028009,0.4440654110873952,1.5,2.75,NaN,NaN,0.6011482120639892,0.5739445222840057,559.0165181732898,0.11701811781639551,0.16801392922976532,0.050995811413369806,32.91802669839315,3.8251366120218497,20.99480258616023,47.55877745675706,31.446419957082703,4960271004
1437744600,23.315,23.32,22.41825,22.5475,20.762105263157892,24.29407894736842,24.2875,21.5025,24.2875,16.2775,23.78275,13.2775,22.995,6.233271,22.087406374999983,23.049899999999994,23.293099999999995,22.891750000000027,23.14219945965044,23.18931943879446,23.15307692307691,24.84046698085863,21.46568686529519,22.087406374999983,23.049899999999994,23.293099999999995,22.891750000000027,22.761916666666668,6037732,5333492.4,43.639713669247634,3.0033067920789387,1.5,2.75,NaN,NaN,0.6226197683451328,1.1320409868775663,554.575987815421,0.029996939031118268,0.08849198520226764,0.058495046171149374,34.026824560998826,-2.6341358091331077,3.8462222938786073,78.825675091391,17.32810261473039,4954233272
1438003800,22.1875,22.4,21.985,22.1525,20.713421052631578,24.296973684210524,24.2875,21.5025,24.2875,16.2775,23.78275,13.2775,22.995,6.233271,22.101868874999983,23.039474999999992,23.25904999999999,22.834625000000024,23.103387716134733,23.090574730337845,23.20307692307691,24.721976010531314,21.684177835622506,22.101868874999983,23.039474999999992,23.25904999999999,22.834625000000024,22.179166666666664,5925776,5475034.4,40.37481567529197,4.371621387814041,1.5,2.75,NaN,NaN,0.6183254991776233,1.082326715609312,550.3333471283016,-0.05186000444090558,-0.006329959379982597,0.04553004506092298,28.56965456813361,-5.58337773042088,0,100,0,4948307496
1438090200,22.49,23.025,22.160025,22.9475,20.664736842105263,24.29986842105263,24.2875,21.5025,24.2875,16.2775,23.78275,13.2775,22.995,6.233271,22.12610637499998,23.036399999999993,23.239299999999993,22.890500000000024,23.097274472364745,23.076948565543766,23.30615384615383,24.531433430237232,22.080874262070427,22.12610637499998,23.036399999999993,23.239299999999993,22.890500000000024,22.710841666666667,5798172,5321268.2,48.69449204411009,1.566325004258989,1.5,2.75,NaN,NaN,0.6364808206649357,1.0896222069769006,554.6352846762754,-0.05012780964411949,-0.017129716994226385,0.032998092649893104,35.51568564241581,-2.1115495360989547,6.980866964800642,70.98918334280435,22.029949692395,4954105668
1438176600,23.01,23.515,22.9625,23.43,20.616052631578945,24.302763157894734,24.2875,21.5025,24.2875,16.2775,23.78275,13.2775,22.995,6.233271,22.155781374999982,23.047924999999992,23.224699999999995,22.962375000000026,23.11032253227201,23.110572511682456,23.384038461538445,24.49704295123417,22.27103397184272,22.155781374999982,23.047924999999992,23.224699999999995,22.962375000000026,23.3025,5621052,5132402.4,52.982459475739894,1.1476254795939076,1.5,2.75,NaN,NaN,0.6315536191888688,1.095208746687516,558.6061085026955,-0.01592313540974354,0.013094173387713681,0.02901730879745722,37.90918951957752,-2.160977137488263,23.423266589439347,44.59350663083947,31.983226779721186,4959726720
1438263000,23.215,23.5125,22.9825,23.445,20.56736842105263,24.30565789473684,24.2875,21.5025,24.2875,16.2775,23.78275,13.2775,22.995,6.233271,22.18994387499998,23.056849999999994,23.211149999999993,23.011375000000026,23.12344713884958,23.14242274866508,23.406153846153828,24.511674286393166,22.30063340591449,22.18994387499998,23.056849999999994,23.211149999999993,23.011375000000026,23.313333333333333,4550872,5015501.2,53.11365303307321,1.1729388399915899,1.5,2.75,NaN,NaN,0.6242997892468065,0.9073613620110389,558.88708424617,0.007043128507492655,0.03782121943182304,0.030778090924330384,35.426651100886296,-2.545983581003848,41.928714892625315,25.630239545883505,32.44104556149119,4964277592
1438349400,23.655,23.6625,23.23,23.3325,20.518684210526313,24.308552631578944,24.2875,21.5025,24.2875,16.2775,23.78275,13.2775,22.995,6.233271,22.22296887499998,23.075599999999994,23.196349999999992,23.057500000000026,23.131645290267244,23.16052534403031,23.396153846153826,24.501806482147288,22.290501210160365,22.22296887499998,23.075599999999994,23.196349999999992,23.057500000000026,23.40833333333333,3224080,5015678,51.94300690218939,0.9298536385949049,1.5,2.75,NaN,NaN,0.6105998043006061,0.6428004349561515,561.8189342902294,0.013608640206341685,0.04778889118225749,0.0341802509759158,35.18614948223496,-3.1946893475780502,50.968334900700235,18.5790455379159,30.45261956138385,4961053512
1438608600,23.32,23.3375,22.7316,23.095,20.47,24.311447368421053,24.2875,21.5025,24.2875,16.2775,23.78275,13.2775,22.995,6.233271,22.257056374999983,23.09357499999999,23.172499999999996,23.100875000000023,23.130208220060684,23.154284835075043,23.36942307692306,24.48604944141112,22.252796712435,22.257056374999983,23.09357499999999,23.172499999999996,23.100875000000023,23.054699999999997,3369068,4957602.4,49.46439822014523,1.1404448742540203,1.5,2.75,NaN,NaN,0.6102641039934199,0.6795760789530035,559.0420455436083,0.0015420783568479285,0.036107848921975716,0.03456577056512779,35.25088323185023,-2.992754384122659,63.08831866801779,10.804394628498734,26.10728670348346,4957684444
1438695000,23.0575,23.25,22.775,22.945,20.421315789473685,24.314342105263158,24.2875,21.5025,24.2875,16.2775,23.78275,13.2775,22.995,6.233271,22.29038124999998,23.101774999999993,23.14924999999999,23.11687500000002,23.122945152607326,23.134352946020275,23.292307692307677,24.376591329515747,22.208024055099607,22.29038124999998,23.101774999999993,23.14924999999999,23.11687500000002,22.989999999999995,3008152,4701776.8,47.90945533349308,0.8182252397558525,1.5,2.75,NaN,NaN,0.6006023822796044,0.6397904724018375,557.7474699660827,-0.01598962624276289,0.014578737761674176,0.030568364004437066,34.922994535097295,-3.03222398309562,35.57473596660396,31.141739011265926,33.283525022130114,4954676292
1438781400,23.3175,23.59925,23.0775,23.1825,20.372631578947367,24.317236842105263,24.2875,21.5025,24.2875,16.2775,23.78275,13.2775,22.995,6.233271,22.32180124999998,23.116599999999995,23.14559999999999,23.20087500000002,23.125280636818804,23.13893837973263,23.224999999999984,24.215504921744444,22.234495078255524,22.32180124999998,23.116599999999995,23.14559999999999,23.20087500000002,23.286416666666668,4131628,4533211.8,50.559548710161366,0.5892069652079444,1.5,2.75,NaN,NaN,0.6044343549739184,0.9114129633210608,557.3043282028099,-0.011261947193934755,0.016490930012018623,0.027752877205953378,35.76407064046474,-0.39742212674542465,30.16498825846281,36.60614022745724,33.22887151407995,4958807920
1438867800,23.2375,23.3025,22.3875,22.645,20.323947368421052,24.320131578947368,24.2875,21.5025,24.2875,16.2775,23.78275,13.2775,22.995,6.233271,22.348151249999983,23.117174999999992,23.11869999999999,23.25275000000002,23.106446102041595,23.0918966292819,23.112884615384594,24.00585900160061,22.21991022916858,22.348151249999983,23.117174999999992,23.11869999999999,23.25275000000002,22.778333333333332,3630680,4373236.4,44.982031928517685,1.9388892557831878,1.5,2.75,NaN,NaN,0.6266176153329243,0.8302043767860342,554.7062519914566,-0.042263371661026165,-0.025076337370329327,0.01718703429069684,36.990052330820475,0.4324204457256908,6.9575040024781565,70.84215448270928,22.20034151481257,4955177240
1438954200,22.5725,22.60875,22.136275,22.4875,20.275263157894734,24.323026315789473,24.2875,21.5025,24.2875,16.2775,23.78275,13.2775,22.995,6.233271,22.36863874999998,23.118349999999996,23.08979999999999,23.25625000000002,23.0821737058831,23.034335045540768,23.011346153846134,23.86460149344631,22.158090814245956,22.36863874999998,23.118349999999996,23.08979999999999,23.25625000000002,22.410841666666666,4771120,4178965.6,43.46881136456908,2.8548935554884785,1.5,2.75,NaN,NaN,0.6181967142377153,1.1416987974248938,553.6021785780507,-0.06968692110241403,-0.0699216170873207,-0.00023469598490667015,32.32949327430843,1.5122446676447392,5.893338246474925,73.32024290235834,20.786418851166733,4950406120
1439213400,22.9425,23.365,22.9425,23.3175,20.22657894736842,24.32592105263158,24.2875,21.5025,24.2875,16.2775,23.78275,13.2775,22.995,6.233271,22.39517624999998,23.119774999999994,23.086849999999995,23.264250000000022,23.091402188005333,23.061303136441648,22.984807692307673,23.774494732407593,22.195120652207752,22.39517624999998,23.119774999999994,23.086849999999995,23.264250000000022,23.208333333333332,4354720,4205704.4,52.531391916470376,1.0587436799584433,1.5,2.75,NaN,NaN,0.6367183775064497,1.0354317816535084,557.887947597953,-0.03025156640631596,-0.03804915399280162,-0.00779758758648566,36.26357899975002,1.6123760758252421,23.73442513255512,44.01638312205963,32.249191745385254,4954760840
1439299800,22.8,22.9624,22.3975,22.6975,20.177894736842102,24.328815789473683,24.2875,21.5025,24.2875,16.2775,23.78275,13.2775,22.995,6.233271,22.415476249999983,23.118374999999997,23.068749999999994,23.22600000000002,23.07595504337767,23.0266552186853,22.940384615384595,23.72473110022661,22.15603813054258,22.415476249999983,23.118374999999997,23.068749999999994,23.22600000000002,22.6858,6183644,4251159.6,46.530696339175506,1.6601503627714287,1.5,2.75,NaN,NaN,0.6569527791131317,1.4545781814448935,555.0431657952212,-0.04344427542257179,-0.062102931864700395,-0.018658656442128607,34.89815625655731,-3.126333760136569,17.383016544186574,52.48097018066846,30.136013275144958,4948577196
1439386200,22.1625,22.855,21.625,22.78,20.129210526315788,24.33171052631579,24.2875,21.5025,24.2875,21.5025,23.78275,16.2775,22.995,13.2775,22.434201249999983,23.111699999999995,23.053949999999997,23.192875000000022,23.064348963245212,23.003164245477176,22.95826923076921,23.716121420070266,22.200417041468157,22.434201249999983,23.111699999999995,23.053949999999997,23.192875000000022,22.42,8799044,4444702.6,47.39185391503276,2.373539269843159,1.5,2.75,NaN,NaN,0.6978847234621937,1.9796699108732272,554.0184707186252,-0.04400072446868455,-0.0736595620279843,-0.029658837559299746,32.25113529400486,-2.8364256771166523,29.224064584794032,37.670817915242054,33.10511749996392,4957376240
1439472600,22.7275,22.98,22.495,22.68,20.080526315789474,24.334605263157894,24.2875,21.5025,24.2875,21.5025,23.78275,16.2775,22.995,13.2775,22.452738874999987,23.105299999999993,23.032999999999998,23.12950000000002,23.049276454882655,22.972386698288872,22.998846153846138,23.624790410963136,22.37290189672914,22.452738874999987,23.105299999999993,23.032999999999998,23.12950000000002,22.718333333333334,6754492,4508448.6,46.4160181870681,0.8917990304159132,1.5,2.75,NaN,NaN,0.6826786717863227,1.498185429018754,551.7466233816369,-0.048154277687291296,-0.08985168466841387,-0.04169740698112257,32.18344114816663,-2.796528447444551,23.364632846497578,44.47289189564635,32.16247525785608,4950621748
1439559000,22.61,22.9625,22.57,22.9325,20.031842105263156,24.3375,24.2875,21.5025,24.2875,21.5025,23.78275,16.2775,22.995,13.2775,22.469338874999984,23.105524999999993,23.028249999999993,23.073250000000023,23.044696986063727,22.968587965118502,22.997692307692294,23.62406606419893,22.371318551185656,22.469338874999984,23.105524999999993,23.028249999999993,23.073250000000023,22.82166666666667,3211208,4549836.6,49.25716583052824,0.43879924244960167,1.5,2.75,NaN,NaN,0.6619516238015853,0.7057853462254008,554.9131715064926,-0.03173921015540708,-0.08137141967538142,-0.04963220951997434,33.18622280835679,-0.7036155011907247,40.48168116733658,26.70978768678762,32.80853114587578,4953832956
1439818200,22.7075,23.31,22.524925,23.2975,19.98315789473684,24.340394736842104,24.2875,21.5025,24.2875,21.5025,23.78275,16.2775,22.995,13.2775,22.488088874999985,23.119299999999996,23.03439999999999,23.033000000000023,23.054610829747503,22.9999129208215,22.987499999999986,23.58923147601796,22.385768523982012,22.488088874999985,23.119299999999996,23.03439999999999,23.033000000000023,23.044141666666665,4848056,4644678,53.12622125629678,1.0930585810909685,1.5,2.75,NaN,NaN,0.6707461506729006,1.0437873195945984,557.731649859207,0.0039591926774652855,-0.04468321867314273,-0.04864241135060802,34.09201454017895,1.5362824144693796,42.15301335131713,25.245302880317038,32.60168376836583,4958681012
1439904600,23.2225,23.34475,23.0225,23.0975,19.934473684210523,24.34328947368421,24.2875,21.5025,24.2875,21.5025,23.78275,16.2775,22.995,13.2775,22.503913874999984,23.132674999999992,23.044849999999993,22.997500000000024,23.0562927579927,23.00920692836231,22.96076923076922,23.507160836654823,22.414377624883617,22.503913874999984,23.132674999999992,23.044849999999993,22.997500000000024,23.154916666666665,3184884,4633123.4,50.83879403405053,0.6998567970095918,1.5,2.75,NaN,NaN,0.6458535684819792,0.6874161823533558,554.5498900465219,0.013806643373443825,-0.03138410713380324,-0.045190750507247066,34.27943104339469,-0.3666558826701212,51.15598627023676,18.281480925208264,30.562532804554966,4955496128
1439991000,22.81,23.115425,22.25,22.55,19.88578947368421,24.346184210526314,24.2875,21.5025,24.2875,21.5025,23.78275,16.2775,22.995,13.2775,22.513688874999986,23.139274999999994,23.04499999999999,22.94187500000002,23.036438140032203,22.96547293518495,22.900576923076912,23.44228772388854,22.358866122265283,22.513688874999986,23.139274999999994,23.04499999999999,22.94187500000002,22.638475,10591624,5047932.4,45.11249508061581,1.292542577044181,1.5,2.75,NaN,NaN,0.6615372421618376,2.0982103484587076,550.6588747548532,-0.015273107861124138,-0.06428213533365223,-0.0490090274725281,36.333158383945644,-0.4195186575402909,9.973070591514167,64.65024108851942,25.376688319966405,4944904504
1440077400,21.9675,22.18875,21.1275,21.1275,19.837105263157895,24.34907894736842,24.2875,21.5025,24.2875,21.5025,23.78275,16.2775,22.995,13.2775,22.516226374999984,23.123549999999994,23.000149999999994,22.834500000000023,22.961577820815254,22.790427893738762,22.74923076923076,23.82511213353594,21.67334940492558,22.516226374999984,23.123549999999994,23.000149999999994,22.834500000000023,21.481249999999996,12504788,5525039.6,34.30189643771263,5.91008419457868,1.5,2.75,NaN,NaN,0.7158917248645634,2.2632938232696107,545.199184362708,-0.12303291184701451,-0.20280016728129624,-0.07976725543428173,50.212147979713706,-6.047804335742076,7.095675606575936,70.54470032525701,22.35962406816706,4932399716
1440163800,20.4575,20.8125,19.1325,19.1325,19.788421052631577,24.351973684210524,24.2875,21.5025,24.2875,21.5025,23.78275,16.2775,22.995,13.2775,22.509726374999982,23.093774999999997,22.910999999999994,22.66375000000002,22.81141790627348,22.442053808620784,22.45596153846153,24.65290131430843,20.25902176261463,22.509726374999982,23.093774999999997,22.910999999999994,22.66375000000002,19.6925,19191056,6182705.8,25.18618461979102,13.450196308082003,1.5,2.75,NaN,NaN,0.8072566016599518,3.1039898421173464,542.3378470886322,-0.31071409726445326,-0.4681598770148483,-0.15744577975039503,72.91876973275107,-17.947893213251845,1.216390798957102,88.41918360359097,10.364425597451932,4913208660
1440423000,16.2925,18.75,16,16.82,16,24.35486842105263,24.2875,21.5025,24.2875,21.5025,23.78275,16.2775,22.995,13.2775,22.48985137499998,23.043024999999997,22.786249999999995,22.397125000000024,22.576460341321578,21.90662011256166,21.966538461538452,25.637988362966798,18.295088560110106,22.48985137499998,23.043024999999997,22.786249999999995,22.397125000000024,17.19,19086776,6840755.8,18.912258765863,25.047107667927392,1.5,2.75,NaN,NaN,0.9733454158270981,2.7901560234031453,537.2352630730218,-0.558203826344139,-0.8552005626805688,-0.29699673633642976,89.18124762256805,-25.894922348276246,0,100,0,4894121884
1440509400,18.53,18.53,16.1325,16.1975,15.841323529411765,24.357763157894734,24.2875,21.5025,24.2875,21.5025,23.78275,16.2775,22.995,13.2775,22.46558887499998,22.984274999999997,22.655749999999994,22.059625000000022,22.32630503381877,21.36289438755579,21.470576923076916,26.223949876871917,16.717203969281915,22.46558887499998,22.984274999999997,22.655749999999994,22.059625000000022,16.953333333333333,14597912,7280742.8,17.63851706687815,22.87981630775384,1.5,2.75,NaN,NaN,1.0750707432680198,2.005003115890868,535.4811470344077,-0.7210824600664256,-1.1983498114194617,-0.47726735135303616,89.14286843289406,-28.895961369622473,0,100,0,4879523972
1440595800,17.465,18.145,16.485025,18.095,15.68264705882353,24.36065789473684,24.2875,21.5025,24.2875,21.5025,23.78275,16.2775,22.995,13.2775,22.45056387499998,22.939824999999995,22.555249999999997,21.792875000000024,22.16037150308078,21.051666350645714,21.132692307692295,26.165157089004524,16.100227526380067,22.45056387499998,22.939824999999995,22.555249999999997,21.792875000000024,17.575008333333333,14174328,7708406.6,32.55073660046365,15.026727556803971,1.5,2.75,NaN,NaN,1.1373871187488753,1.8388142628594606,540.7396178341285,-0.6599261256771105,-1.3021750084494244,-0.6422488827723138,120.99983095569647,-20.216049382716054,3.0056854011107,81.66245978319922,15.331854815690084,4893698300
1440682200,18.7975,19.431,18.265,19.4125,15.523970588235294,24.363552631578944,24.2875,21.5025,24.2875,21.5025,23.78275,16.2775,22.995,13.2775,22.441126374999982,22.910374999999995,22.478899999999996,21.591250000000024,22.0526118362933,20.89555526963184,20.832307692307683,25.77260372109695,15.892011663518415,22.441126374999982,22.910374999999995,22.478899999999996,21.591250000000024,19.036166666666666,11291548,8045440.4,40.59350533419327,5.918069253984061,1.5,2.75,NaN,NaN,1.1515737531239556,1.4034717105107135,547.8941618447556,-0.4970650695432657,-1.263580219701396,-0.7665151501581302,132.24402514669865,-15.349394963479774,12.630235225730143,60.351296214459154,27.018468559810714,4904989848
1440768600,19.175,19.5625,19.0075,19.415,15.365294117647059,24.366447368421053,24.2875,21.5025,24.2875,21.5025,23.78275,16.2775,22.995,13.2775,22.43145137499998,22.878674999999994,22.388549999999995,21.395375000000026,21.949176078007287,20.75455000585738,20.579807692307686,25.44798357147768,15.711631813137693,22.43145137499998,22.878674999999994,22.388549999999995,21.395375000000026,19.328333333333333,6908060,8229639.4,40.607977400823145,4.190845830471499,1.5,2.75,NaN,NaN,1.10896134218653,0.8394122347572118,550.8973048524274,-0.36178222592632014,-1.2187429325660304,-0.8569607066397102,131.58687045645948,-16.664878205816073,32.647896090095934,34.50585884052889,32.846245069375186,4911897908
1441027800,19.0775,19.3475,18.7425,18.9225,15.206617647058824,24.369342105263158,24.2875,21.5025,24.2875,21.5025,23.78275,16.2775,22.995,13.2775,22.419588874999977,22.838899999999995,22.296849999999996,21.18675000000003,21.83048289847759,20.58006905291858,20.28307692307692,25.047799109604995,15.518354736548842,22.419588874999977,22.838899999999995,22.296849999999996,21.18675000000003,19.004166666666666,6413304,8381851.2,38.61237485440056,4.955105239154881,1.5,2.75,NaN,NaN,1.0777855320303493,0.765141714756282,548.64827405342,-0.2816417905587436,-1.2090129448381397,-0.9273711542793961,129.9922485068655,-18.0755493018725,50.45212710441466,18.813219603722484,30.73465329186286,4905484604
1441114200,17.6325,18.0925,16.9325,17.2325,15.047941176470589,24.372236842105263,24.2875,16.1975,24.2875,21.5025,23.78275,16.2775,22.995,13.2775,22.398988874999976,22.778724999999994,22.161699999999996,20.90112500000003,21.650169843635332,20.26125295264062,19.86403846153846,24.6698504630719,15.05822646000502,22.398988874999976,22.778724999999994,22.161699999999996,20.90112500000003,17.41916666666667,13851184,8924002.8,32.677903593039886,12.504893018560862,1.5,2.75,NaN,NaN,1.1429437083138956,1.5521268101798442,542.7400008448004,-0.3160443762543532,-1.3224266245973375,-1.0063822483429843,136.06107754707926,-23.580931263858087,50.2366786433506,18.96825421405261,30.795067142596793,4891633420
1441200600,18.0225,18.22,17.41,18.2025,14.889264705882352,24.375131578947368,24.2875,16.1975,24.2875,21.5025,23.78275,16.2775,22.995,13.2775,22.38317637499998,22.731399999999994,22.0448,20.65212500000003,21.514967104669243,20.065181242865325,19.500192307692302,24.02994712426073,14.970437491123876,22.38317637499998,22.731399999999994,22.0448,20.65212500000003,17.944166666666664,7672508,9101046.8,38.51865337711721,7.91258802770616,1.5,2.75,NaN,NaN,1.1318405862914742,0.8430357703467692,544.721043070975,-0.24996155327787295,-1.3188341899403255,-1.0688726366624526,144.41181574485643,-13.844515441959533,42.808071334048314,24.731914080576935,32.46001458537475,4899305928
1441287000,18.42,18.945,18.085875,18.225,14.730588235294118,24.378026315789473,24.2875,16.1975,24.2875,21.5025,23.78275,16.2775,22.995,13.2775,22.36726387499998,22.683024999999994,21.93875,20.43112500000003,21.385948786839077,19.88992588640196,19.109999999999996,23.106653407732328,15.113346592267664,22.36726387499998,22.683024999999994,21.93875,20.43112500000003,18.418625000000002,9458536,9392439.6,38.651609887500406,4.720467601953177,1.5,2.75,NaN,NaN,1.1123609015563687,1.007037191913377,547.3260880882415,-0.18425811717400142,-1.2991952831299542,-1.1149371659559528,142.06616968373302,-4.743237945903561,39.32089014818384,27.734762357537242,32.94434749427891,4908764464
1441373400,17.5,17.7625,17.140275,17.4175,14.571911764705883,24.380921052631578,24.2875,16.1975,24.2875,21.5025,23.78275,16.2775,22.995,13.2775,22.345438874999978,22.623324999999994,21.820999999999998,20.17762500000003,21.230323344217936,19.65445675436368,18.67307692307692,22.019519439360877,15.326634406792962,22.345438874999978,22.623324999999994,21.820999999999998,20.17762500000003,17.440091666666664,8289848,9568376,35.670233007699025,8.640846521168658,1.5,2.75,NaN,NaN,1.1103869085880569,0.8663798328995432,543.0303357243251,-0.1747854555503221,-1.3334189853938554,-1.1586335298435333,133.4794111128135,3.5523186682520818,18.152771984107023,51.38040048634447,30.466827529548524,4900474616
1441719000,18.3225,18.77,18.11825,18.7525,14.413235294117648,24.383815789473683,24.2875,16.1975,24.2875,21.5025,23.78275,16.2775,22.995,13.2775,22.330863874999977,22.577349999999996,21.73015,19.949375000000032,21.13315380130743,19.56855611109095,18.380961538461538,20.877862339348,15.884060737575076,22.330863874999977,22.577349999999996,21.73015,19.949375000000032,18.546916666666664,7239772,9712628.6,43.43802009133143,1.864844565739839,1.5,2.75,NaN,NaN,1.127680700831767,0.7453978009619353,548.1895650329354,-0.06392601043683421,-1.238541042889576,-1.1746150324527418,116.79323304323617,15.774039203580797,35.845023449507096,31.12594311232492,33.02903343816798,4907714388
1441805400,19.275,19.3025,17.8475,17.97,14.254558823529411,24.386710526315788,24.2875,16.1975,24.2875,21.5025,23.78275,16.2775,22.995,13.2775,22.31176387499998,22.531574999999993,21.65295,19.713000000000033,21.009108554197333,19.41631267193943,18.138076923076923,20.069252485591743,16.206901360562103,22.31176387499998,22.531574999999993,21.65295,19.713000000000033,18.37333333333333,9210192,9863956,40.36162742321853,2.582961128129518,1.5,2.75,NaN,NaN,1.1510606507723549,0.9337219265779368,543.9575139450756,-0.030318931744941047,-1.212513697133918,-1.182194765388977,117.57038058968278,-0.6907985631389887,43.22139407600412,24.56103076003602,32.21757516395986,4898504196
1441891800,17.8825,18.6425,17.8325,18.26,14.095882352941176,24.389605263157893,24.2875,16.1975,24.2875,21.5025,23.78275,16.2775,22.995,13.2775,22.29232637499998,22.482649999999992,21.5783,19.487000000000034,20.90130037560136,19.306187655564248,18.07096153846154,19.918047120650137,16.22387595627294,22.29232637499998,22.482649999999992,21.5783,19.487000000000034,18.245,7876148,9817811.2,42.001047432282746,2.44913373481156,1.5,2.75,NaN,NaN,1.1266991757171865,0.8022305419766068,545.3085293848269,0.021619669125620744,-1.155170178981951,-1.1767898481075718,99.13476199192742,-5.9368963296844806,43.54647989171757,24.29236686778438,32.16115324049805,4906380344
1441978200,18.1175,18.515,17.8925,18.5075,13.937205882352941,24.3925,24.2875,16.1975,24.2875,21.5025,23.78275,16.2775,22.995,13.2775,22.27323887499998,22.436949999999996,21.49915,19.278375000000032,20.807425851067972,19.23012216455813,18.200769230769232,19.909994634070372,16.491543827468092,22.27323887499998,22.436949999999996,21.49915,19.278375000000032,18.305,5948712,9777522.2,43.4303039504783,1.949611871526637,1.5,2.75,NaN,NaN,1.0906849488802448,0.6084069029267968,546.3686679631787,0.07956387936367593,-1.0773349989029768,-1.1568988782666527,89.50285362288314,-4.6742209631727984,38.357804843612826,28.78501575958302,32.85717939680416,4912329056
1442237400,18.555,18.5675,18.14,18.29,13.778529411764707,24.395394736842103,24.2875,16.1975,24.2875,21.5025,23.78275,16.2775,22.995,13.2775,22.25326387499998,22.38555,21.416749999999997,19.046250000000036,20.70870326867315,19.1405867203145,18.36173076923077,19.62088552940093,17.102576009060613,22.25326387499998,22.38555,21.416749999999997,19.046250000000036,18.3325,3827872,9808355.4,42.44052209021122,1.972167870749465,1.5,2.75,NaN,NaN,1.0433145953887986,0.39026644568772456,542.9900745255154,0.10837820210593674,-1.0214261256342319,-1.1298043277401686,89.52598871191098,-3.342581582771834,49.52535978555469,19.478875464587706,30.99576474985761,4908501184
1442323800,18.4675,19.135,18.32,19.005,13.619852941176472,24.39828947368421,24.2875,16.1975,24.2875,21.5025,23.78275,16.2775,22.995,13.2775,22.23606387499998,22.33975,21.3523,18.831625000000034,20.64189137578401,19.127673699332167,18.43173076923077,19.724519026947377,17.138942511514166,22.23606387499998,22.33975,21.3523,18.831625000000034,18.819999999999997,5943236,9863114.4,46.73783429380888,1.7932970783060629,1.5,2.75,NaN,NaN,1.0291492671467417,0.6025719421849147,546.3965331552421,0.17668693695868942,-0.9089456565418068,-1.0856325935004962,91.86969211173842,10.28579718555054,47.42663383070953,21.045384105765493,31.52798206352499,4914444420
1442410200,19.07,19.5475,18.9825,19.4925,13.461176470588235,24.401184210526313,24.2875,16.1975,24.2875,21.5025,23.78275,16.2775,22.995,13.2775,22.22200137499998,22.297074999999996,21.28965,18.651375000000034,20.596817204184635,19.162419061300533,18.43788461538462,19.749907196912034,17.125862033857203,22.22200137499998,22.297074999999996,21.28965,18.651375000000034,19.340833333333332,8546592,10131199.8,49.505885275947655,3.2530842311316666,1.5,2.75,NaN,NaN,0.9959957480648314,0.8435912990285711,550.9435101729979,0.25124792364463877,-0.7715726889446977,-1.0228206125893364,70.18497036254728,7.086938607334153,86.62157160475009,1.6064280577258863,11.772000337524029,4922991012
1442496600,19.445,20.2651,19.2175,19.3525,13.3025,20.2651,24.2875,16.1975,24.2875,21.5025,23.78275,16.2775,22.995,13.2775,22.209638874999982,22.256099999999996,21.24665,18.491500000000034,20.548020451079356,19.18052200784334,18.433076923076925,19.731125982606933,17.135027863546917,22.209638874999982,22.256099999999996,21.24665,18.491500000000034,19.611700000000003,13971668,10300202,48.72277064314607,3.886516011059066,1.5,2.75,NaN,NaN,0.9996817660602005,1.3564460192139922,554.0212077251011,0.28520086163932024,-0.6663195355401861,-0.9515203971795063,65.32704545883638,6.186556927297655,36.67844835689894,30.140640282119406,33.18091136098165,4909019344
1442583000,18.47,19.0175,18.2707,18.3875,13.143823529411765,20.16944761904762,24.2875,16.1975,24.2875,21.5025,23.78275,16.2775,22.995,13.2775,22.19036387499998,22.203324999999996,21.18225,18.354500000000034,20.463294158880167,19.10499610233445,18.391923076923078,19.658845686796422,17.125000467049734,22.19036387499998,22.203324999999996,21.18225,18.354500000000034,18.558566666666668,9870208,10168473,43.60280657301203,1.7034379412884326,1.5,2.75,NaN,NaN,1.0055473541987576,0.9706676705538777,550.0180444189523,0.23862198920524713,-0.6532429106729474,-0.8918648998781945,73.18576150353529,5.569111525764311,14.956830155322967,56.12850755995478,28.91466228472225,4899149136
1442842200,18.6925,19.029,18.3325,18.675,12.985147058823529,20.07379523809524,24.2875,16.1975,24.2875,21.5025,23.78275,16.2775,22.995,13.2775,22.171238874999982,22.156224999999996,21.1074,18.331625000000034,20.393164976178983,19.06404409258831,18.502884615384616,19.583106896915037,17.422662333854195,22.171238874999982,22.156224999999996,21.1074,18.331625000000034,18.678833333333333,7126900,9565265.2,45.44225070322426,0.7272025082545147,1.5,2.75,NaN,NaN,0.9834725431845607,0.7450812759483135,552.8464715436985,0.22339683576575264,-0.6126188551710037,-0.8360156909367563,67.23005699158446,-0.41327822956939375,29.24152818113794,37.6435866513421,33.11488516751996,4906276036
1442928600,17.955,18.119975,17.585,17.965,12.826470588235294,19.978142857142856,24.2875,16.1975,24.2875,21.5025,23.78275,16.2775,22.995,13.2775,22.148988874999983,22.108974999999997,21.003549999999997,18.388875000000034,20.297942820250395,18.95937322662752,18.484615384615385,19.592226893420648,17.37700387581012,22.148988874999983,22.108974999999997,21.003549999999997,18.388875000000034,17.88999166666667,9630452,9092449,41.8150859219882,4.500949770685417,1.5,2.75,NaN,NaN,0.9910816472428063,1.0591703071416734,547.9620941159046,0.164454427435892,-0.6304476566418913,-0.7949020840777833,56.45973785887266,-0.02782415136337788,12.782013764042153,59.656313620293496,27.561672615664374,4896645584
1443015000,18,18.175,17.6875,17.8675,12.667794117647059,19.882490476190476,24.2875,16.1975,24.2875,21.5025,23.78275,16.2775,22.995,13.2775,22.125651374999983,22.053724999999996,20.891649999999995,18.472375000000035,20.20263133710332,18.85538530028204,18.457115384615385,19.606123060417968,17.308107708812802,22.125651374999983,22.053724999999996,20.891649999999995,18.472375000000035,17.91,5939232,8659515,41.32724874136192,3.7392911057411236,1.5,2.75,NaN,NaN,0.9551115295826059,0.685861968020149,545.745555490421,0.1199142433095658,-0.645009279940826,-0.7649235232503918,51.00375352574458,-2.1495071193866475,2.5599812337351966,82.89974108106941,14.540277685195404,4890706352
1443101400,17.465,17.8325,17.0325,17.7,12.509117647058824,19.786838095238096,24.2875,16.1975,24.2875,21.5025,23.78275,16.2775,22.995,13.2775,22.10373887499998,21.994549999999993,20.776799999999994,18.452625000000033,20.10448893172672,18.745348605017085,18.478846153846156,19.556877863427978,17.400814444264334,22.10373887499998,21.994549999999993,20.776799999999994,18.452625000000033,17.521666666666665,14953924,8698494.8,40.45407816650174,5.125894182641708,1.5,2.75,NaN,NaN,0.9465321346124199,1.7191392699343797,542.8679003900999,0.08199541906373597,-0.6624292494207218,-0.7444246684844578,50.0599407382256,-4.363096042145082,2.596374783969078,82.77167279881304,14.63195241721788,4875752428
1443187800,18.1575,18.25,17.375,17.64,12.35044117647059,19.691185714285716,24.2875,16.1975,24.2875,21.5025,23.78275,16.2775,22.995,13.2775,22.081813874999984,21.943074999999993,20.650649999999995,18.364000000000033,20.007842306953123,18.640077309301173,18.393269230769235,19.544932550653506,17.241605910884964,22.081813874999984,21.943074999999993,20.650649999999995,18.364000000000033,17.755,11768824,8722358.6,40.127023263748185,3.369511447122084,1.5,2.75,NaN,NaN,0.9414226964258186,1.3492708268151232,541.7770291786363,0.056888017053178586,-0.6733146471679845,-0.7302026642211631,48.94220523277827,-3.5538545653362417,2.4357544774080977,83.3432592398223,14.220986282769601,4863983604
1443447000,17.35,17.3825,16.225,16.3,12.191764705882353,19.595533333333336,24.2875,16.1975,24.2875,21.5025,23.78275,16.2775,22.995,13.2775,22.058401374999985,21.880824999999994,20.495499999999996,18.20825000000003,19.862436726288294,18.41721280365344,18.2648076923077,19.862754044466836,16.66686134014856,22.058401374999985,21.880824999999994,20.495499999999996,18.20825000000003,16.635833333333334,14869364,9120423.8,33.59470397059917,9.943632680567152,1.5,2.75,NaN,NaN,0.9752496466811171,1.6303369586838716,535.3700657537471,-0.04068953118213059,-0.7810645781988264,-0.7403750470166958,64.97953656568424,-14.233096553538534,0,100,0,4849114240
1443533400,16.415,16.775,16.05,16.345,16.05,19.499880952380952,24.2875,16.1975,24.2875,21.5025,23.78275,16.2775,22.995,13.2775,22.033726374999986,21.816449999999996,20.340349999999997,18.079375000000034,19.724498031139735,18.219859203305496,18.117500000000007,20.015044972609857,16.219955027390156,22.033726374999986,21.816449999999996,20.340349999999997,18.079375000000034,16.39,10466876,9323102.4,33.98336966786492,9.163415609053603,1.5,2.75,NaN,NaN,0.95737467191818,1.1226816515498101,533.0516611298732,-0.09009458271364879,-0.8529932754087568,-0.762898692695108,57.817439595437655,-16.14723611645505,3.0993689199324774,81.14185955031364,15.75877152975388,4859581116
1443619800,16.9525,17.3125,16.6925,17.2675,16.052,19.404228571428572,24.2875,16.1975,24.2875,16.1975,23.78275,21.5025,22.995,16.2775,22.018838874999986,21.752399999999994,20.209549999999997,18.081125000000032,19.62814516717347,18.129158326800212,18.02211538461539,19.955969493894663,16.088261275336116,22.018838874999986,21.752399999999994,20.209549999999997,18.081125000000032,17.090833333333332,13527268,9306906.6,41.5375762372927,3.605588991680116,1.5,2.75,NaN,NaN,0.9580979096383101,1.4534655370883383,537.9554224413564,-0.05051080835005606,-0.8260372031326781,-0.7755263947826221,67.10146293570254,-10.773801834388326,15.578096039163388,55.26478147896629,29.157122481870324,4873108384
1443706200,17.375,17.4925,16.7725,17.4075,16.054000000000002,19.30857619047619,24.2875,16.1975,24.2875,16.1975,23.78275,21.5025,22.995,16.2775,22.00672637499999,21.69312499999999,20.084449999999993,18.041375000000034,19.54106104297059,18.06042896234305,17.954230769230776,19.90756360610155,16.00089793236,22.00672637499999,21.69312499999999,20.084449999999993,18.041375000000034,17.224166666666665,9817264,9414144.4,42.61085273481231,2.6411820027141557,1.5,2.75,NaN,NaN,0.9410909160927164,1.0428206306247012,537.3642458214547,-0.007047806364483988,-0.7843361527382271,-0.7772883463737431,68.07451881524128,-5.329707681849085,39.623130750019065,27.5467328756314,32.83013637434954,4882925648
1443792600,16.7375,18.1675,16.575,18.155,16.056,19.21292380952381,24.2875,16.1975,24.2875,16.1975,23.78275,21.5025,22.995,16.2775,22.000713874999988,21.643524999999997,19.982049999999994,18.03787500000003,19.486705707952137,18.069435727834186,17.88884615384616,19.751930461142713,16.025761846549607,22.000713874999988,21.643524999999997,19.982049999999994,18.03787500000003,17.6325,13874992,9634967.2,48.09046450792178,1.0968456206954245,1.5,2.75,NaN,NaN,0.9876201363718081,1.440066345010495,538.8811607590287,0.07535351210368801,-0.6830964562441331,-0.7584499683478211,68.76036129501229,-2.7844712182061557,71.02195900580571,6.930858753196405,22.047182240997873,4896800640
1444051800,18.57,19.21375,18.5425,19.135,16.058,19.117271428571428,24.2875,16.1975,24.2875,16.1975,23.78275,21.5025,22.995,16.2775,21.993926374999987,21.60345,19.913799999999995,18.12375000000003,19.472913327248133,18.170918039469026,17.86134615384616,19.637459689051845,16.085232618640475,21.993926374999987,21.60345,19.913799999999995,18.12375000000003,18.96375,13699492,9905449.4,54.25703739779857,6.090660348065895,1.5,2.75,NaN,NaN,0.9927008409166789,1.383025791843427,545.7382738542022,0.19250686064785527,-0.5178163925380019,-0.7103232531858572,75.05507145942978,6.512663512385203,99.99999999999999,0,0,4910500132
1444138200,19.1125,19.292475,18.715,18.945,16.060000000000002,19.021619047619048,24.2875,16.1975,24.2875,16.1975,23.78275,21.5025,22.995,16.2775,21.978676374999985,21.55435,19.849649999999993,18.13337500000003,19.452210843826638,18.244640130948167,17.830000000000005,19.511608662057768,16.148391337942243,21.978676374999985,21.55435,19.849649999999993,18.13337500000003,18.984158333333333,6744280,9880674.8,52.943856643565944,4.760609743674851,1.5,2.75,NaN,NaN,0.9630418522797732,0.6825728137515465,546.8799839511731,0.25019530752532426,-0.39757911877920193,-0.6477744263045262,70.99217449471617,6.03050230866098,86.03252468184112,1.7403266060081046,12.227148712150756,4903755852
1444224600,19.2675,19.53,18.855,19.4125,16.062,18.925966666666667,24.2875,16.1975,24.2875,16.1975,23.78275,21.5025,22.995,16.2775,21.96435137499999,21.509124999999997,19.778949999999995,18.20550000000003,19.450653555833437,18.355864880381674,17.90884615384616,19.773749343109735,16.043942964582584,21.96435137499999,21.509124999999997,19.778949999999995,18.20550000000003,19.265833333333337,7870916,9813711,55.77982626889389,5.1180339832350645,1.5,2.75,NaN,NaN,0.9424674342597895,0.802032584819341,551.1940436530214,0.308978050598691,-0.2615518630561624,-0.5705299136548534,71.39960648583322,9.675141242937867,84.73523077551239,2.0606270843400547,13.204142140147562,4911626768
1444311000,19.2675,20.03,19.175,19.9425,16.064,18.830314285714287,24.2875,16.1975,24.2875,16.1975,23.78275,21.5025,22.995,16.2775,21.95112637499999,21.46695,19.709199999999996,18.28962500000003,19.469941651683108,18.50697298701199,18.00634615384616,20.135140156403814,15.877552151288503,21.95112637499999,21.46695,19.709199999999996,18.28962500000003,19.715833333333332,8596824,9849744.8,58.810574868892616,6.307162224794216,1.5,2.75,NaN,NaN,0.9362197603840903,0.8727966231165705,555.6732501831158,0.3686495693132782,-0.10971795201325563,-0.4783675213265338,71.14779722585536,13.052721088435364,84.74483066902634,2.0581662731336015,13.197003057840078,4920223592
1444397400,19.9675,20.135,19.750875,19.9675,16.066000000000003,18.734661904761907,24.2875,16.1975,24.2875,16.1975,23.78275,21.5025,22.995,16.2775,21.937551374999988,21.425400000000003,19.639649999999996,18.36262500000003,19.489453743773968,18.646070797772754,18.160384615384622,20.530985680153645,15.7897835506156,21.937551374999988,21.425400000000003,19.639649999999996,18.36262500000003,19.951125,5870228,9845820.6,58.953482233469494,6.1707423023472465,1.5,2.75,NaN,NaN,0.8967844203566554,0.5962152103401113,557.6570555846025,0.3926819286012839,0.012484889425071088,-0.38019703917621284,70.83153381111018,22.500000000000004,81.9664345516193,2.8257828527216935,15.207782595658996,4926093820
1444656600,19.9825,20.0925,19.85,20.045,16.068,18.639009523809523,24.2875,16.1975,24.2875,16.1975,23.78275,21.5025,22.995,16.2775,21.924238874999986,21.385125000000002,19.573899999999995,18.45037500000003,19.511239871469108,18.779302150365826,18.32788461538462,20.89186277903357,15.763906451735668,21.924238874999986,21.385125000000002,19.573899999999995,18.45037500000003,19.995833333333334,3807160,9844785,59.42347385946631,5.500480826226737,1.5,2.75,NaN,NaN,0.8500498189026086,0.3867184504283232,558.8981155690744,0.39557196302424946,0.11426791460409902,-0.28130404842015044,41.759493676586345,22.636892015907023,77.18458525654309,4.405171548676996,18.410243194779916,4929900980
1444743000,19.7575,20.21,19.58,19.6375,16.07,18.543357142857143,24.2875,16.1975,24.2875,16.1975,23.78275,21.5025,22.995,16.2775,21.907876374999987,21.338625,19.504749999999994,18.482000000000028,19.516191249058554,18.861035278902413,18.47692307692308,21.10209937418694,15.851746779659221,21.907876374999987,21.338625,19.504749999999994,18.482000000000028,19.809166666666666,5470996,9821173,55.8052185491427,4.0565155233120125,1.5,2.75,NaN,NaN,0.8343319746952795,0.5570613612040028,554.8894041249991,0.35320574196541965,0.16020312903662415,-0.1930026129287955,47.19057358920885,13.725206312436667,80.58560880771684,3.251880131060585,16.162511061222595,4924429984
1444829400,19.605,19.82,19.255,19.35,16.072000000000003,18.447704761904763,24.2875,16.1975,24.2875,16.1975,23.78275,21.5025,22.995,16.2775,21.88965137499999,21.29105,19.432849999999995,18.47487500000003,19.509673945173905,18.907603347578373,18.608461538461544,21.224061586149926,15.992861490773162,21.88965137499999,21.29105,19.432849999999995,18.47487500000003,19.475000000000005,6939316,9740809.2,53.33764597218807,2.140708316974841,1.5,2.75,NaN,NaN,0.8150939765027596,0.7123962555390163,552.1541744305345,0.2915477763707357,0.17143210753462412,-0.12011566883611158,44.29579260927945,11.158983196897903,48.75172504565621,20.040528691934952,31.20774626240884,4917490668
1444915800,19.5925,20.247475,19.45775,20.23,16.074,18.352052380952383,24.2875,16.1975,24.2875,16.1975,23.78275,21.5025,22.995,16.2775,21.877676374999986,21.259700000000002,19.373799999999996,18.51875000000003,19.53792202575532,19.033545885904243,18.910769230769237,21.286722792067057,16.534815669471417,21.877676374999986,21.259700000000002,19.373799999999996,18.51875000000003,19.978408333333334,8169644,9450708,59.273720749025244,4.27521839623106,1.5,2.75,NaN,NaN,0.820978335323991,0.8644478276124921,554.5240186482336,0.2948729576363302,0.2484755282093012,-0.04639742942702903,48.05573422882773,11.429358303497656,48.158472494708036,20.483396799901417,31.358130705390536,4925660312
1445002200,20.38,20.52225,20.12,20.4925,16.076,18.2564,24.2875,16.1975,24.2875,16.1975,23.78275,21.5025,22.995,16.2775,21.87048887499999,21.224725000000003,19.330749999999995,18.62400000000003,19.57535645611786,19.172493896770504,19.2298076923077,21.225359921196947,17.23425546341845,21.87048887499999,21.224725000000003,19.330749999999995,18.62400000000003,20.37825,5781972,9246296.2,60.87270385471958,4.737393181245361,1.5,2.75,NaN,NaN,0.7910691685151344,0.6253284423226676,557.0973338678505,0.2986745224001177,0.32694572357311813,0.0282712011730004,44.87259658577815,7.094329762215826,48.28183141982178,20.390885320395824,31.32728325978241,4931442284
1445261400,20.31,20.55,20.175,20.54,16.078,18.16074761904762,24.2875,16.1975,24.2875,16.1975,23.78275,21.5025,22.995,16.2775,21.86363887499999,21.190800000000003,19.291799999999995,18.71725000000003,19.61318561470147,19.30273257326855,19.48153846153847,21.2342863464121,17.72879057666484,21.86363887499999,21.190800000000003,19.291799999999995,18.71725000000003,20.421666666666667,4380308,9108966.6,61.1697937108153,4.1916973939129205,1.5,2.75,NaN,NaN,0.7613499421926248,0.4808786981390403,555.5075311985004,0.28817385343179025,0.3884885179627382,0.10031466453094796,36.862171962566975,8.419107944048555,49.656608909869234,19.3788119169797,30.964579173151066,4935822592
1445347800,20.4,20.6925,20.305,20.4525,16.080000000000002,18.06509523809524,24.2875,16.1975,24.2875,16.1975,23.78275,21.5025,22.995,16.2775,21.86222637499999,21.160675,19.234499999999993,18.84162500000003,19.646099904321023,19.41223423295726,19.715769230769236,21.06453559677158,18.367002864766892,21.86222637499999,21.160675,19.234499999999993,18.84162500000003,20.483333333333334,4897936,8872340.8,60.262075192072565,3.8487082776566117,1.5,2.75,NaN,NaN,0.7346463748931515,0.5520455210647454,558.165067651684,0.25998709274040593,0.4252985304564554,0.16531143771604945,36.03331676339232,5.357372826786859,50.709924724402,18.618661677408273,30.67141359818974,4930924656
1445434200,20.63,20.6775,20.0275,20.0875,16.082,17.96944285714286,24.2875,16.1975,24.2875,16.1975,23.78275,21.5025,22.995,16.2775,21.861851374999986,21.125525000000003,19.182299999999994,18.95262500000003,19.66340971199471,19.4765452583899,19.86442307692308,20.87623248784179,18.852613666004373,21.861851374999986,21.125525000000003,19.182299999999994,18.95262500000003,20.264166666666664,5779020,8864330.2,56.49589928578608,2.5492819127694686,1.5,2.75,NaN,NaN,0.7286002052579263,0.6519409667297819,556.3937363221753,0.20389066408166037,0.4201747678181249,0.21628410373646453,37.0295156301455,0.7270903848564603,53.46699289039003,16.703005715081567,29.83000139452841,4925145636
1445520600,20.425,21.1725,20.38,21.085,16.084,17.87379047619048,24.2875,16.1975,24.2875,16.1975,23.78275,21.5025,22.995,16.2775,21.862713874999987,21.101175,19.148399999999995,19.121875000000028,19.719158350740017,19.62973142425753,20.01442307692308,21.1227779802442,18.90606817360196,21.862713874999987,21.101175,19.148399999999995,19.121875000000028,20.87916666666667,7288872,8481077.6,63.254613206075334,5.150849921012435,1.5,2.75,NaN,NaN,0.7540573334537888,0.8594275802876749,560.9626530427996,0.2197285226116223,0.4909447570009924,0.2712162343893701,43.50897087673349,5.59659446600726,52.39797141726695,17.43318417244434,30.168844410288692,4932434508
1445607000,21.7075,21.93,21.43,21.7925,16.086000000000002,17.778138095238095,24.2875,16.1975,24.2875,16.1975,23.78275,21.5025,22.995,16.2775,21.861551374999987,21.081825000000002,19.130649999999996,19.32950000000003,19.80046586639727,19.83570938385205,20.233461538461544,21.520873280711413,18.946049796211675,21.861551374999987,21.081825000000002,19.130649999999996,19.32950000000003,21.717499999999998,6599420,8222607.4,67.15254165070226,7.236474773627877,1.5,2.75,NaN,NaN,0.7605532382070895,0.802594563860607,563.2267673491527,0.26081522378111466,0.5972352641157634,0.3364200403346488,46.08815468832639,8.717884759291588,54.68210041618364,15.89216877583322,29.425730807983143,4939033928
1445866200,21.725,21.7525,21.5105,21.6275,16.088,17.682485714285715,24.2875,16.1975,24.2875,16.1975,23.78275,21.5025,22.995,16.2775,21.862363874999982,21.0664,19.104549999999996,19.595875000000028,19.872114263793456,20.006356109199473,20.403846153846157,21.793766759471108,19.013925548221206,21.862363874999982,21.0664,19.104549999999996,19.595875000000028,21.630166666666668,5123016,7735290,65.40986631728398,5.75899906365545,1.5,2.75,NaN,NaN,0.7263708640494403,0.6622913943756472,560.3103280856795,0.25929821526443614,0.6605428094151939,0.4012445941507578,46.99123005004601,10.133672819859973,32.47743952649599,34.34822672636793,33.174333747136075,4933910912
1445952600,21.3975,21.6405,21.2695,21.505,16.09,17.586833333333335,24.2875,16.1975,24.2875,16.1975,23.78275,21.5025,22.995,16.2775,21.865076374999987,21.051550000000006,19.068699999999996,19.853875000000027,19.936148998546653,20.149084098799523,20.524038461538467,22.00109444514174,19.046982477935195,21.865076374999987,21.051550000000006,19.068699999999996,19.853875000000027,21.471666666666664,5005744,7462233.4,64.08028383725141,4.210456803475942,1.5,2.75,NaN,NaN,0.7009872309030516,0.6708104305609095,557.7236659013117,0.23327880860968214,0.6928431049128605,0.45956429630317835,44.44662353336559,11.136950904392751,31.733064095457507,35.11227207987121,33.154663824671275,4928905168
1446039000,21.645,22.25,21.39,22.24,16.092000000000002,17.491180952380954,24.2875,16.1975,24.2875,16.1975,23.78275,21.5025,22.995,16.2775,21.872401374999985,21.048200000000005,19.05155,20.102500000000028,20.026496096642862,20.348218946532903,20.698846153846155,22.393003098016113,19.004689209676197,21.872401374999985,21.048200000000005,19.05155,20.102500000000028,21.959999999999997,7420644,7156902.2,68.25038354570103,5.212818783873782,1.5,2.75,NaN,NaN,0.7123452858385478,1.0368513908154284,561.3022089217676,0.24745771091556845,0.768886434947639,0.5214287240320705,43.61565943889364,9.935739001482936,61.19939254735928,11.94526753186215,26.85533992077857,4936325812
1446125400,22.05,22.3425,22.0075,22.2125,16.094,17.39552857142857,24.2875,16.1975,24.2875,16.1975,23.78275,21.5025,22.995,16.2775,21.881438874999986,21.044900000000005,19.0448,20.34275000000003,20.11222173991177,20.52576952305358,20.865576923076922,22.691062268282995,19.04009157787085,21.881438874999986,21.044900000000005,19.0448,20.34275000000003,22.1875,4636412,6897859.6,67.93260698341093,5.406080579522952,1.5,2.75,NaN,NaN,0.6853920511357945,0.6721522716988905,559.0477230010049,0.23686387817923238,0.817508571756111,0.5806446935768786,39.612675266199304,8.393314627302667,34.30732296802857,32.517606301109,33.17507073086242,4931689400
1446211800,22.27,22.392525,21.8525,21.905,16.096,17.29987619047619,24.2875,16.1975,24.2875,16.1975,23.78275,21.5025,22.995,16.2775,21.891688874999986,21.03025000000001,19.060349999999996,20.53025000000003,20.182526769719153,20.657124806572288,21.040000000000003,22.794730967764227,19.285269032235778,21.891688874999986,21.03025000000001,19.060349999999996,20.53025000000003,22.050008333333334,4356168,6421918.4,64.32598739468855,4.49543716669919,1.5,2.75,NaN,NaN,0.6750086903403806,0.6783281456830719,560.5578136710561,0.19288951470362603,0.8217565869564112,0.6288670722527852,41.66859075380503,6.645569620253174,11.198269414927184,62.52049308887676,26.28123749619606,4927333232
1446474600,22.0275,22.7625,21.9975,22.675,16.098000000000003,17.20422380952381,24.2875,16.1975,24.2875,16.1975,23.78275,21.5025,22.995,16.2775,21.90206374999999,21.02110000000001,19.131199999999993,20.70725000000003,20.280270817965462,20.849303396422545,21.29576923076923,22.9574370498078,19.63410141173066,21.90206374999999,21.02110000000001,19.131199999999993,20.70725000000003,22.478333333333335,3650372,5919462.4,68.79378454530524,5.548489742705965,1.5,2.75,NaN,NaN,0.6880437838874961,0.616672892457261,566.6782711702958,0.1986219885885585,0.8771445579884833,0.6785225693999248,44.443274434414135,10.866642219777534,27.258602137105655,39.81898769940259,32.92241016349176,4930983604
1446561000,22.54,23.10415,22.4675,22.8675,16.1,23.10415,24.2875,16.1975,24.2875,16.1975,23.78275,21.5025,22.995,16.2775,21.912688749999987,21.01920000000001,19.252149999999993,20.903375000000032,20.381730785888386,21.041512596763255,21.498653846153847,23.232752609405253,19.76455508290244,21.912688749999987,21.01920000000001,19.252149999999993,20.903375000000032,22.813050000000004,4374200,5800958.4,69.81168441513009,5.982624175641957,1.5,2.75,NaN,NaN,0.6843727993241034,0.7540478138922699,568.724116685228,0.19790183885230506,0.9258998679653061,0.727998029113001,43.553240843590366,13.83945239576852,53.49302311286502,16.66795966908881,29.839017218046187,4935357804
1446647400,23,23.05,22.48,22.6775,16.102,23.19018181818182,24.2875,16.1975,24.2875,16.1975,23.78275,21.5025,22.995,16.2775,21.920751249999988,21.018750000000008,19.381749999999993,21.06662500000003,20.471760951147665,21.19732092088104,21.66673076923077,23.40172399091492,19.93173754754662,21.920751249999988,21.018750000000008,19.381749999999993,21.06662500000003,22.735833333333332,4839604,5649392.8,67.47232379707117,4.439966578971381,1.5,2.75,NaN,NaN,0.676203313658096,0.8566591439703042,566.1660943513009,0.16831374634512763,0.9383902120444105,0.7700764656992829,41.49444752691273,7.552762627460269,18.62179045993044,50.67941958607951,30.698789953990044,4930518200
1446733800,22.7,22.885,22.27275,22.59,16.104000000000003,23.276213636363636,24.2875,16.1975,24.2875,16.1975,23.78275,21.5025,22.995,16.2775,21.92372624999999,21.013450000000013,19.471649999999993,21.19900000000003,20.554829149141874,21.329957023654273,21.824423076923075,23.49247485836217,20.156371295483982,21.92372624999999,21.013450000000013,19.471649999999993,21.19900000000003,22.582583333333332,4829748,5461039,66.36932361323433,3.2342527407896955,1.5,2.75,NaN,NaN,0.6716352198253751,0.8844009354263904,565.3730836455841,0.128340532742371,0.9305021316272466,0.8021615988848756,35.11798118805661,3.659515888493745,18.142529223504532,51.35500075186725,30.502470024628217,4925688452
1446820200,22.4675,22.66425,22.060275,22.5575,16.106,23.362245454545455,24.2875,16.1975,24.2875,16.1975,23.78275,21.5025,22.995,16.2775,21.928376249999992,21.00672500000001,19.534549999999992,21.32850000000003,20.63336526094023,21.446865878544344,21.986346153846153,23.49092073642962,20.481771571262687,21.928376249999992,21.00672500000001,19.534549999999992,21.32850000000003,22.427341666666667,6540388,5494547,65.93815543361814,2.1449151341610397,1.5,2.75,NaN,NaN,0.6668023469807053,1.1903416241593712,562.0697876089137,0.0871710458150291,0.911125406153662,0.8239543603386329,31.088606508300558,4.300080915501097,14.690162090285014,56.51630805545663,28.793529854258356,4919148064
1447079400,22.3425,22.39,21.5865,21.9225,16.108,23.448277272727275,24.2875,16.1975,24.2875,16.1975,23.78275,21.5025,22.995,16.2775,21.929001249999992,20.986625000000014,19.584699999999994,21.42237500000003,20.68391956443277,21.492164366302024,22.1275,23.164746725341068,21.090253274658934,21.929001249999992,20.986625000000014,19.584699999999994,21.42237500000003,21.96633333333333,6684824,5638430.2,58.008633684307604,0.48094101858870375,1.5,2.75,NaN,NaN,0.6885307507677977,1.1855824693901504,556.1537078258141,0.008761107581139127,0.8349057448150567,0.8261446372339176,35.77380015184532,1.9414089746570586,3.051750577451654,81.20669759480298,15.741551827745365,4912463240
1447165800,21.7525,22.1025,21.6525,22.0625,16.110000000000003,23.53430909090909,22.8675,16.1975,24.2875,16.1975,23.78275,21.5025,22.995,16.2775,21.934701249999993,20.97217500000001,19.647499999999994,21.54362500000003,20.73798154229815,21.546482045701833,22.20269230769231,23.051316673127022,21.354067942257597,21.934701249999993,20.97217500000001,19.647499999999994,21.54362500000003,21.939166666666665,4207448,5575252.8,59.17432240973658,0.2029983920359426,1.5,2.75,NaN,NaN,0.6714928399986693,0.7546649723219726,558.4288936617921,-0.039441324413440726,0.7768429817171167,0.8162843061305575,35.574844861079455,-0.7981115107913599,2.6697768349123847,82.49078998122792,14.83943318385971,4916670688
1447252200,22.2,22.21,21.8,21.8,16.112000000000002,23.62034090909091,22.8675,16.1975,24.2875,16.1975,23.78275,21.5025,22.995,16.2775,21.943176249999997,20.950275000000016,19.738849999999992,21.66612500000003,20.779629324953124,21.570626612777847,22.203269230769234,23.050786838063946,21.35575162347452,21.943176249999997,20.950275000000016,19.738849999999992,21.66612500000003,21.936666666666667,7607372,5608655.6,56.033411554851654,0.18777044514566543,1.5,2.75,NaN,NaN,0.6528147799987644,1.3563628331894724,556.1354813003228,-0.09178014050807992,0.7015591304954576,0.7933392710035375,30.248208162527327,-1.857062464828353,2.212824869365713,84.14264156563395,13.64453356500034,4909063316
1447338600,21.44,21.6075,20.9075,20.9175,16.114,23.70637272727273,22.8675,16.1975,24.2875,16.1975,23.78275,21.5025,22.995,16.2775,21.944413749999995,20.918975000000014,19.793149999999994,21.70050000000003,20.785036018092217,21.508424078227577,22.148653846153852,23.203655879299205,21.0936518130085,21.944413749999995,20.918975000000014,19.793149999999994,21.70050000000003,21.144166666666667,7788256,5589586.2,47.00107349698952,3.1237142316420967,1.5,2.75,NaN,NaN,0.6699351528559957,1.3933510856313478,550.879704630239,-0.18332564085760494,0.5641822199315314,0.7475078607891363,37.690356180203025,-4.508103172791603,1.8759826173209562,85.46267515693573,12.66134222574331,4901275060
1447425000,20.75,20.85,20.1725,20.21,16.116000000000003,23.792404545454545,22.8675,16.1975,24.2875,16.1975,23.78275,21.5025,22.995,16.2775,21.945976249999994,20.885800000000014,19.832849999999993,21.68637500000003,20.76248558601017,21.3847646422059,22.049038461538466,23.498964903255608,20.599112019821323,21.945976249999994,20.885800000000014,19.832849999999993,21.68637500000003,20.410833333333333,8350708,5718023,41.259006000910105,6.209871997936175,1.5,2.75,NaN,NaN,0.6752969276519961,1.460418749627275,548.0734615901586,-0.2830602375517357,0.39368256384946676,0.6767428014012025,40.94787146246109,-10.871003307607497,1.763838378100998,85.925866749177,12.310294872721999,4892924352
1447684200,20.1425,21.135,20.1005,21.13,20.1005,23.878436363636364,22.8675,16.1975,24.2875,16.1975,23.78275,21.5025,22.995,16.2775,21.948588749999995,20.864050000000017,19.907099999999993,21.71587500000003,20.776897915970554,21.360501342948197,21.96365384615385,23.48739622214868,20.43991147015902,21.948588749999995,20.864050000000017,19.907099999999993,21.71587500000003,20.7885,7519320,5874973.6,49.840447323106474,3.395099812245142,1.5,2.75,NaN,NaN,0.7009542899625679,1.2798900066546683,552.211093763274,-0.278190949421368,0.3290041146244924,0.6071950640458604,44.93745458219167,-7.598119602055322,13.888014929388728,57.81813669036766,28.2938483802436,4900443672
1447770600,21.235,21.5675,20.892625,21.06,20.219632352941176,23.964468181818184,22.8675,16.1975,24.2875,16.1975,23.78275,21.5025,22.995,16.2775,21.946401249999994,20.841700000000014,19.95324999999999,21.74625000000003,20.787999958481514,21.33188216742932,21.875000000000004,23.463256179685036,20.28674382031497,21.946401249999994,20.841700000000014,19.95324999999999,21.74625000000003,21.173374999999997,10901116,6175132.6,49.25088746912418,1.6434090697792276,1.5,2.75,NaN,NaN,0.6990914835366703,1.765325006948029,549.0421422771943,-0.2705586626604368,0.26899673572031446,0.5395553983807513,43.950050482751365,-7.132620438760886,3.567125133501592,79.6071038860104,16.825770980488013,4889542556
1447857000,21.2525,22.125,21.23,22.0625,20.338764705882355,24.0505,22.8675,16.1975,24.2875,16.1975,23.78275,21.5025,22.995,16.2775,21.95038874999999,20.844025000000016,20.03509999999999,21.84500000000003,20.837980352266552,21.401464818150338,21.887115384615388,23.47850187027673,20.295728898954046,21.95038874999999,20.844025000000016,20.03509999999999,21.84500000000003,21.805833333333336,7917548,6282059,57.08097844971027,1.4292856110340197,1.5,2.75,NaN,NaN,0.725227806141194,1.2603428270890165,553.3368418527693,-0.19253357660477005,0.29888842762478873,0.4914220042295588,53.994731468824035,-2.3351040283311195,17.38751455363752,52.45732129196617,30.15516415439632,4897460104
1447943400,22.035,22.1825,21.91,22.0025,20.45789705882353,24.13653181818182,22.8675,16.1975,24.2875,16.1975,23.78275,21.5025,22.995,16.2775,21.95077624999999,20.844125000000016,20.10994999999999,21.89087500000003,20.88364778943257,21.45870626404078,21.835384615384616,23.3634223794088,20.307346851360432,21.95077624999999,20.844125000000016,20.10994999999999,21.89087500000003,22.031666666666666,7911600,6313195.4,56.51891707560795,1.9701325373633856,1.5,2.75,NaN,NaN,0.6928901057025374,1.2531847184707763,554.5708302128146,-0.1418452964673348,0.31411538364539027,0.45596068011272506,53.990078734025765,-2.46037903136429,16.92916185001052,53.12658060205428,29.944257547935187,4889548504
1448029800,22.2875,22.5125,22.115,22.275,20.577029411764705,24.22256363636364,22.8675,16.1975,24.2875,16.1975,23.78275,21.5025,22.995,16.2775,21.953601249999988,20.842225000000017,20.18529999999999,21.915000000000028,20.938210621219525,21.536448524608325,21.78980769230769,23.224479272976485,20.355136111638895,21.953601249999988,20.842225000000017,20.18529999999999,21.915000000000028,22.300833333333333,5367876,6251618.2,58.51677580292918,2.720348759040317,1.5,2.75,NaN,NaN,0.6798265267237846,0.8586378483574061,557.4431115360836,-0.0894056927383507,0.3442035641897867,0.4336092569281374,54.67193739718322,1.6079370509750217,36.18236827810883,30.596012382064576,33.22161933982659,4894916380
1448289000,22.275,22.4725,22.0025,22.16,20.69616176470588,24.308595454545454,22.8675,16.1975,24.2875,16.1975,23.78275,21.5025,22.995,16.2775,21.95726374999999,20.839725000000016,20.26269999999999,21.94162500000003,20.986123930191308,21.59583437940753,21.75,23.110753467752332,20.389246532247668,21.95726374999999,20.839725000000016,20.26269999999999,21.94162500000003,22.21166666666667,4590856,6225010.2,57.31980071399129,2.032241350647284,1.5,2.75,NaN,NaN,0.6648389176720856,0.7374856992202198,558.6629475906418,-0.06314293506144775,0.35468058810132774,0.4178235231627755,51.98808751204954,0.4419263456090658,18.080664426014465,51.43794524525774,30.48139032872779,4890325524
1448375400,21.7925,22.41975,21.648,22.26,20.81529411764706,24.394627272727273,22.8675,16.1975,24.2875,16.1975,23.78275,21.5025,22.995,16.2775,21.958038749999993,20.84005000000002,20.32779999999999,21.97937500000003,21.03607985449753,21.659088248035385,21.724615384615387,23.03304786744749,20.416182901783284,21.958038749999993,20.84005000000002,20.32779999999999,21.97937500000003,22.109250000000003,5227004,6236073.2,58.12199135033563,1.9846593355088316,1.5,2.75,NaN,NaN,0.672475423552651,0.8381883650756377,561.4603716549103,-0.04079934127247914,0.36682434657217655,0.4076236878446557,51.929841698313965,2.11009174311927,47.74495903307113,20.775628361098963,31.479412605829904,4895552528
1448461800,22.3175,22.385,22.156875,22.2475,20.934426470588235,24.480659090909093,22.8675,16.1975,24.2875,16.1975,23.78275,21.5025,22.995,16.2775,21.958488749999994,20.83627500000002,20.382899999999992,21.97975000000003,21.083586526870175,21.715127462508207,21.700769230769232,22.957909429509986,20.44362903202848,21.958488749999994,20.83627500000002,20.382899999999992,21.97975000000003,22.263125000000002,3293032,6029692.6,57.97530527456415,1.9062658396878844,1.5,2.75,NaN,NaN,0.6407361075846046,0.5461359671967357,563.9222549919548,-0.029169988816969306,0.37116120182344403,0.40033119064041334,51.306531382139866,6.358312417831951,21.912660895175613,46.26349971608183,31.82383938874255,4892259496
1448634600,22.2775,22.40175,22.1025,22.3275,21.05355882352941,24.56669090909091,22.8675,16.1975,24.2875,16.1975,23.78275,21.5025,22.995,16.2775,21.956251249999994,20.84452500000002,20.442399999999992,21.98550000000003,21.132367447385068,21.773448656555043,21.731923076923074,23.028939110638916,20.434907043207232,21.956251249999994,20.84452500000002,20.442399999999992,21.98550000000003,22.27725,2054740,5900609,58.693807677475796,1.6978376782904683,1.5,2.75,NaN,NaN,0.616344242757133,0.3482250730390711,566.3871021876473,-0.018896126924106305,0.37671103198528044,0.39560715890938675,43.28414938710315,10.477486392874813,50.468410914413674,18.769261941795286,30.762327143791044,4894314236
1448893800,22.3975,22.44,22.01,22.04,21.17269117647059,24.652722727272728,22.8675,16.1975,24.2875,16.1975,23.78275,21.5025,22.995,16.2775,21.951038749999995,20.848850000000017,20.51544999999999,21.99225000000003,21.16796088082095,21.798834498787897,21.73019230769231,23.025498124773094,20.434886490611525,21.951038749999995,20.848850000000017,20.51544999999999,21.99225000000003,22.163333333333338,3728036,5869202.4,55.051116653674676,0.8937501141285606,1.5,2.75,NaN,NaN,0.6030339397030521,0.635186137046492,564.2327982070017,-0.033420356430307885,0.3538317133715019,0.38725206980180976,37.19883312657136,4.306672976810224,19.19164387056188,49.88129146719058,30.927064662247545,4890586200
1448980200,22.2625,22.7225,22.1875,22.685,21.291823529411765,24.738754545454547,22.8675,16.1975,24.2875,16.1975,23.78275,21.5025,22.995,16.2775,21.948551249999994,20.851525000000017,20.595649999999992,21.99275000000003,21.227452610984834,21.88323121318905,21.79826923076923,23.190494047682215,20.406044413856243,21.948551249999994,20.851525000000017,20.595649999999992,21.99275000000003,22.531666666666666,4857592,5929563.4,60.91219918027678,2.044510015318336,1.5,2.75,NaN,NaN,0.6087100868671198,0.8192157958881087,568.1521662406434,-0.0031400218331945617,0.3833270425103166,0.38646706434351114,32.470349582086655,7.71604938271605,52.17276088615407,17.566546117116438,30.260692996729496,4895443792
1449066600,22.66,22.7775,21.88,21.965,21.41095588235294,22.7775,22.8675,16.1975,24.2875,16.1975,23.78275,21.5025,22.995,16.2775,21.942426249999997,20.83960000000002,20.67564999999999,21.947625000000027,21.256376038005037,21.891018716694855,21.87884615384615,23.175834700418875,20.581857607273427,21.942426249999997,20.83960000000002,20.67564999999999,21.947625000000027,22.2075,6247660,6023236.4,52.65790453583856,0.6981302262450495,1.5,2.75,NaN,NaN,0.6293379378051827,1.0372596366963116,563.2659611692204,-0.03346835400642301,0.34463162183548235,0.37809997584190536,39.363005476723174,-0.4419263456090658,15.282693561892875,55.58406146251664,29.133244975590493,4889196132
1449153000,22.0825,22.165,20.7875,21.045,21.530088235294116,22.7611675,22.8675,16.1975,24.2875,16.1975,23.78275,21.5025,22.995,16.2775,21.93191375,20.81542500000002,20.739199999999993,21.866000000000028,21.24808678161268,21.81044550558106,21.943076923076923,22.954352115491382,20.931801730662464,21.93191375,20.81542500000002,20.739199999999993,21.866000000000028,21.3325,7855888,6174050.6,44.38188598550519,4.042186765382725,1.5,2.75,NaN,NaN,0.6827780851048123,1.2724042138559732,557.6046143808999,-0.11288241465339272,0.23699695752516448,0.3498793721785572,37.57076117909555,-4.351778207021927,10.213152533529934,64.19290478551333,25.593942680956747,4881340244
1449239400,21.1925,22.39,21.1725,22.2625,21.649220588235295,22.744835,22.8675,16.1975,24.2875,16.1975,23.78275,21.5025,22.995,16.2775,21.92546375,20.803625000000014,20.830449999999992,21.849625000000028,21.287867692137674,21.85349831457334,22.030192307692307,22.93589743362896,21.124487181755654,21.92546375,20.803625000000014,20.830449999999992,21.849625000000028,21.941666666666666,7882932,6326709.8,54.55989889797979,1.3276427397772885,1.5,2.75,NaN,NaN,0.7300796504544685,1.2459765421831108,560.2305470510306,-0.08223190440747408,0.24708949166921457,0.32932139607668864,51.377906082213165,-0.056116722783386266,23.558037495603926,44.19058876644132,32.25137373795476,4889223176
1449498600,22.14,22.155,21.505,21.845,21.76835294117647,22.7285025,22.8675,16.1975,24.2875,16.1975,23.78275,21.5025,22.995,16.2775,21.91697625,20.782600000000013,20.91454999999999,21.81400000000003,21.309716017936196,21.85268895128064,22.09057692307692,22.8162812330835,21.36487261307034,21.91697625,20.782600000000013,20.91454999999999,21.81400000000003,21.834999999999997,4985676,6248974.2,51.106140027614444,0.9374099244563859,1.5,2.75,NaN,NaN,0.7320382468505781,0.7978391077370747,556.0087548472663,-0.0883562610235562,0.2188760697972434,0.3072323308207996,52.02282669285936,-1.421480144404338,23.028980254218304,44.87237201647894,32.09864772930275,4884237500
1449585000,21.29,21.77,21.06375,21.345,21.887485294117646,22.71217,22.8675,16.1975,24.2875,16.1975,23.78275,21.5025,22.995,16.2775,21.905026250000006,20.75547500000001,21.01544999999999,21.78512500000003,21.311099703507328,21.804337622587248,22.035384615384608,22.863189511930624,21.20757971883859,21.905026250000006,20.75547500000001,21.01544999999999,21.78512500000003,21.392916666666665,5958624,6212664.2,47.24863968110458,2.1803749201028193,1.5,2.75,NaN,NaN,0.7355533720755368,0.9591092980689347,552.2808283596012,-0.12227291832079495,0.1543911829198059,0.27666410124060087,53.4312940444367,-4.110512129380066,7.800422355244252,69.02909784373371,23.17047980102204,4878278876
1449671400,21.2125,21.97,20.575,20.9425,22.006617647058825,22.6958375,22.8675,16.1975,22.8675,16.1975,24.2875,21.5025,23.78275,16.2775,21.891388750000004,20.72387500000001,21.107399999999995,21.729125000000028,21.296644813173707,21.72225784900751,21.953846153846147,22.966684160835598,20.941008146856696,21.891388750000004,20.72387500000001,21.107399999999995,21.729125000000028,21.162499999999998,9394880,6472035.8,44.34678539386515,4.06210786434413,1.5,2.75,NaN,NaN,0.78265670264157,1.4516112534482581,549.5816221270738,-0.16533037710216464,0.07000112986289508,0.23533150696505972,53.806754424244104,-5.865827621081019,6.573817680528551,71.74146274253474,21.684719576936704,4868883996
1449757800,20.97,21.56,20.8625,21.085,22.12575,22.679505,22.8675,16.1975,22.8675,16.1975,24.2875,21.5025,23.78275,16.2775,21.878901250000002,20.696650000000012,21.183749999999996,21.693375000000024,21.28834501657866,21.661566625292508,21.862307692307688,22.954490512905718,20.77012487170966,21.878901250000002,20.696650000000012,21.183749999999996,21.693375000000024,21.169166666666666,5587420,6371038.2,45.62016485710611,2.212644668991641,1.5,2.75,NaN,NaN,0.7765740810243148,0.8770030605058999,550.0877825236947,-0.17670252187569635,0.014453354620439285,0.19115587649613563,54.245485099355996,-5.56488635091255,22.35160456592423,45.72598066857673,31.92241476549905,4874471416
1449844200,20.3275,20.5525,19.745,19.86,22.244882352941175,22.663172499999998,22.8675,16.1975,22.8675,16.1975,24.2875,21.5025,23.78275,16.2775,21.861488750000003,20.658625000000015,21.232799999999994,21.640500000000024,21.232331486516753,21.489988851455127,21.68538461538461,23.19336319888108,20.17740603188814,21.861488750000003,20.658625000000015,21.232799999999994,21.640500000000024,20.0525,13487108,6655980.8,37.645892085702684,7.199376116585709,1.5,2.75,NaN,NaN,0.8168187895225779,2.0263141384061685,546.7756165632161,-0.2544866935351019,-0.1269524904227417,0.12753420311236016,62.04853266487439,-9.891107078039926,2.500949530385604,83.10369175362644,14.395358715987953,4860984308
1450103400,19.9175,20.1875,19.295075,20.1875,22.364014705882354,22.64684,22.8675,16.1975,22.8675,16.1975,24.2875,21.5025,23.78275,16.2775,21.843512500000003,20.627750000000013,21.273449999999993,21.639375000000026,21.191357702731782,21.365942294173685,21.525961538461534,23.18761680501115,19.864306271911918,21.843512500000003,20.627750000000013,21.273449999999993,21.639375000000026,19.890024999999998,10816044,6779247.6,40.633578466396756,6.545430024585626,1.5,2.75,NaN,NaN,0.8222192331281081,1.5954637797858275,541.9156733928644,-0.27016211249231686,-0.21016843750303593,0.05999367498928093,64.07507065065985,-11.0094776283888,16.668878057808048,53.485825712456815,29.845296229735133,4871800352
1450189800,20.7,21.1125,20.646,20.79,22.48314705882353,22.6305075,22.8675,16.1975,22.8675,16.1975,24.2875,21.5025,23.78275,16.2775,21.830037500000003,20.610175000000012,21.306549999999994,21.622375000000027,21.175618184977594,21.311090647109523,21.413846153846148,23.062265694572513,19.765426613119782,21.830037500000003,20.610175000000012,21.306549999999994,21.622375000000027,20.8495,11923808,6999472,45.78059014478335,1.4511111916988422,1.5,2.75,NaN,NaN,0.8295607164761004,1.703529637664098,547.7125495848238,-0.22792162548575026,-0.2249083568679069,0.0030132686178433662,64.19655759208607,-5.349419531072163,40.58098455267615,26.58691723575603,32.83209821156781,4883724160
1450276200,21.2175,21.81,20.7,21.6775,22.602279411764705,22.614175,22.8675,16.1975,22.8675,16.1975,24.2875,21.5025,23.78275,16.2775,21.822450000000003,20.60542500000001,21.361199999999993,21.65325000000003,21.195299824782396,21.345986775956234,21.36384615384615,22.936050162169174,19.791642145523127,21.822450000000003,20.60542500000001,21.361199999999993,21.65325000000003,21.395833333333332,14750240,7191928.2,52.33601210435074,1.1219159047323832,1.5,2.75,NaN,NaN,0.8495920938706646,2.050943723270207,553.7571370014335,-0.1328873730902939,-0.163095947745024,-0.030208574654730112,68.19620842388201,3.005464480874301,71.82086747826276,6.531035942263544,21.6480965794737,4898474400
1450362600,21.8175,21.845,20.7125,20.72,22.721411764705884,22.5978425,22.8675,16.1975,22.8675,16.1975,24.2875,21.5025,23.78275,16.2775,21.809775000000005,20.583150000000003,21.387349999999998,21.586125000000028,21.1766606159674,21.286368987769926,21.262307692307687,22.817127075261688,19.707488309353685,21.809775000000005,20.583150000000003,21.387349999999998,21.586125000000028,21.092499999999998,11857464,7388924,45.88963675085408,0.5931070077316225,1.5,2.75,NaN,NaN,0.8697998014513314,1.6047619382740979,550.3171757613418,-0.12718557642146983,-0.18919054518156742,-0.062004968760097576,68.73785738771234,-6.9286917462099975,47.47250238754405,20.981565525455856,31.54593208700012,4886616936
1450449000,20.4375,20.46,19.5375,19.5375,22.84054411764706,22.581509999999998,22.8675,16.1975,22.8675,16.1975,24.2875,21.5025,23.78275,16.2775,21.796075000000005,20.544225000000004,21.379249999999992,21.46287500000003,21.11237980749809,21.119810036553744,21.0201923076923,22.593587047075,19.446797568309602,21.796075000000005,20.544225000000004,21.379249999999992,21.46287500000003,19.845000000000002,11700180,7578353,39.430246743841344,5.5181118708158765,1.5,2.75,NaN,NaN,0.8921355299190933,1.5438948278075724,548.3838424280085,-0.19184362265130397,-0.30180949707422755,-0.10996587442292358,64.94145607222241,-10.563057907988087,50.23404185302648,18.937032884644307,30.828925262329214,4874916756
1450708200,20.03,20.15,19.61775,20.075,22.959676470588235,22.5651775,22.8675,16.1975,22.8675,16.1975,24.2875,21.5025,23.78275,16.2775,21.783687500000006,20.510525,21.381399999999996,21.35287500000003,21.071698246419732,21.02030431878672,20.874807692307687,22.42117373209066,19.328441652524713,21.783687500000006,20.510525,21.381399999999996,21.35287500000003,19.94758333333333,7924356,7706177,43.33466513240281,4.733667016290649,1.5,2.75,NaN,NaN,0.8721615634963007,1.0283122227792068,551.8326273802865,-0.18700874149924024,-0.34372680129697386,-0.15671805979773362,68.68092944771244,-5.949871164207073,48.38600104529142,20.28660847084457,31.327390483864026,4882841112
1450794600,20.3925,20.7275,20.045,20.62,23.07880882352941,22.548845,22.8675,16.1975,22.8675,16.1975,24.2875,21.5025,23.78275,16.2775,21.779500000000002,20.483400000000003,21.39289999999999,21.275875000000028,21.05398458969739,20.98218009794989,20.84211538461538,22.390675318819568,19.29355545041119,21.779500000000002,20.483400000000003,21.39289999999999,21.275875000000028,20.464166666666667,6882240,7820746.2,47.06097687557969,1.5120522156729967,1.5,2.75,NaN,NaN,0.8586143089608506,0.8799978702799485,556.2853973601784,-0.13796562899669804,-0.3291750960436062,-0.19120946704690814,70.71268389482358,-1.5399307628029033,42.86971815975544,24.6354093496676,32.49487249057695,4889723352
1450881000,20.9875,21.4,20.9522,21.3675,23.19794117647059,22.5325125,22.8675,16.1975,22.8675,16.1975,24.2875,21.5025,23.78275,16.2775,21.779850000000007,20.466124999999998,21.42749999999999,21.231250000000028,21.06627931167004,21.01887723147847,20.773269230769227,22.130930376630833,19.41560808490762,21.779850000000007,20.466124999999998,21.42749999999999,21.231250000000028,21.2399,5789644,7848878.2,51.74779664444319,2.0921834496530534,1.5,2.75,NaN,NaN,0.8529990011779326,0.7376396795149656,562.4511859676918,-0.050547046037583476,-0.2543932745938875,-0.20384622855630402,73.20993595831263,1.3398150343846282,29.980712775639272,36.804521358804045,33.21476586555669,4895512996
1450967400,21.2775,21.475,21.2,21.24925,23.317073529411765,22.51618,22.8675,16.1975,22.8675,16.1975,24.2875,21.5025,23.78275,16.2775,21.775471250000006,20.4491675,21.465484999999994,21.18133750000003,21.07345463278102,21.040817495147188,20.727442307692304,21.972888384001543,19.481996231383064,21.775471250000006,20.4491675,21.465484999999994,21.18133750000003,21.308083333333332,2834864,7825969.8,50.978900941077285,1.8451616252433831,1.5,2.75,NaN,NaN,0.8117133582366519,0.3622380449257548,564.1139264412333,0.0012069762686187924,-0.20233750822053054,-0.20354448448914933,73.25766336354619,6.995216515609268,46.9491768568406,21.375051327278936,31.67577181588046,4892678132
1451313000,21.0275,21.1375,20.7375,21.1125,23.43620588235294,22.499847499999998,22.8675,16.1975,22.8675,16.1975,24.2875,21.5025,23.78275,16.2775,21.772533750000008,20.4284675,21.483134999999994,21.12058750000003,21.07498582365235,21.047644400371265,20.70955769230769,21.925341772230635,19.493773612384746,21.772533750000008,20.4284675,21.483134999999994,21.12058750000003,20.995833333333334,4004704,7923468,50.05268171595136,0.5325347824833929,1.5,2.75,NaN,NaN,0.790287404076891,0.5054231303767491,560.760364631516,0.02671073380248512,-0.17015606723604293,-0.19686680103852805,62.7690642516584,4.582043343653254,69.23412739934068,7.697560189383428,23.06831241127589,4888673428
1451399400,21.525,21.92,21.5225,21.8075,23.555338235294116,22.483515,22.8675,16.1975,22.8675,16.1975,24.2875,21.5025,23.78275,16.2775,21.768633750000006,20.4200925,21.50943499999999,21.10896250000003,21.10371186978363,21.120011600335907,20.776096153846154,22.123182461663905,19.429009846028404,21.768633750000006,20.4200925,21.50943499999999,21.10896250000003,21.75,4634360,7968784.2,54.570260379822024,3.4615214760196666,1.5,2.75,NaN,NaN,0.7915168752142561,0.5815642491611205,564.3202194560392,0.08744384753128437,-0.08756199162442257,-0.17500583915570694,64.3758159377644,4.894179894179903,65.14408840358806,9.716083820260948,25.139827776151,4893307788
1451485800,21.705,21.73945,21.29,21.345,23.674470588235295,22.4671825,22.8675,16.1975,22.8675,16.1975,24.2875,21.5025,23.78275,16.2775,21.76350875000001,20.4086675,21.52553499999999,21.041962500000032,21.11317414939996,21.141439066970584,20.796096153846158,22.16841759436025,19.423774713332065,21.76350875000001,20.4086675,21.52553499999999,21.041962500000032,21.45815,3856516,7918730.4,51.248370547173394,1.9126142181089238,1.5,2.75,NaN,NaN,0.7719442412703807,0.4870119078684633,559.8620808310075,0.09300606095310235,-0.058748262964329,-0.15175432391743135,64.71817792745252,-1.53384846038519,33.73762343692629,32.94701931231802,33.315357250755696,4889451272
1451572200,21.075,21.3175,20.7025,20.72,23.79360294117647,22.45085,22.8675,16.1975,22.8675,16.1975,24.2875,21.5025,23.78275,16.2775,21.75123375000001,20.382692499999997,21.53088499999999,20.97971250000003,21.097755555305845,21.101302012973385,20.86225,22.126338269800076,19.598161730199923,21.75123375000001,20.382692499999997,21.53088499999999,20.97971250000003,20.91333333333333,5826760,7897685.4,47.07777485226655,0.6681641056205004,1.5,2.75,NaN,NaN,0.762698224036782,0.7377807173732193,556.9427097904018,0.05311429248529104,-0.08536145831081754,-0.13847575079610858,61.83700655264003,0,6.371247404493537,72.19728834394658,21.431464251559888,4883624512
1451917800,19.6625,19.8275,19.097475,19.8125,23.912735294117645,22.4345175,22.8675,16.1975,22.8675,16.1975,24.2875,21.5025,23.78275,16.2775,21.736108750000014,20.3538425,21.525384999999986,20.91808750000003,21.0473533766664,20.978558964118776,20.833403846153846,22.17264673701049,19.494160955297204,21.736108750000014,20.3538425,21.525384999999986,20.91808750000003,19.579158333333336,12571068,8133444.4,41.76325896112567,6.96690113245045,1.5,2.75,NaN,NaN,0.824114422319869,1.5456020084184752,553.708835345524,-0.03132550706485157,-0.17763263462717305,-0.14630712756232148,61.74396581243199,1.40754958413307,2.8736448494357916,81.79548550125268,15.330869649311538,4871053444
1452004200,19.9575,20.089975,19.53775,19.945,24.031867647058824,22.418184999999998,22.8675,16.1975,22.8675,16.1975,24.2875,21.5025,23.78275,16.2775,21.718596250000008,20.3254925,21.502584999999986,20.80221250000003,21.004123832483405,20.880124777059844,20.768403846153845,22.189298466000814,19.347509226306876,21.718596250000008,20.3254925,21.502584999999986,20.80221250000003,19.857575,7654164,8122006,42.778940606875636,4.433906988774677,1.5,2.75,NaN,NaN,0.8046937492970212,0.9423982203411325,556.2867355802603,-0.07281890809858166,-0.23733076268554854,-0.16451185458696688,51.242399358022226,-0.6475716064757111,16.679489176364253,53.4603120250463,29.86019879858945,4878707608
1452090600,19.0425,19.535,18.81,19.1525,24.151,22.4018525,22.8675,16.1975,22.8675,16.1975,24.2875,21.5025,23.78275,16.2775,21.697758750000013,20.290217499999997,21.449784999999984,20.66758750000003,20.93151113317033,20.715589084006528,20.57417307692307,22.128899535483143,19.019446618363,21.697758750000013,20.290217499999997,21.449784999999984,20.66758750000003,19.165833333333335,15461976,8645821,38.45856332865445,7.283201772756851,1.5,2.75,NaN,NaN,0.8282870529186627,1.7883756788395226,551.6444597765535,-0.1440845559154686,-0.34461754948130263,-0.20053299356583404,53.77500038792493,-7.116876818622702,3.314068066378916,80.36654163554212,16.319390298078957,4863245632
1452177000,18.15,18.7625,17.6625,17.785,24.270132352941175,22.38552,22.8675,16.1975,22.8675,16.1975,24.2875,21.5025,23.78275,16.2775,21.67213375000001,20.238742499999997,21.372934999999984,20.489587500000034,20.80811853971267,20.43648536172019,20.34840384615384,22.493265680851085,18.203542011456594,21.67213375000001,20.238742499999997,21.372934999999984,20.489587500000034,18.069999999999997,17905516,9243165.6,32.38141050478039,12.386474044750141,1.5,2.75,NaN,NaN,0.8755522634244723,1.9371627400032734,543.7020998576704,-0.2666417670592288,-0.53383520238987,-0.2671934353306412,62.57077135595186,-16.766116766116763,2.022276689097076,84.8768431417975,13.100880169105425,4845340116
1452263400,18.0775,18.2725,17.1075,17.2,24.389264705882354,22.3691875,22.8675,16.1975,22.8675,16.1975,24.2875,21.5025,23.78275,16.2775,21.64853375000001,20.1777675,21.286834999999982,20.302462500000033,20.666623695018053,20.128248660603983,20.168596153846146,22.87391775806412,17.46327454962817,21.64853375000001,20.1777675,21.286834999999982,20.302462500000033,17.526666666666667,14990948,9522969,30.184066445376274,12.805122240514944,1.5,2.75,NaN,NaN,0.8962271017512957,1.57418847000342,540.442724240813,-0.3643778324286859,-0.7226657258664986,-0.3582878934378127,54.230136115495526,-19.055966681176987,1.590884775575592,86.66736756261948,11.741747661804933,4830349168
1452522600,17.495,17.5975,16.632525,17.21,24.50839705882353,22.352854999999998,22.8675,16.1975,22.8675,16.1975,24.2875,21.5025,23.78275,16.2775,21.62578375000001,20.1188925,21.186234999999982,20.10871250000003,20.531069824625188,19.850320216736936,19.94821153846153,23.081119513282722,16.815303563640335,21.62578375000001,20.1188925,21.186234999999982,20.10871250000003,17.146675,18027412,10144968.6,30.271171526092147,13.174886176254589,1.5,2.75,NaN,NaN,0.9011376659119174,1.7769805615761098,537.1738722621473,-0.40263099768678123,-0.8615766405462892,-0.458945642859508,55.00470538150039,-18.48431024274719,14.13117107552212,57.5531103555692,28.315718568908668,4848376580
1452609000,17.7175,17.905,16.985,17.65,24.627529411764705,22.336522499999997,22.8675,16.1975,22.8675,16.1975,24.2875,21.5025,23.78275,16.2775,21.604583750000007,20.0698925,21.094984999999983,19.99821250000003,20.41808669424773,19.640765910381038,19.71974999999999,23.050310636566476,16.389189363433506,21.604583750000007,20.0698925,21.094984999999983,19.99821250000003,17.513333333333332,17508232,10346024.8,34.163360794602596,9.374216442522489,1.5,2.75,NaN,NaN,0.9024849754896377,1.6922665795272402,535.939883902102,-0.3732368664679624,-0.925491725944461,-0.5522548594764987,60.779513835596,-19.064542015361695,20.94846127516295,47.67388603348358,31.377652691353468,4865884812
1452695400,17.88,17.9975,16.22,16.3525,24.746661764705884,22.32019,22.8675,16.1975,22.8675,16.1975,24.2875,21.5025,23.78275,16.2775,21.57284625000001,20.0221425,20.983934999999985,19.80646250000003,20.25865192192429,19.327597728439986,19.33398076923076,22.960367859082556,15.707593679378961,21.57284625000001,20.0221425,20.983934999999985,19.80646250000003,16.856666666666666,17911312,10700788.2,29.019281937216263,13.05079339192855,1.5,2.75,NaN,NaN,0.9649860486689493,1.6738310921806676,529.3124351529168,-0.41301611785976866,-1.0685250068012095,-0.6555088889414409,59.8801751168899,-23.389552588428206,21.047401358820785,47.54385589938373,31.408742741795496,4847973500
1452781800,16.5375,17.49,16.04,17.115,24.86579411764706,22.3038575,22.8675,16.1975,22.8675,16.1975,24.2875,21.5025,23.78275,16.2775,21.547871250000007,20.0019675,20.872734999999984,19.62271250000003,20.13537145439785,19.116874135255227,19.015961538461532,22.6398383079222,15.392084769000864,21.547871250000007,20.0019675,20.872734999999984,19.62271250000003,16.881666666666664,21744216,11191808.6,35.19480848914776,9.370621662849802,1.5,2.75,NaN,NaN,0.9996299023354529,1.9428688228281532,533.0996316282607,-0.36166087652918555,-1.1075849846029229,-0.7459241080737373,73.62297585995003,-17.398648648648653,51.42832039501009,18.197248833531948,30.37443077145797,4869717716
1452868200,15.75,16.289975,15.43,16.0275,24.984926470588235,22.287525,22.8675,16.1975,22.8675,16.1975,24.2875,21.5025,23.78275,16.2775,21.518533750000007,19.9940425,20.73593499999998,19.34021250000003,19.97427845618617,18.82264802713568,18.624807692307684,22.35522242566378,14.894392958951586,21.518533750000007,19.9940425,20.73593499999998,19.34021250000003,15.915824999999998,22730524,11590822.8,31.04608451316099,13.841759819578362,1.5,2.75,NaN,NaN,1.0485849093114918,1.9610794153457336,526.5104991613371,-0.37311480710838496,-1.2123176169592185,-0.8392028098508335,77.747247625934,-19.104100946372238,45.27623612614446,22.813291052003713,31.910472821851833,4846987192
1453213800,16.6,16.6225,15.63,16.095,25.10405882352941,22.271192499999998,22.8675,16.1975,22.8675,16.1975,24.2875,21.5025,23.78275,16.2775,21.488646250000006,19.9930175,20.604284999999983,19.10896250000003,19.822149889276908,18.562872024551332,18.185384615384603,21.648916520021526,14.72185271074768,21.488646250000006,19.9930175,20.604284999999983,19.10896250000003,16.11583333333333,15717444,11783821.8,31.585154897978242,11.412217424306395,1.5,2.75,NaN,NaN,1.044578844360671,1.3338154859062787,522.4108628916347,-0.3487760700289174,-1.2751728973869803,-0.9263968273580628,78.42005314307089,-19.30308347956882,42.181850522549105,25.51766770448149,32.3004817729694,4862704636
1453300200,15.3225,15.9475,14.29585,15.52,14.29585,22.254859999999997,22.8675,16.1975,22.8675,16.1975,24.2875,21.5025,23.78275,16.2775,21.45354625000001,19.967267500000002,20.462884999999982,18.90808750000003,19.65343812891311,18.273074688879777,17.73730769230768,20.947782412500022,14.52683297211534,21.45354625000001,19.967267500000002,20.462884999999982,18.90808750000003,15.25445,29300688,12663847.2,29.471484302867168,14.54045076569864,1.5,2.75,NaN,NaN,1.0984767840491945,2.3137272218508764,520.6560896521374,-0.34348697688486896,-1.355755548464149,-1.01226857157928,76.78503910997918,-18.966192403080537,14.699207768250712,56.8424784190736,28.458313812675684,4833403948
1453386600,15.6425,16.275,15.2275,15.71,14.160858139534884,22.2385275,22.8675,16.1975,22.8675,16.1975,24.2875,21.5025,23.78275,16.2775,21.420308750000007,19.930242500000002,20.32593499999998,18.689837500000028,19.498793496406712,18.028972337557892,17.351923076923068,20.22251545337013,14.481330700476008,21.420308750000007,19.930242500000002,20.32593499999998,18.689837500000028,15.737499999999999,19535064,13244382.6,31.1119554313115,9.651966675473842,1.5,2.75,NaN,NaN,1.0948355851885376,1.4749697732229512,524.4334772039274,-0.30081170538792934,-1.3882832033141916,-1.0874714979262623,78.82775454655979,-11.667135226314306,34.47819349298255,32.54341293083643,32.97839357618102,4852939012
1453473000,16.515,16.755025,16.29,16.68,14.025866279069767,22.222195,22.8675,16.1975,22.8675,16.1975,24.2875,21.5025,23.78275,16.2775,21.39078375000001,19.902892500000004,20.221084999999977,18.49283750000003,19.388252574979,17.900498781599996,17.11096153846153,19.617765002929268,14.604158073993792,21.39078375000001,19.902892500000004,20.221084999999977,18.49283750000003,16.575008333333333,13151700,13557855.6,38.922605264237674,3.578182129983138,1.5,2.75,NaN,NaN,1.0912776862464992,0.9700427846421377,533.2687757274635,-0.18647722133713707,-1.3205680245976836,-1.1340908032605466,82.48505491539376,-3.023255813953486,28.617774908212503,38.642436026218725,32.739789065568765,4866090712
1453732200,16.5525,16.6,15.88,15.9225,13.890874418604652,22.2058625,22.8675,16.1975,22.8675,16.1975,24.2875,21.5025,23.78275,16.2775,21.35589625000001,19.872892500000003,20.09828499999998,18.22058750000003,19.25234070929355,17.712117945257138,16.801538461538453,18.76733986247625,14.835737060600659,21.35589625000001,19.872892500000003,20.09828499999998,18.22058750000003,16.13416666666667,10864040,13811575.4,35.534270575477265,5.396162670991584,1.5,2.75,NaN,NaN,1.0704721372288921,0.7865894863811118,526.9295971383098,-0.14304172864707576,-1.3128929640693912,-1.1698512354223154,84.36060452157695,-7.481115630447422,39.92308299150136,27.169981309021363,32.90693569947727,4855226672
1453818600,16.125,16.665,16.05,16.5725,13.755882558139534,22.189529999999998,22.8675,16.1975,22.8675,16.1975,24.2875,21.5025,23.78275,16.2775,21.32250875000001,19.8662925,19.99373499999998,17.986750000000026,19.147248916772234,17.603582902851695,16.603076923076916,18.025169305997988,15.180984540155846,21.32250875000001,19.8662925,19.99373499999998,17.986750000000026,16.42916666666667,8575352,14098599.8,40.33410199585271,3.041663117526997,1.5,2.75,NaN,NaN,1.047045555998257,0.6082413942978933,533.1730552530703,-0.056171927643452024,-1.2400661449766304,-1.1838942173331783,88.69227880276377,-6.104815864022647,34.64999889960686,32.05241613281262,33.29758496758054,4863802024
1453905000,16.425,16.9425,15.772525,16.0325,13.620890697674419,22.173197499999997,22.8675,15.52,22.8675,16.1975,24.2875,21.5025,23.78275,16.2775,21.28799625000001,19.8445925,19.89603499999998,17.732750000000024,19.025101900428226,17.45395595972296,16.468269230769224,17.741060507112714,15.195477954425732,21.28799625000001,19.8445925,19.89603499999998,17.732750000000024,16.249174999999997,12104616,14503595.4,37.81510591934471,3.864697587415949,1.5,2.75,NaN,NaN,1.0558262305698098,0.8345941586318658,530.2924964448493,-0.02244719492293057,-1.2119532109868416,-1.189506016063911,88.02861475753237,-1.9568873260969288,53.243097035471905,16.839387027200335,29.917515937327778,4851697408
1453991400,16.525,16.575,15.8,16.2925,13.485898837209302,22.156865,22.8675,15.52,22.8675,16.1975,24.2875,21.5025,23.78275,16.2775,21.25414625000001,19.825267500000002,19.81768499999998,17.457000000000026,18.917941041587902,17.343341106416013,16.39846153846153,17.600652708561963,15.196270368361093,21.25414625000001,19.825267500000002,19.81768499999998,17.457000000000026,16.2225,9376928,14740723.8,39.765684060073056,3.12361908421341,1.5,2.75,NaN,NaN,1.0357672141005376,0.636123987344502,534.8992547652111,0.02730462512407872,-1.1553752346588126,-1.1826798597828914,77.79609193557148,-4.805725971370132,44.15869985803457,23.591957583833537,32.249342558131886,4861074336
1454077800,16.515,17.4875,16.4875,17.4725,13.350906976744186,22.1405325,22.8675,15.52,22.8675,16.1975,24.2875,21.5025,23.78275,16.2775,21.224571250000007,19.825817500000003,19.744534999999978,17.263375000000025,18.86125707917269,17.355641953424012,16.418653846153838,17.6819547960232,15.155352896284478,21.224571250000007,19.825817500000003,19.744534999999978,17.263375000000025,17.14916666666667,10499852,15072890.6,47.77267887144942,2.5915774927714854,1.5,2.75,NaN,NaN,1.047140984521928,0.696605069236023,543.1921088319018,0.1431438583416429,-1.0037500368558376,-1.1468938951974805,84.0451878464001,9.01575417251599,41.62130598841696,25.70043890941193,32.67825510217111,4871574188
1454337000,17.155,17.715,16.975,17.48,13.215915116279069,22.1242,22.8675,15.52,22.8675,16.1975,24.2875,21.5025,23.78275,16.2775,21.195221250000003,19.813092500000003,19.67293499999998,17.101375000000026,18.80709013489141,17.36748557690744,16.405576923076914,17.620204364922852,15.190949481230977,21.195221250000003,19.813092500000003,19.67293499999998,17.101375000000026,17.39,10630464,15313075.8,47.82015685582732,3.2380956728357684,1.5,2.75,NaN,NaN,1.0252023427703616,0.6942082791753699,542.1570104928883,0.21918045315363588,-0.8729183287554356,-1.0920987819090715,72.32897863600014,8.605156881018962,73.20796110140193,5.946643574696834,20.845395323901226,4882204652
1454423400,16.995,17.0069,16.3575,16.5255,13.080923255813953,22.107867499999998,22.8675,15.52,22.8675,16.1975,24.2875,21.5025,23.78275,16.2775,21.165111250000006,19.7986475,19.562194999999978,16.937025000000027,18.717616011954494,17.287296474344828,16.418884615384606,17.634684646630014,15.2030845841392,21.165111250000006,19.7986475,19.562194999999978,16.937025000000027,16.629966666666668,12135564,15291300.6,42.52218715526894,2.021218703478932,1.5,2.75,NaN,NaN,1.0321521754296215,0.7936253636920851,536.6027328620887,0.20439141219272505,-0.8366095166681653,-1.0410009288608904,81.39525067575022,6.478737113402071,43.85568904815687,23.83997168828756,32.30433926355556,4870069088
1454509800,16.8575,16.93,15.7275,16.7925,12.945931395348836,22.091534999999997,22.8675,15.52,22.8675,16.1975,24.2875,21.5025,23.78275,16.2775,21.133311250000002,19.7839725,19.45799499999998,16.779400000000027,18.64212126638765,17.2401730005977,16.394076923076913,17.564358010032183,15.223795836121642,21.133311250000002,19.7839725,19.45799499999998,16.779400000000027,16.483333333333334,27986200,16307902.4,44.378541416355766,2.244054891260923,1.5,2.75,NaN,NaN,1.0443198771846485,1.7161127969468348,539.3967356560929,0.21093731525998682,-0.7773292847859068,-0.9882666000458936,77.68310416062877,6.890515595162314,80.91352826317026,3.1461684428088224,15.940303294020913,4898055288
1454596200,16.66,17.195,16.465,16.88,12.81093953488372,22.0752025,22.8675,15.52,22.8675,16.1975,24.2875,21.5025,23.78275,16.2775,21.10232375,19.767697500000004,19.35009499999998,16.66577500000003,18.57301847162735,17.205870810064585,16.459653846153834,17.63594543641768,15.28336225588999,21.10232375,19.767697500000004,19.35009499999998,16.66577500000003,16.846666666666664,12856420,16177624.6,45.00538939773287,0.5331948632303142,1.5,2.75,NaN,NaN,1.021868457385745,0.7947038157876405,542.6517220936777,0.21857636139719738,-0.7150461482993968,-0.9336225096965942,77.64540333244501,1.1990407673860868,82.0129782673145,2.8128064445728644,15.174215288112642,4910911708
1454682600,16.745,16.7475,15.7275,15.9225,12.675947674418603,22.05887,22.8675,15.52,22.8675,16.1975,24.2875,21.5025,23.78275,16.2775,21.064786249999997,19.744022500000003,19.22534499999998,16.572650000000028,18.46907657077922,17.083645018629863,16.446384615384606,17.642554667216455,15.250214563552756,21.064786249999997,19.744022500000003,19.22534499999998,16.572650000000028,16.132499999999997,13445788,15954638.2,39.72893494147505,5.108558200311179,1.5,2.75,NaN,NaN,1.0311992818581919,0.8427510440192871,537.9145102058064,0.15931247858097797,-0.7344819114703718,-0.8937943900513498,77.92820073446352,0,59.60646459193549,12.798796960809643,27.594738447254866,4897465920
1454941800,15.37,15.44565,14.6175,15.28,12.540955813953488,22.042537499999998,22.8675,15.52,22.8675,16.1975,24.2875,21.5025,23.78275,16.2775,21.023261249999997,19.706772500000003,19.085744999999978,16.476650000000028,18.34401474447415,16.911869302569876,16.427923076923065,17.68649466323424,15.169351490611891,21.023261249999997,19.706772500000003,19.085744999999978,16.476650000000028,15.114383333333334,17973032,16103742.4,36.62591091916257,9.935676153314429,1.5,2.75,NaN,NaN,1.0507564760111783,1.1160779621015298,530.8676744097315,0.08096130542629298,-0.7925927582684835,-0.8735540636947765,76.94476939885685,-7.799064715643398,33.59970337749461,33.07187627498278,33.3284203475226,4879492888
1455028200,14.755,15.654975,14.734,15.26,12.40596395348837,22.026204999999997,22.8675,15.52,22.8675,16.1975,24.2875,21.5025,23.78275,16.2775,20.980761249999997,19.6644475,18.94599499999998,16.379150000000028,18.22307298978889,16.75454841661084,16.39330769230768,17.74989410615121,15.036721278464148,20.980761249999997,19.6644475,18.94599499999998,16.379150000000028,15.216325,15032316,15953987.6,36.530263651343695,7.3730450239143135,1.5,2.75,NaN,NaN,1.0414863705818085,0.9422293897232313,525.625797577215,0.034295854970307404,-0.8306842449818923,-0.8649800999521997,71.76505727611413,-4.818337751442377,32.23889826847889,34.44414155573355,33.31696017578755,4864460572
1455114600,15.5175,15.9925,15.2025,15.2375,12.270972093023255,22.009872499999997,22.8675,15.52,22.8675,16.1975,24.2875,21.5025,23.78275,16.2775,20.939698749999998,19.6232975,18.80419499999998,16.258525000000027,18.105991696071676,16.610067615028857,16.28234615384614,17.75775469620446,14.80693761148782,20.939698749999998,19.6232975,18.80419499999998,16.258525000000027,15.477500000000001,13284256,15742788.8,36.41505044692433,4.928186659632701,1.5,2.75,NaN,NaN,1.0235230583973935,0.8438311768496825,527.3552220742397,0.00969897032095246,-0.8528563870510091,-0.8625553573719615,70.03248740258621,-6.4753721037287075,4.38868188402035,77.20725560342242,18.404062512557218,4851176316
1455201000,14.495,14.94,14.215,14.68,14.215,21.99354,22.8675,15.52,22.8675,16.1975,24.2875,21.5025,23.78275,16.2775,20.89477375,19.5862225,18.65699499999998,16.17490000000003,17.971639080539454,16.426251651692777,16.18676923076922,17.886902104100667,14.486636357437769,20.89477375,19.5862225,18.65699499999998,16.17490000000003,14.611666666666665,22599996,15977223,33.58831776984749,9.245619957280374,1.5,2.75,NaN,NaN,1.0234499827975798,1.414513398229467,521.0109333040149,-0.03394091153993928,-0.9049814967968857,-0.8710405852569464,70.8177402621627,-15.982257833738736,0,100,0,4828576320
1455287400,15.1625,15.5575,14.90825,15.5525,14.209946875,21.9772075,22.8675,15.52,22.8675,16.1975,24.2875,21.5025,23.78275,16.2775,20.855611249999995,19.554997500000002,18.51434499999998,16.09677500000003,17.876770881302612,16.343037208674417,16.10830769230768,17.82406693391121,14.392548450704147,20.855611249999995,19.554997500000002,18.51434499999998,16.09677500000003,15.339416666666667,11355360,15457780.2,41.271763540871945,3.665120804377684,1.5,2.75,NaN,NaN,1.0130249840263241,0.7346048302588751,527.5523932079216,0.004107717051971771,-0.8659059389419816,-0.8700136559939534,65.94771630911535,-11.026887871853548,2.4628885204969064,83.22308325803793,14.314028221465176,4839931680
1455633000,16.095,16.335,15.7975,16.325,14.20489375,21.960874999999998,22.8675,15.52,22.8675,16.1975,24.2875,21.5025,23.78275,16.2775,20.823786249999998,19.5385975,18.40154499999998,16.11165000000003,17.81591712125153,16.341319379276854,16.13080769230768,17.84966905685473,14.411946327760631,20.823786249999998,19.5385975,18.40154499999998,16.11165000000003,16.1525,8840236,14763265.8,47.1066251872461,1.7491144339438218,1.5,2.75,NaN,NaN,0.9965589137387295,0.5987994878477362,534.2871643886776,0.08497142074326747,-0.763799380064869,-0.8487708008081365,74.36931065738175,-1.2132764515445926,11.531512764828003,61.80257334455405,26.66591389061794,4848771916
1455719400,16.675,17.2475,16.6547,17.1275,14.199840625,21.944542499999997,22.8675,15.52,22.8675,16.1975,24.2875,21.5025,23.78275,16.2775,20.792461249999995,19.531197500000005,18.323194999999984,16.163275000000027,17.78892037139853,16.41619372410763,16.19503846153845,17.993815202358057,14.39626172071884,20.792461249999995,19.531197500000005,18.323194999999984,16.163275000000027,17.0099,12123712,14583579.2,52.39768765582645,5.800233675963141,1.5,2.75,NaN,NaN,0.9912689913288203,0.8313262357432804,538.771460419393,0.19015263793128567,-0.6110800033940293,-0.801232641325315,73.10449785766748,1.994938216465689,33.908335578639644,32.78653895350965,33.30512546785073,4860895628
1455805800,17.2175,17.2375,16.82,16.9125,14.1947875,21.928209999999996,22.8675,15.52,22.8675,16.1975,24.2875,21.5025,23.78275,16.2775,20.758936249999998,19.523322500000003,18.21619499999998,16.23290000000003,17.754550945069173,16.46346098847833,16.151961538461528,17.850323892728287,14.453599184194767,20.758936249999998,19.523322500000003,18.21619499999998,16.23290000000003,16.990000000000002,7638156,13500452.6,50.92783129479995,4.402088967959661,1.5,2.75,NaN,NaN,0.9502854919481903,0.5657703653579733,539.8757756801414,0.23969395900157175,-0.5016151925733503,-0.741309151574922,73.16848972526904,0.192535545023711,38.948322341436146,28.04115609138776,33.010521567176106,4853257472
1455892200,16.6775,16.94,16.485,16.91,14.189734375,21.9118775,22.8675,14.68,22.8675,16.1975,24.2875,21.5025,23.78275,16.2775,20.729548749999996,19.516022500000002,18.11749499999998,16.29290000000003,17.7214313001645,16.50598851338516,16.108115384615374,17.69269070524408,14.523540063986669,20.729548749999996,19.516022500000002,18.11749499999998,16.29290000000003,16.778333333333332,8191556,12933277.2,50.90994783023066,3.0071561444815784,1.5,2.75,NaN,NaN,0.914907956809034,0.6333704809172419,539.1243065308392,0.26477917573910004,-0.410335181901047,-0.675114357640147,73.11301350469925,6.201915528340403,57.63531453989731,13.995443952182196,28.369241507920513,4845065916
1456151400,17.3925,17.674975,17.37,17.6175,14.18468125,21.895545,22.8675,14.68,22.8675,16.1975,24.2875,21.5025,23.78275,16.2775,20.70501125,19.529197500000002,18.04294499999998,16.33977500000003,17.717355562903148,16.61184675020562,16.192115384615374,17.961309949462333,14.422920819768413,20.70501125,19.529197500000002,18.04294499999998,16.33977500000003,17.554158333333334,6660504,12608717.4,55.65570339196224,5.908739775255399,1.5,2.75,NaN,NaN,0.9041984598941031,0.5282459578323169,543.4409410223539,0.3179278275713099,-0.2777045731760097,-0.5956324007473196,65.88331350081417,15.29777486910995,52.498575397842814,17.335881235681306,30.165543366475887,4851726420
1456237800,17.4125,17.5025,16.93,16.9875,14.179628125,21.879212499999998,22.8675,14.68,22.8675,16.1975,24.2875,21.5025,23.78275,16.2775,20.676036249999996,19.535622500000002,17.963844999999978,16.39302500000003,17.688733776122632,16.647623250186037,16.207115384615374,17.999570561776068,14.414660207454679,20.676036249999996,19.535622500000002,17.963844999999978,16.39302500000003,17.14,9436964,12537363.6,50.93380356571183,3.2421406082509625,1.5,2.75,NaN,NaN,0.8887199984730957,0.7527072119053801,539.623411793682,0.29979920950340755,-0.22088338886806014,-0.5206825983714677,64.57026557418051,11.32044560943644,24.468172105887582,43.07110419896549,32.46072369514692,4842289456
1456324200,16.495,17.28175,16.1675,17.1925,14.174575,21.862879999999997,22.8675,14.68,22.8675,16.1975,24.2875,21.5025,23.78275,16.2775,20.64363625,19.534872500000002,17.885994999999976,16.424025000000032,17.66927362803939,16.699516273977842,16.231153846153838,18.066918846390706,14.395388845916967,20.64363625,19.534872500000002,17.885994999999976,16.424025000000032,16.880583333333334,12216072,12719399.6,52.350457663594035,2.1702168572330858,1.5,2.75,NaN,NaN,0.9048292842964459,0.9604283522942388,542.684585835917,0.29055015789368416,-0.15749490100436248,-0.44804505889804663,64.12379465186825,12.830188679245271,24.68005556926137,42.815757095772845,32.50418733496576,4854505528
1456410600,17.3375,17.815,17.0925,17.8075,14.169521875,21.846547499999996,22.8675,14.68,22.8675,16.1975,24.2875,21.5025,23.78275,16.2775,20.61599875,19.538872500000004,17.844944999999978,16.512775000000033,17.67469427007706,16.805038533599,16.376153846153837,18.3814455143548,14.370862177952871,20.61599875,19.538872500000004,17.844944999999978,16.512775000000033,17.57166666666667,8596104,12543974,56.41596545101371,4.35420404028297,1.5,2.75,NaN,NaN,0.8918057639895569,0.6852775683367966,546.8972851419485,0.3128545166660222,-0.056976913065518886,-0.3698314297315411,64.7627721674906,21.304495912806548,49.52501426937883,19.445034402288247,31.029951328332913,4863101632
1456497000,18.125,18.13,17.64,17.6975,14.16446875,21.830215,22.8675,14.68,22.8675,16.1975,24.2875,21.5025,23.78275,16.2775,20.588911250000002,19.5342975,17.795144999999977,16.58302500000003,17.67558861242698,16.890034863732428,16.562115384615375,18.574670062471593,14.549560706759156,20.588911250000002,19.5342975,17.795144999999977,16.58302500000003,17.8225,11119992,12631127.2,55.503784677748136,4.873262729430548,1.5,2.75,NaN,NaN,0.863105352276017,0.8803641847577943,550.05748167148,0.30678584543639187,0.013650877063948741,-0.2931349683724431,57.552508359925135,13.791994856132463,43.30051518077057,24.278693096898525,32.4207917223309,4851981640
1456756200,17.705,18,17.2225,17.2225,14.159415625,21.8138825,22.8675,14.68,22.8675,16.1975,24.2875,21.5025,23.78275,16.2775,20.55931125,19.515172500000002,17.723794999999978,16.570525000000032,17.657820431547492,16.921698210043626,16.713076923076912,18.602974309227154,14.82317953692667,20.55931125,19.515172500000002,17.723794999999978,16.570525000000032,17.481666666666666,8311628,12521716,51.622266987267594,2.9586946384698742,1.5,2.75,NaN,NaN,0.8569906842563014,0.6637770733659828,551.4857673571886,0.2592589641607342,0.03093873682847459,-0.2283202273322596,57.11031193846991,5.497702909647785,23.472665362167266,44.28624566361935,32.24108897421338,4843670012
1456842600,17.6675,18.515,17.52,18.505,14.1543625,21.797549999999998,22.8675,14.68,22.8675,16.1975,24.2875,21.5025,23.78275,16.2775,20.532561250000004,19.510772500000005,17.660344999999978,16.62177500000003,17.6910431597221,17.072488856706137,16.964423076923065,18.871531393243224,15.057314760602905,20.532561250000004,19.510772500000005,17.660344999999978,16.62177500000003,18.179999999999996,10162132,12498299.4,59.79719246727973,6.360629196301018,1.5,2.75,NaN,NaN,0.8880984925237084,0.8130811780681138,556.7226230487507,0.29980695819566694,0.14643847041232405,-0.15336848778334286,63.97697990443149,8.04262151510727,50.17410564978789,18.972765789921322,30.853128560290777,4853832144
1456929000,18.4,18.759975,18.252525,18.7425,14.149309375,21.781217499999997,22.8675,14.68,22.8675,16.1975,24.2875,21.5025,23.78275,16.2775,20.506598750000002,19.504072500000007,17.620794999999976,16.73262500000003,17.732276761301623,17.23153753701984,17.276923076923065,18.89355675152898,15.66028940231715,20.506598750000002,19.504072500000007,17.620794999999976,16.73262500000003,18.585,7800100,12281526.2,61.10785565459611,6.204507486314315,1.5,2.75,NaN,NaN,0.8609093144863008,0.6351083629980776,560.1903312256306,0.32606020553980375,0.2542067691414118,-0.07185343639839191,59.90803995935126,10.82039911308203,45.88936549905465,22.196103652104043,31.91453084884131,4861632244
1457015400,18.6825,18.9625,18.4925,18.955,14.14425625,21.764884999999996,22.8675,14.68,22.8675,16.1975,24.2875,21.5025,23.78275,16.2775,20.480573750000005,19.494197500000006,17.609144999999977,16.84075000000003,17.780226692230972,17.395676819208425,17.53865384615383,19.05224943204629,16.025058260261375,20.480573750000005,19.494197500000006,17.609144999999977,16.84075000000003,18.80333333333333,6951604,11229796.4,62.29237961185918,6.319093553994787,1.5,2.75,NaN,NaN,0.8329872205944221,0.619032060100395,564.513681549707,0.3396389452271335,0.35269524513552497,0.01305629990839148,58.30099716441049,12.093435836782959,44.32239946425825,23.44343988147972,32.23416065426204,4868583848
1457101800,19.025,19.404575,18.7425,19.145,14.139203125,21.7485525,22.8675,14.68,22.8675,16.1975,24.2875,21.5025,23.78275,16.2775,20.455686250000007,19.485972500000006,17.590544999999974,16.95400000000003,17.833747214104267,17.56227902690286,17.755576923076912,19.31874204778402,16.192411798369804,20.455686250000007,19.485972500000006,17.590544999999974,16.95400000000003,19.097358333333332,9289744,11051462.6,63.36670849465485,6.718768971085797,1.5,2.75,NaN,NaN,0.8207792048376777,0.840589552372914,568.0502112404521,0.34235172579501283,0.44099595715215756,0.0986442313571447,57.85606949699833,8.670356179934725,78.69163443689058,3.866198734102643,17.442166829006776,4877873592
1457361000,18.8275,19.325,18.8125,19.1825,14.13415,21.732219999999998,22.8675,14.68,22.8675,16.1975,24.2875,21.5025,23.78275,16.2775,20.431236250000005,19.477347500000004,17.561794999999975,17.117000000000026,17.886639480217827,17.716585786245446,17.913653846153835,19.601447826682872,16.2258598656248,20.431236250000005,19.477347500000004,17.561794999999975,17.117000000000026,19.10666666666667,7954020,10776874.2,63.58721649683501,5.501692553514027,1.5,2.75,NaN,NaN,0.7987592616349863,0.7380637328029681,570.4547523987229,0.3275992426894934,0.5081432847190115,0.18054404202951807,55.0783125723946,12.921265636497425,100,0,0,4885827612
1457447400,18.82,18.9975,18.5075,18.545,14.129096875,21.715887499999997,22.8675,14.68,22.8675,16.1975,24.2875,21.5025,23.78275,16.2775,20.402523750000007,19.466422500000004,17.505344999999974,17.28025000000003,17.91245753981713,17.795482378031593,18.03923076923076,19.65162433711407,16.426837201347446,20.402523750000007,19.466422500000004,17.505344999999974,17.28025000000003,18.683333333333334,8099420,10283193.6,57.27545518839084,3.1576333344924676,1.5,2.75,NaN,NaN,0.7899193143753446,0.7876366345956961,565.8886473770997,0.25884963219605683,0.5041060822745891,0.24525645007853228,54.31437973154508,7.866802384760814,77.44771591802585,4.318568104811875,18.23371597716229,4877728192
1457533800,18.8325,18.945,18.57,18.835,14.12404375,21.699554999999997,22.8675,14.68,22.8675,16.1975,24.2875,21.5025,23.78275,16.2775,20.376161250000006,19.461272500000003,17.457059999999977,17.459000000000028,17.948635675510577,17.894484056314298,18.18730769230768,19.708686699274793,16.665928685340567,20.376161250000006,19.461272500000003,17.457059999999977,17.459000000000028,18.783333333333335,6207044,9841930,59.25670567348694,3.0069133327243356,1.5,2.75,NaN,NaN,0.7620679347771055,0.6306734553080544,569.6445950414239,0.21846054905869594,0.5183321364019022,0.2998715873432063,54.42802517500218,5.770040713182647,76.40115773498296,4.701956099519731,18.896886165497286,4883935236
1457620200,19.0075,19.31,18.2675,18.875,14.118990625,21.683222499999996,22.8675,14.68,22.8675,16.1975,24.2875,21.5025,23.78275,16.2775,20.353711250000007,19.447722500000005,17.412309999999977,17.64087500000003,17.984963688235652,17.987866527141506,18.28403846153845,19.80810505919186,16.759971863885042,20.353711250000007,19.447722500000005,17.412309999999977,17.64087500000003,18.8175,14479324,9901683.4,59.535435528325614,2.6529566482082036,1.5,2.75,NaN,NaN,0.7820987965787409,1.4623093281289927,567.4980916905032,0.18151222577551085,0.5267618695625949,0.345249643787084,51.89740901337227,6.653482130244376,80.74250358316098,3.2089724821948047,16.04852393464422,4898414560
1457706600,19.3625,19.8025,19.33,19.7775,14.1139375,21.66689,22.8675,14.68,22.8675,16.1975,24.2875,21.5025,23.78275,16.2775,20.332648750000008,19.440572500000002,17.37170999999998,17.895750000000028,18.05525922987347,18.158307810270887,18.498653846153836,20.017729495488776,16.979578196818895,20.332648750000008,19.440572500000002,17.37170999999998,17.895750000000028,19.636666666666667,10012144,9272290.8,65.3029854033258,5.889998308630064,1.5,2.75,NaN,NaN,0.7924845968231164,1.079791846045208,568.3017292539192,0.20328642823508647,0.5993576790809421,0.3960712508458556,56.11229247931869,14.835244592829147,81.23733076570241,3.055276784248888,15.70739245004869,4908426704
1457962200,19.6025,19.8725,19.4875,19.705,14.108884375,21.650557499999998,22.8675,14.68,22.8675,16.1975,24.2875,21.5025,23.78275,16.2775,20.31151125000001,19.4322225,17.338909999999977,18.103375000000025,18.119954946349022,18.305611828340325,18.691923076923064,20.13449710361466,17.24934905023147,20.31151125000001,19.4322225,17.338909999999977,18.103375000000025,19.688333333333333,5593972,8984221.4,64.50755434441865,5.487625254641121,1.5,2.75,NaN,NaN,0.7633785541928937,0.6226440501566446,566.4547817849124,0.19803977939997253,0.6436209750958213,0.44558119569584875,51.69347127635292,6.484733855714668,60.913553997272686,12.02380835239485,27.06263765033247,4902832732
1458048600,19.3675,19.625,19.2925,19.6225,14.10383125,21.634224999999997,22.8675,14.68,22.8675,16.1975,24.2875,21.5025,23.78275,16.2775,20.292298750000008,19.4239225,17.316959999999977,18.268250000000027,18.178878281786314,18.43102974945077,18.83153846153845,20.255906794494848,17.407170128582052,20.292298750000008,19.4239225,17.316959999999977,18.268250000000027,19.513333333333335,5677856,8826102.4,63.55881712147538,3.6386386626255596,1.5,2.75,NaN,NaN,0.7383158003219725,0.6433027561520247,562.1257240651839,0.17504247310108018,0.664384287072199,0.4893418139711188,36.497048912266365,4.695211417900488,65.7429252305971,9.399247023143351,24.857827746259552,4897154876
1458135000,19.455,20.095,19.4325,19.9575,14.098778125,21.617892499999996,22.8675,14.68,22.8675,16.1975,24.2875,21.5025,23.78275,16.2775,20.274073750000007,19.4226225,17.319859999999977,18.409750000000024,18.248628153088813,18.576407868550696,19.005384615384603,20.384630292939278,17.62613893782993,20.274073750000007,19.4226225,17.319859999999977,18.409750000000024,19.828333333333333,7802212,8610027.4,65.76089802390163,4.534296949682058,1.5,2.75,NaN,NaN,0.7329003860132601,0.9061773717468077,567.7525363909286,0.16836987282893334,0.6998041550072855,0.5314342821783522,36.86136535632951,5.2888419941967895,67.54339059971684,8.498450661280039,23.958158739003107,4904957088
1458221400,19.9175,20.51,19.7875,20.3275,14.093725,21.601559999999996,22.8675,14.68,22.8675,16.1975,24.2875,21.5025,23.78275,16.2775,20.258111250000006,19.4150475,17.327509999999975,18.580500000000022,18.330152539242192,18.743178547736346,19.244230769230754,20.355048874910224,18.133412663551283,20.258111250000006,19.4150475,17.327509999999975,18.580500000000022,20.208333333333332,7389060,8597572.6,68.0568369116008,5.928158790313754,1.5,2.75,NaN,NaN,0.7321575012980273,0.859435603951748,572.601538402974,0.174128940000168,0.7490954571785622,0.5749665171783942,37.432091501884464,6.1765474014102955,61.11898905008693,11.905955707719793,26.97505524219328,4912346148
1458307800,20.5475,20.69,20.40065,20.5625,14.088671875,21.5852275,22.8675,14.68,22.8675,14.68,24.2875,16.1975,23.78275,21.5025,20.242286250000006,19.4027475,17.355709999999974,18.763125000000024,18.41769557691897,18.916447257475742,19.40249999999999,20.627365769725863,18.177634230274116,20.242286250000006,19.4027475,17.355709999999974,18.763125000000024,20.55105,6504232,8513206.4,69.4576840447498,5.798359658529819,1.5,2.75,NaN,NaN,0.705753394062454,0.7640167164277845,576.2658022128398,0.17836577597366698,0.7979237371454779,0.619557961171811,37.48642775289723,7.1940570832790245,56.760464709345996,14.525951645287936,28.713583645366075,4918850380
1458567000,20.4975,20.7375,20.395,20.665,14.08361875,21.568894999999998,22.8675,14.68,22.8675,14.68,24.2875,16.1975,23.78275,21.5025,20.229761250000006,19.3931225,17.413309999999974,18.915500000000023,18.505825162137832,19.082976090097098,19.550384615384605,20.880504399108332,18.220264831660877,20.229761250000006,19.3931225,17.413309999999974,18.915500000000023,20.599166666666665,4593716,8409867,70.07413735861755,5.307861615910148,1.5,2.75,NaN,NaN,0.6798067230579931,0.5462293280024524,575.982328858083,0.1725640328412027,0.8352630022233143,0.6626989693821116,37.37383259901491,11.431652736586667,81.15317453188149,3.096257038620909,15.750568429497605,4923444096
1458653400,20.39,20.825,20.33,20.6275,14.078565625,21.552562499999997,22.8675,14.68,22.8675,14.68,24.2875,16.1975,23.78275,21.5025,20.21794875000001,19.3843475,17.481859999999973,19.09750000000002,18.589028096955957,19.230073605325945,19.67903846153845,21.075790929093564,18.282285993983336,20.21794875000001,19.3843475,17.481859999999973,19.09750000000002,20.594166666666666,5630772,8219557.4,69.52128634403752,4.65265117239879,1.5,2.75,NaN,NaN,0.666606242839565,0.6850456449151386,574.4668410499158,0.1514466584952101,0.8520072925011242,0.7005606340059141,27.7475632012687,9.51685691531723,80.39890339287102,3.3337518668108554,16.26734474031813,4917813324
1458739800,20.5075,20.5525,20.1575,20.23,14.0735125,21.536229999999996,22.8675,14.68,22.8675,14.68,24.2875,16.1975,23.78275,21.5025,20.206223750000007,19.364247499999998,17.542259999999974,19.249375000000022,18.653379936291017,19.325304690533,19.762499999999992,21.15127782461912,18.373722175380863,20.206223750000007,19.364247499999998,17.542259999999974,19.249375000000022,20.313333333333333,5944312,7905969.4,63.777377285414765,2.6007523554190284,1.5,2.75,NaN,NaN,0.6525629397795962,0.7518764239082433,569.9202782958441,0.09851721433210492,0.8237071519210453,0.7251899375889403,32.36235597849251,7.1788079470198705,52.000713532550826,17.78333673339903,30.21594973405014,4911869012
1458826200,19.85,20.2,19.77,20.2,14.068459375,21.519897499999995,22.8675,14.68,22.8675,14.68,24.2875,16.1975,23.78275,21.5025,20.19451125000001,19.344122499999997,17.593259999999976,19.36900000000002,18.71403170349529,19.408609005720333,19.840769230769222,21.20443564697025,18.477102814568195,20.19451125000001,19.344122499999997,17.593259999999976,19.36900000000002,20.05666666666667,5726100,7762469.2,63.35195660914165,1.2631062299113656,1.5,2.75,NaN,NaN,0.6388084440810538,0.7376647626505236,569.3989922607014,0.0516516808281805,0.789754538624166,0.7381028577959855,32.63149500213719,2.136265958791553,22.143651843880924,46.107097149354175,31.749251006764908,4906142912
1459171800,20.335,20.4,20.0625,20.2243,14.06340625,21.503565,22.8675,14.68,22.8675,14.68,24.2875,16.1975,23.78275,21.5025,20.178782750000007,19.3273155,17.670695999999975,19.49534000000002,18.77325791120136,19.486293862318398,19.969946153846145,21.11950204833593,18.82039025935636,20.178782750000007,19.3273155,17.670695999999975,19.49534000000002,20.228933333333334,3621708,7387555,63.56396485484018,1.8305405572175435,1.5,2.75,NaN,NaN,0.6172864123609784,0.4902444719531699,571.5043882585347,0.014391232272482624,0.7560918981365887,0.7417006658641061,20.466532517589346,2.635371733062681,13.137058864322317,59.023482189712205,27.839458945965468,4909764620
1459258200,20.075,20.81,19.9675,20.8,14.058353125,21.487232499999998,22.8675,14.68,22.8675,14.68,24.2875,16.1975,23.78275,21.5025,20.164832750000006,19.3085655,17.744395999999973,19.67421500000002,18.85273799311503,19.61140873257379,20.121099999999995,21.14371734478061,19.098482655219378,20.164832750000006,19.3085655,17.744395999999973,19.67421500000002,20.525833333333335,5518064,7247876.8,68.25013903174911,3.2257036951420197,1.5,2.75,NaN,NaN,0.6333730971923368,0.7613352368241139,575.2892532828166,0.02026057846384699,0.7670263889439148,0.7467658104800678,24.758325862356454,6.0007644285896395,15.408474648304614,55.38524932690937,29.206276024786003,4915282684
1459344600,21.1325,21.305,20.925,21.0725,14.0533,21.470899999999997,22.8675,14.68,22.8675,14.68,24.2875,16.1975,23.78275,21.5025,20.15490775000001,19.290615499999998,17.845295999999973,19.80259000000002,18.93978748358111,19.750560281852476,20.290138461538454,21.145818126756378,19.43445879632053,20.15490775000001,19.290615499999998,17.845295999999973,19.80259000000002,21.100833333333338,5030464,6991293.4,70.20360562466875,4.380065008265351,1.5,2.75,NaN,NaN,0.624203590250027,0.7195326690194406,577.8411930732926,0.033459469987575874,0.7885901479645376,0.7551306779769618,24.282182698349676,5.586872103219351,40.449113878842475,26.69707994334454,32.853806177812984,4920313148
1459431000,21.0075,21.1675,20.84,20.8975,14.048246875,21.454567499999996,22.8675,14.68,22.8675,14.68,24.2875,16.1975,23.78275,21.5025,20.14578275000001,19.2728155,17.941345999999974,19.91034000000002,19.016560523440674,19.859792635961764,20.376292307692303,21.233695817263413,19.518888798121193,20.14578275000001,19.2728155,17.941345999999974,19.91034000000002,20.968333333333334,3536220,6778099.4,67.33822670457056,3.2907343848605266,1.5,2.75,NaN,NaN,0.6030104766607395,0.5217126205024376,579.7403353989317,0.021925805366273643,0.7825379346848038,0.7606121293185302,24.871865701207767,2.804083138605339,48.1055354475928,20.499153346778566,31.395311205628644,4916776928
1459517400,20.505,21.385,20.427575,21.3025,14.04319375,21.438234999999995,22.8675,14.68,22.8675,14.68,24.2875,16.1975,23.78275,21.5025,20.13669525000001,19.2599405,18.056995999999973,20.027715000000022,19.10620520879594,19.99719333729874,20.49917692307692,21.393625903963077,19.604727942190763,20.13669525000001,19.2599405,18.056995999999973,20.027715000000022,21.038358333333335,4876980,6674368.2,70.3539477786011,3.7977213396204994,1.5,2.75,NaN,NaN,0.628325799756401,0.7307028701233473,578.2268303033279,0.032459139129108694,0.801186053229916,0.7687269141008073,25.042511624735603,3.598784194528868,81.74289521200957,2.890182015424966,15.366922772565475,4921653908
1459776600,21.305,21.3575,21.0025,21.11,14.038140625,21.421902499999998,22.8675,14.68,22.8675,14.68,24.2875,16.1975,23.78275,21.5025,20.12609525000001,19.2454655,18.164995999999974,20.125965000000022,19.184785396686298,20.103174924222667,20.613599999999998,21.404794765480077,19.82240523451992,20.12609525000001,19.2454655,18.164995999999974,20.125965000000022,21.156666666666666,3062408,6363001.4,67.1789388961042,2.995793706185366,1.5,2.75,NaN,NaN,0.6088025283452295,0.4812835653312916,573.8959631550065,0.01806643013402387,0.7913099517683371,0.7732435216343132,25.76606246131331,2.1533994676990096,62.62566678110791,11.06246554589293,26.311867672999156,4918591500
1459863000,20.62,20.7975,20.39035,20.485,14.0330875,21.405569999999997,22.8675,14.68,22.8675,14.68,24.2875,16.1975,23.78275,21.5025,20.108857750000013,19.2310905,18.241095999999974,20.191090000000024,19.235774204659386,20.139539217153843,20.654176923076925,21.355632811942126,19.952721034211724,20.108857750000013,19.2310905,18.241095999999974,20.191090000000024,20.557616666666664,6418508,6286225.8,58.02322335973815,0.2866269744305583,1.5,2.75,NaN,NaN,0.6167202048919986,1.021043183017702,570.5530965286582,-0.038837266625563194,0.7246969383523592,0.7635342049779223,31.73260942261321,-0.6908253545024935,25.825348056195853,41.46297270902953,32.71167923477462,4912172992
1459949400,20.495,21.1675,20.4175,21.14,14.028034375,21.389237499999997,22.8675,14.68,22.8675,14.68,24.2875,16.1975,23.78275,21.5025,20.09702025000001,19.2218655,18.345445999999974,20.32084000000002,19.31044972604529,20.234821196472524,20.716676923076925,21.435148844925795,19.998205001228055,20.09702025000001,19.2218655,18.345445999999974,20.32084000000002,20.90833333333334,6882392,6225374.4,63.61921640509708,1.8388788088781676,1.5,2.75,NaN,NaN,0.6262401902568558,1.1055386484064316,574.7385053568163,-0.03762791345498884,0.7164993131591864,0.7541272266141752,36.717014642069174,4.498269896193772,31.216867975196173,35.503434159332016,33.279697865471825,4919055384
1460035800,20.755,20.8775,20.13,20.385,14.02298125,21.372904999999996,22.8675,14.68,22.8675,14.68,24.2875,16.1975,23.78275,21.5025,20.078995250000013,19.207715500000003,18.421695999999976,20.398340000000022,19.35258895247489,20.249123939665616,20.703023076923078,21.43922365224246,19.966822501603694,20.078995250000013,19.207715500000003,18.421695999999976,20.398340000000022,20.46416666666667,8108684,6320456.4,54.58604870366949,1.1879431652373853,1.5,2.75,NaN,NaN,0.6536516052385091,1.2829269734381838,569.9741974178826,-0.08995496707341188,0.6416835177724103,0.7316384848458222,41.38292976371105,0.9158415841584271,22.399268428284817,45.63877070042326,31.961960871291943,4910946700
1460122200,20.8025,20.95,20.3625,20.56,14.017928125000001,21.356572499999995,21.3025,14.68,22.8675,14.68,24.2875,16.1975,23.78275,21.5025,20.06155775000001,19.2041405,18.512245999999973,20.482590000000023,19.399938405319013,20.278731183506984,20.694946153846153,21.43493231843775,19.954959989254558,20.06155775000001,19.2041405,18.512245999999973,20.482590000000023,20.624166666666667,6663652,5929672.8,56.14054872296072,0.5020248073241351,1.5,2.75,NaN,NaN,0.6489264905786154,1.1237807253041012,574.491968595162,-0.11353907976118605,0.5897146351443396,0.7032537149055257,41.58305305456311,1.6598843964933234,25.990770982461893,41.269573746934284,32.73965527060382,4917610352
1460381400,20.7825,21.0175,20.3725,20.3975,14.012875000000001,21.340239999999998,21.3025,14.68,22.8675,14.68,24.2875,16.1975,23.78275,21.5025,20.045907750000012,19.2060155,18.594345999999973,20.513590000000022,19.43905846785552,20.290042499363462,20.677253846153842,21.433660218886157,19.920847473421528,20.045907750000012,19.2060155,18.594345999999973,20.513590000000022,20.595833333333335,6125400,5735335.6,54.28248268866853,0.23315664791444193,1.5,2.75,NaN,NaN,0.6486460269658572,1.0680107368084966,577.0569144753749,-0.1391510387680317,0.529314916445486,0.6684659552135177,41.95641445378907,-1.935096153846153,21.301947851342103,47.04296194862068,31.655090200037222,4911484952
1460467800,20.46,21.0675,20.3175,20.985,14.007821875,21.323907499999997,21.3025,14.68,22.8675,14.68,24.2875,16.1975,23.78275,21.5025,20.03430775000001,19.204565499999998,18.664595999999975,20.577590000000022,19.499683625978832,20.356228927995513,20.735330769230764,21.460761796051752,20.009899742409775,20.03430775000001,19.204565499999998,18.664595999999975,20.577590000000022,20.789999999999996,6766788,5793976.4,59.50122195812362,1.5792016302100316,1.5,2.75,NaN,NaN,0.6558855964682959,1.167900511296525,580.8059884351089,-0.1165109901209016,0.5228272175623907,0.6393382076832923,42.03428134862135,-0.41523312373948096,46.64514185205591,21.608155468186094,31.746702679757995,4918251740
1460554200,21.3,21.6375,21.25,21.6,14.00276875,21.307574999999996,21.3025,14.68,22.8675,14.68,24.2875,16.1975,23.78275,21.5025,20.02583275000001,19.2099655,18.746995999999974,20.676465000000025,19.582048973979663,20.474683315805464,20.843023076923075,21.63152071031827,20.05452544352788,20.02583275000001,19.2099655,18.746995999999974,20.676465000000025,21.495833333333337,6755648,5847866,64.11868323803868,3.6165226058103612,1.5,2.75,NaN,NaN,0.655643768149132,1.155233037145516,585.9239517396957,-0.06279380876475571,0.5608459467273477,0.6236397554921034,44.61096963893375,3.3616461299198495,46.68039657726258,21.580923955559346,31.738679467178066,4925007388
1460640600,21.65,21.7875,21.4825,21.6175,13.997715625,21.291242499999996,21.3025,14.68,22.8675,14.68,24.2875,16.1975,23.78275,21.5025,20.02477025000001,19.2055155,18.848835999999974,20.759465000000027,19.661870582843207,20.583523000014466,20.950192307692305,21.75178797965029,20.148596635734318,20.02477025000001,19.2055155,18.848835999999974,20.759465000000027,21.629166666666666,3907176,5653114.2,64.24361204704763,3.52878197988419,1.5,2.75,NaN,NaN,0.6305977847099082,0.691154620580635,584.1863583553762,-0.03040196043983201,0.5856373049423134,0.6160392653821454,44.10697978669383,1.4786996831357884,76.70018243674774,4.572697395302961,18.7271201679493,4928914564
1460727000,21.6025,21.635,21.415,21.5325,13.9926625,21.274909999999995,21.3025,14.68,22.8675,14.68,24.2875,16.1975,23.78275,21.5025,20.022470250000012,19.200815499999997,18.943635999999973,20.819715000000024,19.735228599202298,20.67390176191785,21.00653846153846,21.8593269610224,20.153749962054523,20.022470250000012,19.200815499999997,18.943635999999973,20.819715000000024,21.5275,2481900,5407756.2,63.094528809831885,2.591532782093955,1.5,2.75,NaN,NaN,0.6012693715163435,0.4589519031941566,585.6997395303104,-0.019546470256489146,0.591606177561534,0.6111526478180231,43.061356951645635,2.001421127427757,58.677154579557296,13.342920662815349,27.97992475762736,4926432664
1460986200,21.3225,21.995,21.29,21.9875,13.987609375,21.258577499999998,21.3025,14.68,22.8675,14.68,24.2875,16.1975,23.78275,21.5025,20.02008275000001,19.197940499999998,19.045785999999975,20.890965000000026,19.82355296786103,20.79900635602091,21.076923076923077,22.078013163252347,20.075832990593806,20.02008275000001,19.197940499999998,19.045785999999975,20.890965000000026,21.757499999999997,4456528,5305371,66.54414534898251,3.700006111952979,1.5,2.75,NaN,NaN,0.608678702122319,0.8400030836674759,589.8348048782944,0.01174747396014253,0.6258369902682013,0.6140895163080587,43.90294848765216,7.334635098852825,89.46569353889134,1.0226505743825292,9.511655886726121,4930889192
1461072600,22.1375,22.2875,21.89,22.19,13.98255625,21.242244999999997,21.3025,14.68,22.8675,14.68,24.2875,16.1975,23.78275,21.5025,20.01898275000001,19.198240499999997,19.171135999999976,20.967215000000024,19.916354812258636,20.931481941161778,21.176346153846154,22.3313130454539,20.02137926223841,20.01898275000001,19.198240499999997,19.171135999999976,20.967215000000024,22.122500000000002,4188760,5285123.2,67.97870076725643,3.882572125716783,1.5,2.75,NaN,NaN,0.593594509113582,0.7925567373717987,593.6682265810581,0.03807062995617272,0.6616778037532747,0.623607173797102,38.153695685063944,4.966887417218547,88.26582355666933,1.2575421032485377,10.476634340082125,4935077952
1461159000,22.2025,22.5125,22.0325,22.245,13.977503125,22.5125,21.3025,14.68,22.8675,14.68,24.2875,16.1975,23.78275,21.5025,20.019070250000013,19.198090499999996,19.310435999999974,21.048090000000023,20.00767423138575,21.05657889914637,21.248846153846156,22.537030050453815,19.960662257238496,20.019070250000013,19.198090499999996,19.310435999999974,21.048090000000023,22.263333333333335,3657284,5186448.8,68.37533796377079,4.264892479387215,1.5,2.75,NaN,NaN,0.585480615605469,0.7051614970150675,595.9655680397398,0.05039841278176227,0.6866051897743048,0.6362067769925426,35.14136907338495,9.12435614422369,86.20346605089148,1.7129304938817533,12.083603455226774,4938735236
1461245400,22.25,22.3,21.79305,21.8925,13.97245,22.50971052631579,21.3025,14.68,22.8675,14.68,24.2875,16.1975,23.78275,21.5025,20.015407750000012,19.194540499999995,19.443085999999976,21.131215000000022,20.08158896740984,21.136190432561,21.30903846153846,22.63812365655844,19.97995326651848,20.015407750000012,19.194540499999995,19.443085999999976,21.131215000000022,21.995183333333333,5027652,5140615.8,62.99006567209911,2.365985227109666,1.5,2.75,NaN,NaN,0.5798712859193641,0.9780252396998819,593.1767012846262,0.027187357910163912,0.6701909743802474,0.6430036164700835,27.46370618286208,6.481031128404667,53.15681501492649,16.973545151222787,29.869639833850723,4933707584
1461331800,21.7625,21.9825,21.5625,21.9025,13.967396875,22.50692105263158,21.3025,14.68,22.8675,14.68,24.2875,16.1975,23.78275,21.5025,20.01740775000001,19.190290499999993,19.576385999999978,21.216340000000024,20.15299724319769,21.20917229612662,21.418076923076917,22.690217992065843,20.14593585408799,20.01740775000001,19.190290499999993,19.576385999999978,21.216340000000024,21.815833333333334,4209996,5064810.6,63.078905622752494,1.4176479687018055,1.5,2.75,NaN,NaN,0.5684519083536953,0.8312247648510293,596.850935898801,0.005989947568274534,0.6504910509304267,0.6445011033621522,27.70221170917409,7.378355190587076,73.35060446416763,5.922771535124521,20.726624000707854,4937917580
1461591000,21.665,21.78,21.442,21.78,13.96234375,22.50413157894737,21.3025,14.68,22.8675,14.68,24.2875,16.1975,23.78275,21.5025,20.01827025000001,19.187690499999995,19.718385999999978,21.294125000000026,20.21680127287621,21.263536839352657,21.46730769230769,22.74212511745359,20.192490267161787,20.01827025000001,19.187690499999995,19.718385999999978,21.294125000000026,21.667333333333335,4736324,5120541.4,61.1426831373136,0.4352216697356486,1.5,2.75,NaN,NaN,0.5607410577570028,0.924965473377483,594.0075900906702,-0.021303638873979125,0.6178715547696783,0.6391751936436574,27.29417666322782,3.788420300214447,41.47016289934441,25.818053841300213,32.71178325935538,4933181256
1461677400,21.935,22.055575,21.702525,21.9,13.957290625,22.501342105263156,21.3025,14.68,22.8675,14.68,24.2875,16.1975,23.78275,21.5025,20.01568275000001,19.179840499999997,19.84533599999998,21.349125000000022,20.28280906609675,21.32415237846193,21.583846153846146,22.709907389004094,20.457784918688198,20.01568275000001,19.179840499999997,19.84533599999998,21.349125000000022,21.88603333333333,2966976,4992987,62.36148587275672,1.2178610641512413,1.5,2.75,NaN,NaN,0.5459059822029311,0.5942286651257053,598.5219833871656,-0.035463076713504904,0.5948463477517762,0.6303094244652812,23.49853390147706,1.3888888888888757,37.61611037415904,29.23285156636247,33.15103805947849,4936148232
1461763800,21.7475,22.1525,21.5988,22.0025,13.9522375,22.498552631578946,22.245,14.68,22.8675,14.68,24.2875,16.1975,23.78275,21.5025,20.009907750000014,19.180215499999996,19.95888599999998,21.395625000000024,20.350247926249818,21.388756913846507,21.694807692307684,22.669564982687156,20.720050401928212,20.009907750000014,19.180215499999996,19.95888599999998,21.395625000000024,21.917933333333334,4423160,4962621.8,63.417007513962446,1.4571876720619055,1.5,2.75,NaN,NaN,0.5464626977598644,0.8912950005579712,601.2843326135321,-0.041684005122212375,0.5782044180625157,0.619888423184728,17.596514011729838,1.7809644963571254,39.86098918924733,27.21310729363517,32.92590351711752,4940571392
1461850200,21.7325,22.135,21.25,21.4075,13.947184375,22.495763157894736,22.245,14.68,22.8675,14.68,24.2875,16.1975,23.78275,21.5025,19.99963275000001,19.183840499999995,20.044485999999978,21.421125000000025,20.39170879188708,21.39054196967065,21.772499999999997,22.43095097942648,21.114049020573514,19.99963275000001,19.183840499999995,20.044485999999978,21.421125000000025,21.5975,7452172,5158419.4,53.9575787926545,0.1797561287867867,1.5,2.75,NaN,NaN,0.57064393363416,1.4446619055441672,598.1740411411009,-0.08702093250072551,0.5111122575588212,0.5981331900595467,24.345106438771772,-0.5805178218971323,32.745767945580894,33.93082501662474,33.323407037794354,4933119220
1461936600,21.17,21.3012,20.6575,21.06,13.942131250000001,22.492973684210526,22.245,14.68,22.8675,14.68,24.2875,16.1975,23.78275,21.5025,19.98772025000001,19.171815499999994,20.127435999999975,21.409000000000027,20.41791629024445,21.359061782082968,21.778269230769226,22.40978262856664,21.146755832971813,19.98772025000001,19.171815499999994,20.127435999999975,21.409000000000027,21.00623333333333,8393608,5334250.8,49.3296202207731,3.082279176753719,1.5,2.75,NaN,NaN,0.58345508123172,1.5735308133618315,595.9098775468328,-0.1385051634792156,0.42500173571052713,0.5635068991897427,25.889951447311102,-4.218305855599781,9.258462814420945,66.02449083679484,24.717046348784216,4924725612
1462195800,21.2625,21.62,21.0825,21.5525,13.937078125000001,22.490184210526316,22.245,14.68,22.8675,14.68,24.2875,16.1975,23.78275,21.5025,19.97574525000001,19.168890499999996,20.220285999999977,21.431125000000026,20.462409769058393,21.37748446950364,21.77461538461538,22.410745046512673,21.138485722718087,19.97574525000001,19.168890499999996,20.220285999999977,21.431125000000026,21.418333333333333,4671608,5414710.8,55.19504134811011,0.6272763682784976,1.5,2.75,NaN,NaN,0.5817797182865974,0.8627622365353289,598.967654517117,-0.13722099790843978,0.39198065180419306,0.5292016497126328,26.629468052204672,-2.8729157278053306,24.46197804218024,43.12683496799992,32.411186989819846,4929397220
1462282200,21.1125,21.1875,20.72,21,13.932025,22.487394736842106,22.245,14.68,22.8675,14.68,24.2875,16.1975,23.78275,21.5025,19.96045775000001,19.165440499999995,20.28793599999998,21.456875000000025,20.48349173889924,21.34153356764615,21.72711538461538,22.48386157251421,20.97036919671655,19.96045775000001,19.165440499999995,20.28793599999998,21.456875000000025,20.969166666666666,5110740,5349322.4,48.423166049025724,2.4061195707297145,1.5,2.75,NaN,NaN,0.5996883098375546,0.9553995100388789,596.200722284753,-0.16930664603377765,0.31756834217041074,0.4868749882041884,28.78008608805479,-5.596763317599465,11.450759981033867,61.96794881856881,26.58129120039733,4924286480
1462368600,20.59,20.89425,20.4625,20.645,13.926971875,22.484605263157896,22.245,14.68,22.8675,14.68,24.2875,16.1975,23.78275,21.5025,19.94317025000001,19.162465499999993,20.361085999999982,21.432125000000024,20.489825396197308,21.275197037394136,21.65884615384615,22.60893443999607,20.708757867696228,19.94317025000001,19.162465499999993,20.361085999999982,21.432125000000024,20.66725,6275776,5318991.6,44.63390498132177,3.5455212201237276,1.5,2.75,NaN,NaN,0.5952462877063008,1.1798807879298023,593.4151355115783,-0.20763599151186113,0.227329998814362,0.43496599032622313,28.977187383811223,-5.698298504053894,2.39015841049376,83.5116852149262,14.098156374580045,4918010704
1462455000,20.8275,20.9275,20.4775,20.6225,13.92191875,22.481815789473682,22.245,14.68,22.8675,14.68,24.2875,16.1975,23.78275,21.5025,19.92724525000001,19.157840499999992,20.429685999999982,21.444000000000024,20.495028321836628,21.21303541478517,21.55384615384615,22.62892685812377,20.478765449568527,19.92724525000001,19.157840499999992,20.429685999999982,21.444000000000024,20.675833333333333,5003884,5163751.6,44.39677220211559,3.191021764172902,1.5,2.75,NaN,NaN,0.5848715528701364,0.9690404162740904,592.2495924767496,-0.22617686025945172,0.1522449150019085,0.3784217752613602,28.635577749876266,-5.84408172583039,2.879566069676684,81.80501615190816,15.315417778415148,4913006820
1462541400,20.3625,20.86,20.29585,20.8525,13.916865625,22.479026315789472,22.245,14.68,22.8675,14.68,24.2875,16.1975,23.78275,21.5025,19.913195250000012,19.167765499999994,20.490585999999986,21.458625000000026,20.509046819019506,21.178698708615155,21.450961538461534,22.518803608428126,20.383119468494943,19.913195250000012,19.167765499999994,20.490585999999986,21.458625000000026,20.66945,5839972,5122567.6,47.46912672872994,2.516603447556635,1.5,2.75,NaN,NaN,0.5833914419508408,1.1400478150839826,595.1316269055827,-0.21471328925241967,0.11003016369583563,0.3247434529482553,30.117866308599183,-4.258494031221312,19.59508917646811,49.36836661508562,31.036544208446266,4918846792
1462800600,20.8075,21.0425,20.7375,20.915,13.9118125,22.476236842105262,22.245,14.68,22.8675,14.68,24.2875,16.1975,23.78275,21.5025,19.90139525000001,19.175040499999994,20.554935999999984,21.48450000000003,20.524966551606976,21.153584545889903,21.348653846153844,22.34505046046852,20.352257231839168,19.90139525000001,19.175040499999994,20.554935999999984,21.48450000000003,20.898333333333333,4610360,5046815.6,48.30503085750853,1.2240122059199936,1.5,2.75,NaN,NaN,0.5635063389543522,0.9135186155800898,593.383251035863,-0.1952445396958472,0.08068777832844631,0.2759323180242935,30.446999011877004,-4.497716894977167,19.020635171334604,50.16773048963358,30.811634339031805,4923457152
1462887000,21.1475,21.675,21.125,21.6525,13.906759375,22.473447368421052,22.245,14.68,22.8675,14.68,24.2875,16.1975,23.78275,21.5025,19.896920250000008,19.183665499999993,20.64353599999998,21.517875000000025,20.569183549583173,21.201100303424198,21.330192307692304,22.293957882321443,20.366426733063165,19.896920250000008,19.183665499999993,20.64353599999998,21.517875000000025,21.484166666666667,4244664,4920709.4,57.00014906540057,1.5817237379457023,1.5,2.75,NaN,NaN,0.5775416004576128,0.8626122079064453,597.8905550497592,-0.12825695845603874,0.11561111995424511,0.24386807841028385,37.544192851265734,-1.5907283263265601,41.809812147335,25.574218339594324,32.61596951307069,4927701816
1462973400,21.495,21.6267,21.0675,21.1,13.90170625,22.470657894736842,22.245,14.68,22.8675,14.68,24.2875,16.1975,23.78275,21.5025,19.891657750000007,19.177890499999993,20.695435999999976,21.492875000000026,20.58999988097207,21.191471703098085,21.26846153846154,22.17902463233752,20.35789844458556,19.891657750000007,19.177890499999993,20.695435999999976,21.492875000000026,21.264733333333332,5992412,4882547.6,50.1894100038765,0.38787215976933964,1.5,2.75,NaN,NaN,0.5780743432820691,1.2273125611719589,595.065775156865,-0.11702955658300335,0.09758113268152968,0.21461068926453303,39.826579328390224,-1.4364124722643814,42.283164923611395,25.174251589590995,32.54258348679759,4921709404
1463059800,21.3075,21.3675,20.7175,21.08,13.896653125,22.467868421052632,22.245,14.68,22.8675,14.68,24.2875,16.1975,23.78275,21.5025,19.882320250000006,19.181490499999992,20.742185999999975,21.466000000000026,20.60921557191434,21.180855350422075,21.21461538461538,22.07945162112281,20.349779148107952,19.882320250000006,19.181490499999992,20.742185999999975,21.466000000000026,21.055,5445960,4959486.8,49.95671102100247,0.6373258753205009,1.5,2.75,NaN,NaN,0.5832118901904926,1.0980894232846834,593.9430923580894,-0.10709047382645526,0.08074759698146394,0.1878380708079192,36.97992621968765,0.09496676163342628,40.55760509340037,26.649924155848115,32.79247075075152,4916263444
1463146200,20.9575,21.1575,20.41625,20.5225,13.8916,22.46507894736842,22.245,14.68,22.8675,14.68,24.2875,16.1975,23.78275,21.5025,19.867782750000007,19.191340499999992,20.773535999999975,21.415500000000026,20.605814961251035,21.118154840858068,21.108653846153842,21.948822362640072,20.268485329667612,19.867782750000007,19.191340499999992,20.773535999999975,21.415500000000026,20.69875,6476816,5159232.6,43.853156690942754,2.5027129959684227,1.5,2.75,NaN,NaN,0.5945003266054572,1.2553836010417518,590.6744212938316,-0.1325378211248523,0.022165794401853844,0.15470361552670614,38.93899340509714,-4.77902795499361,13.604334198752426,58.30398287744678,28.091682923800803,4909786628
1463405400,20.575,21.295,20.5694,21.1175,13.886546875,22.46228947368421,22.245,14.68,22.8675,14.68,24.2875,16.1975,23.78275,21.5025,19.856145250000008,19.201765499999993,20.812985999999977,21.372000000000025,20.625881041201975,21.118092475062063,21.04057692307692,21.70505807939408,20.376095766759757,19.856145250000008,19.201765499999993,20.812985999999977,21.372000000000025,20.99396666666667,5204584,5196635.4,50.766756013283896,0.8779011864026252,1.5,2.75,NaN,NaN,0.6072145889907817,1.001529566611504,595.4096652380512,-0.1049787671836438,0.02348015654715141,0.1284589237307952,40.35551696967637,0.5595238095238082,15.153157490297556,55.816608719198605,29.030233790503832,4914991212
1463491800,21.0225,21.135,20.35,20.5675,13.88149375,22.4595,22.245,14.68,22.8675,14.68,24.2875,16.1975,23.78275,21.5025,19.842320250000007,19.201240499999994,20.840685999999984,21.290875000000025,20.62359158860582,21.065655096484726,20.97596153846154,21.64847272927932,20.30345034764376,19.842320250000007,19.201240499999994,20.840685999999984,21.290875000000025,20.68416666666667,6536084,5314001.6,45.22340331652356,2.2600369597101295,1.5,2.75,NaN,NaN,0.6199135469200117,1.2299740368915208,592.2871662388519,-0.11847297622265818,-0.019632296547527517,0.09884067967513066,40.447154759737806,-0.37539355776217276,3.4807884923838714,79.87506009479122,16.644151412824908,4908455128
1463578200,20.39,20.965,20.1725,20.5675,13.876440625,22.45671052631579,22.245,14.68,22.8675,14.68,24.2875,16.1975,23.78275,21.5025,19.829682750000007,19.193240499999995,20.881135999999984,21.207000000000026,20.621391918464415,21.01821175396237,20.938076923076924,21.642131537015562,20.234022309138286,19.829682750000007,19.193240499999995,20.881135999999984,21.207000000000026,20.56833333333333,8466508,5554462.8,45.22340331652356,2.2413394042285177,1.5,2.75,NaN,NaN,0.6322411507114394,1.5242712580593754,588.8584496333309,-0.12162144745070921,-0.053186129638255863,0.06843531781245335,39.30859409575462,-0.26669899381743106,5.698385020585144,73.8276209013962,20.473994078018656,4908455128
1463664600,20.3275,20.4375,19.9075,20.35,19.9075,22.45392105263158,22.245,14.68,22.8675,14.68,24.2875,16.1975,23.78275,21.5025,19.816707750000006,19.184247999999993,20.91143599999998,21.129875000000027,20.610749098132477,20.954572539299285,20.845576923076923,21.517677973875987,20.17347587227786,19.816707750000006,19.184247999999993,20.91143599999998,21.129875000000027,20.231666666666666,7957952,5700977.8,43.06665163894067,3.137485761973196,1.5,2.75,NaN,NaN,0.6342239256606224,1.3958924730420808,584.9718209717604,-0.13172350458483678,-0.09621906291859261,0.035504441666244155,39.74975692713038,-2.40978299964032,4.676001240690383,76.45079790520485,18.87320085410477,4900497176
1463751000,20.57,20.9,20.54,20.7025,19.991213235294115,22.45113157894737,22.245,14.68,22.8675,14.68,24.2875,16.1975,23.78275,21.5025,19.804307750000007,19.180147999999996,20.947985999999982,21.069875000000028,20.614347172715515,20.93056563079459,20.822692307692307,21.49245822988643,20.152926385498183,19.804307750000007,19.180147999999996,20.947985999999982,21.069875000000028,20.714166666666667,4043756,5692665.8,47.44151305071399,0.7652096393701778,1.5,2.75,NaN,NaN,0.6282079309705777,0.7103448791952621,589.8117589878924,-0.10897807523577374,-0.10071815237847304,0.008259922857300712,40.587547663131595,-1.0160172125268878,19.636549196777903,49.3041559867755,31.059294816446606,4904540932
1464010200,20.72,20.8225,20.5625,20.64,20.074926470588235,22.44834210526316,22.245,14.68,22.8675,14.68,24.2875,16.1975,23.78275,21.5025,19.794282750000008,19.168472999999995,20.965235999999987,21.012875000000026,20.61535316594236,20.90289271357606,20.822307692307692,21.492486949437,20.152128435178383,19.794282750000008,19.168472999999995,20.965235999999987,21.012875000000026,20.675,3385920,5625145.6,46.75549458112611,0.6867209195751914,1.5,2.75,NaN,NaN,0.6019073644726795,0.6019257528196248,589.8117589878924,-0.0930727781189959,-0.10808104979144417,-0.015008271672448264,40.53300842066954,-4.676134395566328,4.042267412098506,78.18123495725045,17.776497630651043,4901155012
1464096600,20.9175,21.545,20.9175,21.44,20.15863970588235,22.445552631578945,22.245,14.68,22.8675,14.68,24.2875,16.1975,23.78275,21.5025,19.789045250000004,19.169423,20.999935999999988,20.989875000000026,20.64769225747403,20.954045788473575,20.885192307692307,21.618974557772358,20.151410057612257,19.789045250000004,19.169423,20.999935999999988,20.989875000000026,21.300833333333333,5690416,5761317.6,55.60477897251117,2.4437122741245068,1.5,2.75,NaN,NaN,0.6235568384389166,0.987693509554134,593.9097846628961,-0.027033658596398672,-0.0488003449179466,-0.02176668632154793,41.656360820048185,1.6113744075829377,29.274162311544384,37.5654842949728,33.160353393482836,4906845428
1464183000,21.675,22.025,21.67,21.8475,20.24235294117647,22.442763157894735,22.245,14.68,22.245,14.68,22.8675,16.1975,24.2875,21.5025,19.781695250000006,19.180697999999996,21.04443599999999,20.98212500000003,20.694743541494656,21.039136665761806,20.96173076923077,21.855939453821584,20.067522084639954,19.781695250000006,19.180697999999996,21.04443599999999,20.98212500000003,21.8475,5147840,5797551.6,59.31414047075757,3.993176845020583,1.5,2.75,NaN,NaN,0.6208027785504224,0.8879334510795903,597.0315557219993,0.04197967191464004,0.030707903571752126,-0.011271768342887917,39.75043124436239,3.6408918406072197,44.07685674883814,23.642842667228198,32.280300583933645,4911993268
1464269400,21.9375,22,21.775,21.885,20.326066176470587,22.439973684210525,22.245,14.68,22.245,14.68,22.8675,16.1975,24.2875,21.5025,19.777632750000006,19.201423,21.08298599999999,21.00600000000003,20.74142026535761,21.119695078546396,21.03634615384615,22.0556362827417,20.0170560249506,19.777632750000006,19.201423,21.08298599999999,21.00600000000003,21.886666666666667,2695136,5559699.8,59.64826891304184,3.395846209642104,1.5,2.75,NaN,NaN,0.5925311515111067,0.48476286435465454,598.6539563839956,0.08553117165223592,0.095642196222407,0.010111024570171066,39.671333679887454,6.639054696065297,81.90425988783751,2.841319691363312,15.254420420799164,4914688404
1464355800,21.945,22.1575,21.927525,22.1525,20.409779411764706,22.437184210526315,22.245,14.68,22.245,14.68,22.8675,16.1975,24.2875,21.5025,19.774495250000005,19.223497999999996,21.119485999999988,21.060625000000027,20.796756725539666,21.21805745201817,21.07480769230769,22.214783166973806,19.934832217641574,19.774495250000005,19.223497999999996,21.119485999999988,21.060625000000027,22.079175000000003,2528584,5266448.6,62.04290809388915,3.505475537340372,1.5,2.75,NaN,NaN,0.5696717835460274,0.48013076592070036,602.0012390244771,0.12532376739367584,0.1667657338122659,0.041441966418590034,34.6919232482299,4.901148336687582,80.55299886802302,3.2550187799522177,16.19198235202477,4917216988
1464701400,22.2625,22.31,21.835075,22.05,20.493492647058822,22.434394736842105,22.245,14.68,22.245,14.68,22.8675,16.1975,24.2875,21.5025,19.771345250000007,19.252473,21.149235999999988,21.085500000000028,20.84590352061654,21.297290075635487,21.147884615384612,22.401121725606725,19.8946475051625,19.771345250000007,19.252473,21.149235999999988,21.085500000000028,22.065025000000002,4244328,5245084.6,60.55988565446558,2.973390223813384,1.5,2.75,NaN,NaN,0.5629041561498825,0.8092010565473053,602.9113394740335,0.13677618748066772,0.21241220076942469,0.07563601328875696,32.531438405856235,7.20797374498603,75.4518112974164,5.0542143039872665,19.49397439859631,4912972660
1464787800,21.8075,22.235,21.74,22.17,20.57720588235294,22.431605263157895,22.245,14.68,22.245,14.68,22.8675,16.1975,24.2875,21.5025,19.767532750000008,19.296322999999997,21.17933599999999,21.144000000000027,20.897828872749226,21.380405306527347,21.23173076923077,22.596471354069266,19.86699018439227,19.767532750000008,19.296322999999997,21.17933599999999,21.144000000000027,22.048333333333332,3289672,5154031.2,61.71371316366467,2.8854776314264554,1.5,2.75,NaN,NaN,0.5580538592820339,0.6382716503539986,605.8185586052521,0.14375286932388537,0.2553270999436137,0.11157423061972832,26.02952039837965,7.791418500060789,71.87907453231425,6.516416764517334,21.604508703168396,4916262332
1464874200,22.03,22.375,21.845,22.3675,20.660919117647058,22.428815789473685,22.245,14.68,22.245,14.68,22.8675,16.1975,24.2875,21.5025,19.762882750000006,19.347997999999997,21.21413599999999,21.23012500000003,20.955463034602197,21.474414324953315,21.373653846153847,22.796359307028432,19.95094838527926,19.762882750000006,19.347997999999997,21.21413599999999,21.23012500000003,22.195833333333336,3242944,5002389.6,63.60110247241617,2.7940077195941444,1.5,2.75,NaN,NaN,0.5560500121904601,0.648278974512501,608.6070818827174,0.15217674303318804,0.3017951594112134,0.14961841637802534,25.58905327945756,9.914004914004906,68.15556703565073,8.218573426690059,23.625859537659192,4919505276
1464960600,22.17,22.3,21.7175,22.1825,20.744632352941174,22.42602631578947,22.245,14.68,22.245,14.68,22.8675,16.1975,24.2875,21.5025,19.758307750000007,19.397722999999996,21.253185999999985,21.30812500000003,21.003582131284464,21.541851055910143,21.455576923076926,22.93150316920973,19.97965067694412,19.758307750000007,19.397722999999996,21.253185999999985,21.30812500000003,22.066666666666666,6862000,5095295.4,60.5881304064709,2.105327632785182,1.5,2.75,NaN,NaN,0.5627607256054271,1.346732517215783,610.118442371256,0.136308997197938,0.3200046628754478,0.18369566567750983,24.985609458086035,7.148895060982976,28.033703449388234,38.97112241746776,32.995174133144005,4912643276
1465219800,22.3025,22.6375,22.25,22.505,20.828345588235294,22.42323684210526,22.245,14.68,22.245,14.68,22.8675,16.1975,24.2875,21.5025,19.758082750000007,19.446272999999998,21.299285999999988,21.39075000000003,21.062461263390954,21.633579526775844,21.604615384615386,23.083025193203714,20.126205576027058,19.758082750000007,19.446272999999998,21.299285999999988,21.39075000000003,22.464166666666667,4921564,5049375,63.806961446976494,3.181666403607787,1.5,2.75,NaN,NaN,0.555063530919325,0.9746877583859389,613.5709776715825,0.13812433690629708,0.3563510868103812,0.2182267499040841,24.69096660882728,9.035852713178286,36.1914964063695,30.61241895159351,33.196084642037,4917564840
1465306200,22.5725,22.82,22.555,22.6025,20.91205882352941,22.42044736842105,22.245,14.68,22.245,14.68,22.8675,16.1975,24.2875,21.5025,19.765457750000007,19.508772999999998,21.346849999999986,21.475125000000027,21.122854939336406,21.725857667082906,21.76115384615385,23.197508226286217,20.32479946602148,19.765457750000007,19.508772999999998,21.346849999999986,21.475125000000027,22.659166666666664,3073496,4972531.8,64.74443369212477,3.3279810035232895,1.5,2.75,NaN,NaN,0.537916135853659,0.6180947902635836,616.286900649828,0.13625414128541358,0.3885444265108511,0.2522902852254375,23.79888017767081,5.422108208955214,60.69403620827332,12.18454405508222,27.121419736644473,4920638336
1465392600,22.6725,22.875,22.6225,22.8175,20.99577205882353,22.875,22.245,14.68,22.245,14.68,22.8675,16.1975,24.2875,21.5025,19.783882750000004,19.565797999999997,21.38719999999999,21.533375000000028,21.189311608382038,21.8298236035512,21.950961538461538,23.235338877069236,20.66658419985384,19.783882750000004,19.565797999999997,21.38719999999999,21.533375000000028,22.771666666666665,3115532,4916075.2,66.78737151280441,3.2775617763869493,1.5,2.75,NaN,NaN,0.5189578404355406,0.6337437637243628,619.3300683358449,0.13935998701485125,0.42649026899400155,0.2871302819791503,15.194682483922302,4.439867261700418,60.51643318949333,12.287586307435788,27.195980503070878,4923753868
1465479000,22.55,22.781725,22.4525,22.7375,21.079485294117646,22.885661764705883,22.245,14.68,22.245,14.68,22.8675,16.1975,24.2875,21.5025,19.813470250000005,19.632897999999997,21.42049999999999,21.615250000000028,21.250024878641565,21.916268974641564,22.1075,23.231053771264676,20.983946228735327,19.813470250000005,19.632897999999997,21.42049999999999,21.615250000000028,22.657241666666668,3858932,4809401.2,65.27175627710537,2.368950379846016,1.5,2.75,NaN,NaN,0.5079608518330019,0.8023726529614539,616.7160038122852,0.12627806506918254,0.4449778633156285,0.31869979824644595,13.75949670445335,3.8953621201736306,36.35263414330733,30.46025335849561,33.18711249819706,4919894936
1465565400,22.1975,22.337475,21.882,22.1,21.163198529411762,22.896323529411763,22.245,14.68,22.245,14.68,22.8675,16.1975,24.2875,21.5025,19.842982750000004,19.692947999999998,21.444549999999985,21.66625000000003,21.283357236341896,21.933767167532846,22.219807692307697,22.960959243140437,21.478656141474957,19.842982750000004,19.692947999999998,21.444549999999985,21.66625000000003,22.106491666666667,6922896,4883248,54.63230929837857,0.5699868496161499,1.5,2.75,NaN,NaN,0.5327850767020731,1.4176826571167387,612.4083878178451,0.06786957908710706,0.4035367721053298,0.33566719301822273,23.19776333947025,-0.23699356731745147,36.241697951484824,30.564961392107865,33.193340656407315,4912972040
1465824600,21.8475,22.1775,21.5425,21.5725,21.24691176470588,22.906985294117646,22.245,14.68,22.245,14.68,22.8675,16.1975,24.2875,21.5025,19.860370250000006,19.753472999999996,21.449949999999987,21.718750000000032,21.294696168250056,21.899360770624956,22.230000000000004,22.930505312119543,21.529494687880465,19.860370250000006,19.753472999999996,21.449949999999987,21.718750000000032,21.764166666666668,5588836,4838849,47.7033279489613,1.635479945856064,1.5,2.75,NaN,NaN,0.5400861426519249,1.1549928505725224,608.2362209055337,-0.009021595240294333,0.3243901989678548,0.33341179420814915,25.98233827162369,-2.16553287981859,9.523544308407722,65.5133009308896,24.963154760702686,4907383204
1465911000,21.42,21.658025,21.0925,21.435,21.330624999999998,22.91764705882353,22.245,14.68,22.245,14.68,22.8675,16.1975,24.2875,21.5025,19.870482750000004,19.810722999999996,21.456449999999986,21.73462500000003,21.300198279299074,21.85513593532734,22.198269230769235,22.99584822279492,21.40069023874355,19.870482750000004,19.810722999999996,21.456449999999986,21.73462500000003,21.395175,6336860,4895462.8,46.06334175144907,2.98904329491806,1.5,2.75,NaN,NaN,0.5419032038910729,1.2944353289744128,605.0514356470184,-0.06855714720916184,0.24771536019669682,0.31627250740585866,26.05072427340501,-3.3152909336941945,1.6936114941210398,86.22910502596137,12.077283479917595,4901046344
1465997400,21.5825,21.8,21.277525,21.3425,21.414338235294117,22.928308823529413,22.8175,14.68,22.245,14.68,22.8675,16.1975,24.2875,21.5025,19.880120250000008,19.857347999999995,21.473599999999987,21.773375000000033,21.301857170306953,21.806313465296164,22.156538461538467,23.064451407343164,21.24862551573377,19.880120250000008,19.857347999999995,21.473599999999987,21.773375000000033,21.473341666666673,6995184,4918417.8,44.94393901189519,1.943413629830671,1.5,2.75,NaN,NaN,0.5405154750417106,1.4222427383049892,607.7790719864155,-0.11106552882796972,0.1774405963708965,0.2885061251988662,25.51677432029321,-4.582541634067279,0,100.00000000000001,0,4894051160
1466083800,21.0425,21.6,20.68,21.5625,21.498051470588234,22.938970588235293,22.8175,14.68,22.245,14.68,22.8675,16.1975,24.2875,21.5025,19.893320250000006,19.913747999999995,21.482049999999987,21.823125000000033,21.312078457745894,21.783093135267958,22.111153846153854,23.07273630668564,21.149571385622068,19.893320250000006,19.913747999999995,21.482049999999987,21.823125000000033,21.280833333333334,8201536,4905169.2,48.17003629995892,2.6006492689665444,1.5,2.75,NaN,NaN,0.5676215125387314,1.6720189794880063,606.3112349877861,-0.12047708958677239,0.13790976321540072,0.2583868528021731,25.77910530701854,-2.7949960554491198,6.843646676607238,71.10965759637678,22.046695727015987,4902252696
1466170200,21.5,21.505,21.0675,21.2975,21.58176470588235,22.949632352941176,22.8175,14.68,22.245,14.68,22.8675,16.1975,24.2875,21.5025,19.913645250000005,19.960997999999996,21.500299999999985,21.870500000000032,21.311506753520565,21.73684617000434,22.05326923076924,23.108631699700364,20.997906761838113,19.913645250000005,19.960997999999996,21.500299999999985,21.870500000000032,21.29,7283028,4871423,44.76720673473631,2.2250029290664393,1.5,2.75,NaN,NaN,0.5624342616431078,1.4950514459532667,609.2674370165356,-0.13932780995003888,0.0842270903646245,0.22355490031466338,26.14829321770295,-5.365474339035768,6.80129738021078,71.20551746897902,21.99318515081018,4894969668
1466429400,22.025,22.25,21.6775,21.69,21.66547794117647,22.96029411764706,22.8175,14.68,22.245,14.68,22.8675,16.1975,24.2875,21.5025,19.93108275000001,20.017572999999995,21.522899999999986,21.919875000000033,21.326349625931524,21.732384630003928,22.01634615384616,23.086275366789735,20.946416940902587,19.93108275000001,20.017572999999995,21.522899999999986,21.919875000000033,21.8725,5210004,4929735.4,50.36051738650714,0.5640452411455191,1.5,2.75,NaN,NaN,0.5902961000971716,1.0568526659666155,614.1707886399516,-0.12082895655358611,0.07251870462268073,0.19334766117626684,27.20763972618446,-4.037164030527587,20.130247584778783,48.612166630123184,31.257585785098048,4900179672
1466515800,21.94,22.0375,21.685,21.8875,21.749191176470585,22.970955882352943,22.8175,14.68,22.245,14.68,22.8675,16.1975,24.2875,21.5025,19.949395250000006,20.073522999999994,21.552699999999987,21.982250000000032,21.348355522953817,21.747157522384505,21.979423076923084,23.03130811350147,20.927538040344697,19.949395250000006,20.073522999999994,21.552699999999987,21.982250000000032,21.87,3280644,4924471.6,52.942835887351386,0.6829552429192731,1.5,2.75,NaN,NaN,0.5733106643759454,0.666192084446177,615.858982941565,-0.09205890518024806,0.07827402970095676,0.17033293488120482,27.845471817837467,-4.075818998575653,38.43003652934184,28.500843390657426,33.06912008000073,4903460316
1466602200,21.945,22.2225,21.7325,21.755,21.832904411764705,22.981617647058822,22.8175,14.68,22.245,14.68,22.8675,16.1975,24.2875,21.5025,19.971082750000008,20.116347999999995,21.56809999999999,21.998000000000033,21.364302365190923,21.747904425014553,21.946538461538466,22.997701806931666,20.895375116145267,19.971082750000008,20.116347999999995,21.56809999999999,21.998000000000033,21.903333333333332,3946364,4837269,51.02505279736872,0.6129406073153751,1.5,2.75,NaN,NaN,0.5673599026348063,0.8158247970083946,613.9986416918968,-0.07920924772774018,0.07132137522152959,0.15053062294926978,26.661496292096967,-4.321055525013751,46.60099076866505,21.656127139305354,31.7428820920296,4899513952
1466688600,22.2925,22.635,22.1475,22.6225,21.91661764705882,22.992279411764706,22.8175,14.68,22.245,14.68,22.8675,16.1975,24.2875,21.5025,19.990432750000007,20.167772999999997,21.58854999999999,22.036750000000033,21.413643448908925,21.831199241679833,21.95557692307693,23.02760618833144,20.88354765782242,19.990432750000007,20.167772999999997,21.58854999999999,22.036750000000033,22.468333333333334,4851712,4822462.6,60.988748506309506,2.5486034498284593,1.5,2.75,NaN,NaN,0.5896913381608917,1.0060652414390938,618.9073317508878,-0.013013587316616088,0.13426363880349967,0.14727722612011576,36.69389722904738,2.364253393665146,39.419843160690284,27.613421492134105,32.9667353471756,4904365664
1466775000,20.285,21.374975,20.03,20.1825,22.00033088235294,23.00294117647059,22.8175,14.68,22.245,14.68,22.8675,16.1975,24.2875,21.5025,20.00149525000001,20.204342999999994,21.559849999999987,21.951625000000032,21.365363313657593,21.674180266281756,21.769423076923083,23.129270570982836,20.40957558286333,20.00149525000001,20.204342999999994,21.559849999999987,21.951625000000032,20.52915833333333,14501596,5412785.6,37.73490430319061,6.367892454879898,1.5,2.75,NaN,NaN,0.7327490997208278,2.67913733734438,611.5275256246039,-0.12789903411579245,-0.01259656652462482,0.11530246759116763,74.20116412296557,-6.44338857341523,24.737785678040545,42.762999100830704,32.49921522112875,4889864068
1467034200,19.7075,19.72,18.8325,19.0675,18.8325,23.013602941176472,22.8175,14.68,22.245,14.68,22.8675,16.1975,24.2875,21.5025,20.005532750000008,20.227092999999996,21.510549999999988,21.797375000000034,21.275251026847492,21.42592500282635,21.480961538461543,23.33153685281188,19.630386224111206,20.005532750000008,20.227092999999996,21.510549999999988,21.797375000000034,19.206666666666663,13074112,5940062,31.773138899480713,11.59876898408363,1.5,2.75,NaN,NaN,0.7768384497407688,2.2010059827658366,604.8037393158652,-0.2654102135014912,-0.21646029928569632,0.04894991421579484,78.84288075559216,-11.045019827385117,5.618324460929634,74.0568686364414,20.324806902628964,4876789956
1467120600,19.655,20.1325,19.54,20.06,18.791153846153847,23.024264705882352,22.8175,14.68,22.245,14.68,22.8675,16.1975,24.2875,21.5025,20.013295250000006,20.258892999999993,21.47199999999999,21.69787500000003,21.227594123833864,21.295836907319078,21.275000000000002,23.11630597465704,19.433694025342966,20.013295250000006,20.258892999999993,21.47199999999999,21.69787500000003,19.910833333333333,13388428,6397267,40.74705314580448,5.952298767432099,1.5,2.75,NaN,NaN,0.7974214176164283,2.092835581194282,611.3492062399969,-0.27479355043002573,-0.29454202382173733,-0.01974847339171161,86.81451760560749,-6.009136699074626,17.32532049298832,52.59607656457411,30.078602942437563,4890178384
1467207000,20.625,21.2325,20.59,21.1525,18.74980769230769,23.034926470588236,22.8175,14.68,22.245,14.68,22.8675,16.1975,24.2875,21.5025,20.027607750000005,20.311192999999992,21.451249999999987,21.64700000000003,21.224649256232535,21.28218577328869,21.202115384615386,22.980978295139373,19.4232524740914,20.027607750000005,20.311192999999992,21.451249999999987,21.64700000000003,20.99166666666667,11790396,6822303.2,48.739583082084344,0.645218055208403,1.5,2.75,NaN,NaN,0.8242127449295407,1.7282134279813304,617.5773258345623,-0.1963688714599754,-0.26520956271668084,-0.06884069125670546,93.34828983500891,-1.9014492753623196,36.69684594287833,30.15622964165728,33.14692441546438,4901968780
1467293400,21.3075,22.04,21.12275,21.99,18.70846153846154,23.04558823529412,22.8175,14.68,22.245,14.68,22.8675,16.1975,24.2875,21.5025,20.042532750000007,20.378292999999992,21.44614999999999,21.628125000000033,21.254663010890084,21.3495966520231,21.23423076923077,23.05330215597159,19.41515938248995,20.042532750000007,20.378292999999992,21.44614999999999,21.628125000000033,21.717583333333334,8538588,7087085.4,53.87588364837354,2.8974389016028748,1.5,2.75,NaN,NaN,0.8308582631488591,1.2048095257889795,622.5773258345623,-0.08284492040500133,-0.1723968417629571,-0.08955192135795578,95.99319666401125,3.251555346871694,40.75697133084781,26.49788477105897,32.745143898093225,4910507368
1467379800,21.985,22.335,21.975,22.115,18.667115384615386,23.05625,22.8175,14.68,22.245,14.68,22.8675,16.1975,24.2875,21.5025,20.055645250000005,20.44684299999999,21.45059999999999,21.62475000000003,21.288401716345376,21.422492208973278,21.286538461538463,23.163868335487443,19.409208587589482,20.055645250000005,20.44684299999999,21.45059999999999,21.62475000000003,22.141666666666666,5926844,7040327.6,54.606967801768555,3.5230094212447662,1.5,2.75,NaN,NaN,0.7972255300667977,0.8418420756443209,625.5137265190044,0.0014461961644914867,-0.08774417615234142,-0.08919037231683291,95.5661509832703,1.9594283079760126,70.94687517444876,6.941244899645201,22.11187992590604,4916434212
1467725400,21.85,21.882475,21.45,21.6925,18.62576923076923,23.066911764705882,22.8175,19.0675,22.245,14.68,22.8675,16.1975,24.2875,21.5025,20.067345250000006,20.511392999999988,21.446399999999993,21.584125000000032,21.304248707861245,21.44820723669011,21.313461538461542,23.20322702906281,19.423696047860275,20.067345250000006,20.511392999999988,21.446399999999993,21.584125000000032,21.674991666666667,5652564,7076877.6,51.62825817986117,1.2230184018283892,1.5,2.75,NaN,NaN,0.7877808493477406,0.7987370023186497,620.2687475942071,0.0280525916837953,-0.05412463271208878,-0.08217722439588408,95.91017695548516,-0.8909194745859522,85.98396212268445,1.7526235332134894,12.263414344102056,4910781648
1467811800,21.4875,22.1075,21.255,22.055,18.584423076923077,23.077573529411765,22.8175,19.0675,22.245,14.68,22.8675,16.1975,24.2875,21.5025,20.085682750000004,20.585142999999988,21.451899999999995,21.55675000000003,21.333689935003942,21.505997023672002,21.35134615384616,23.278930947336363,19.423761360355954,20.085682750000004,20.585142999999988,21.451899999999995,21.55675000000003,21.80583333333333,8421920,7344298.8,53.94929673356136,2.171102701852586,1.5,2.75,NaN,NaN,0.7924036458229021,1.1467289429999772,623.1727086288495,0.06714149893545261,0.001749649273431686,-0.06539184966202093,96.26474550794062,1.3789933348655514,84.5023161967688,2.1216338623681286,13.376049940863068,4919203568
1467898200,22.1525,22.375,21.7425,22,18.543076923076924,23.08823529411765,22.8175,19.0675,22.245,14.68,22.8675,16.1975,24.2875,21.5025,20.102307750000005,20.64961799999999,21.453899999999994,21.51587500000003,21.359819741474375,21.55304492617943,21.40538461538462,23.36305478300916,19.447714447760077,20.102307750000005,20.64961799999999,21.453899999999994,21.51587500000003,22.03916666666667,4572392,7417141.8,53.529611123605804,2.1187740512119873,1.5,2.75,NaN,NaN,0.7809819568355519,0.6164627997269784,625.3684837929836,0.0852081939037477,0.04111839271766371,-0.04408980118608399,96.19388202353296,-2.7516852690905016,61.86802943936521,11.4932624368316,26.638708123803188,4914631176
1467984600,22.5,23.0875,22.41,23.0075,18.501730769230768,23.09889705882353,22.8175,19.0675,22.245,14.68,22.8675,16.1975,24.2875,21.5025,20.127520250000003,20.716442999999995,21.473999999999993,21.52937500000003,21.42443465357342,21.691564457019485,21.50673076923077,23.64126583355471,19.372195704906833,20.127520250000003,20.716442999999995,21.473999999999993,21.52937500000003,22.834999999999997,5956584,7522024.4,59.71230520065027,5.188622133050657,1.5,2.75,NaN,NaN,0.8028761027758696,0.79188575883907,631.1745276205427,0.15676354857323657,0.15186463453046173,-0.0048989140427748434,97.0630473151172,13.997274866840081,58.53784734357621,13.440793893769523,28.02135876265428,4920587760
1468243800,23.195,23.455,23.1025,23.2475,18.460384615384616,23.10955882352941,22.8175,19.0675,22.245,14.68,22.8675,16.1975,24.2875,21.5025,20.154420250000005,20.777642999999994,21.51079999999999,21.58675000000003,21.495927412256815,21.8397487944462,21.611346153846156,23.935188806556578,19.287503501135735,20.154420250000005,20.777642999999994,21.51079999999999,21.58675000000003,23.26833333333333,7207128,7536236,61.041991131272226,5.842233019747118,1.5,2.75,NaN,NaN,0.777492095434736,0.95632992385058,634.8093267492268,0.20875615614724707,0.256046281141284,0.04729012499403694,63.14313928531333,21.92211878851449,62.6473630117458,11.152351494621447,26.20028549363276,4927794888
1468330200,23.625,23.86,23.525,23.735,18.419038461538463,23.120220588235295,22.8175,19.0675,22.245,14.68,22.8675,16.1975,24.2875,21.5025,20.184595250000008,20.845867999999996,21.56429999999999,21.69487500000003,21.583734180403606,22.02024890926085,21.76365384615385,24.349919059058223,19.17738863324948,20.184595250000008,20.845867999999996,21.56429999999999,21.69487500000003,23.706666666666667,3887852,7451186.8,63.665282355777,6.471666505653609,1.5,2.75,NaN,NaN,0.7657069457608262,0.5217762088584331,638.6164585926967,0.26108074872044096,0.37364106089458815,0.11256031217414718,44.10192806300647,18.320039880358927,84.44288957251499,2.16249310582027,13.394617321664748,4931682740
1468416600,23.9025,23.925,23.55745,23.745,18.377692307692307,23.13088235294118,22.8175,19.0675,22.245,14.68,22.8675,16.1975,24.2875,21.5025,20.215120250000005,20.914217999999995,21.608149999999988,21.81037500000003,21.66848970274072,22.184510917902674,21.850000000000005,24.61403759854201,19.085962401458,20.215120250000005,20.914217999999995,21.608149999999988,21.81037500000003,23.742483333333336,3981244,7333406,63.719250324237876,5.455041565682561,1.5,2.75,NaN,NaN,0.7372671639207672,0.5428915295293892,636.8958405886675,0.27980249114405853,0.4623134261042203,0.1825109349601618,41.438821472454606,12.25623448764922,81.69510188177742,2.9408481472531616,15.364049970969404,4935663984
1468503000,24.245,24.315,23.98775,24.125,18.336346153846154,23.141544117647058,22.8175,19.0675,22.245,14.68,22.8675,16.1975,24.2875,21.5025,20.254245250000007,20.979293,21.670649999999988,21.94950000000003,21.764823439888143,22.369319401911945,22.153269230769236,24.9832796850958,19.323258776442675,20.254245250000007,20.979293,21.670649999999988,21.94950000000003,24.142583333333334,3817500,7174521.8,65.79814380347625,6.0293750902855985,1.5,2.75,NaN,NaN,0.7253195093549981,0.532091211988512,639.373913442807,0.2994560025522429,0.5568309381504655,0.25737493559822255,34.492575709083184,9.708958617553442,100.00000000000001,0,0,4939481484
1468589400,24.37,24.37,23.8575,24.0225,18.295,23.15220588235294,22.8175,19.0675,22.245,14.68,22.8675,16.1975,24.2875,21.5025,20.292632750000006,21.049642999999996,21.73819999999999,22.072500000000026,21.853359775578806,22.526765173158427,22.53442307692308,24.89516298199697,20.173683171849188,20.292632750000006,21.049642999999996,21.73819999999999,22.072500000000026,24.083333333333332,3570636,6942976.8,64.72087199022185,5.001567306474497,1.5,2.75,NaN,NaN,0.7101181158296411,0.5142802724041942,640.9568686305607,0.2871887155691204,0.616360830059623,0.32917211449050265,31.493689273397823,8.625367397693884,82.76643466391603,2.6245054898704967,14.609059846213471,4935910848
1468848600,24.075,24.2875,23.98475,24.23,18.253653846153846,23.162867647058825,22.8175,19.0675,22.245,14.68,22.8675,16.1975,24.2875,21.5025,20.327445250000007,21.120017999999995,21.81034999999999,22.219125000000027,21.946561353007088,22.688978013810004,22.855192307692313,24.895339796269532,20.815044819115094,20.327445250000007,21.120017999999995,21.81034999999999,22.219125000000027,24.167416666666668,3135504,6735600.6,65.93671391754935,4.817749334486862,1.5,2.75,NaN,NaN,0.6810203932703812,0.4655121623452555,644.0692225609407,0.2746860766257367,0.6725297102726735,0.3978436336469368,31.430671293077587,11.697591333410172,77.95858487492427,4.139376066220563,17.90203905885518,4939046352
1468935000,24.0525,24.1625,23.965,24.1325,18.212307692307693,23.173529411764708,22.8175,19.0675,22.245,14.68,22.8675,16.1975,24.2875,21.5025,20.361070250000008,21.183267999999998,21.87594999999999,22.341250000000027,22.03228443720289,22.826456298209052,23.084423076923084,24.971741233060307,21.19710492078586,20.361070250000008,21.183267999999998,21.87594999999999,22.341250000000027,24.086666666666662,5678188,6759009.8,64.80652970167799,3.568159704166294,1.5,2.75,NaN,NaN,0.6513046508939254,0.8400916950882362,641.8783323309201,0.24260088002993058,0.70109473368435,0.45849385365441947,27.345635560820988,9.419632736340969,40.64456120846928,26.592451551536296,32.76298723999443,4933368164
1469021400,24.3275,24.54225,24.165,24.4525,18.170961538461537,23.184191176470588,22.8175,19.0675,22.245,14.68,22.8675,16.1975,24.2875,21.5025,20.39255775000001,21.250817999999995,21.946699999999993,22.46950000000003,22.12719485143023,22.981317603141523,23.273846153846158,25.17799710069947,21.369695206992844,20.39255775000001,21.250817999999995,21.946699999999993,22.46950000000003,24.38658333333333,2963652,6743160.2,66.81686892746123,4.3625067994224205,1.5,2.75,NaN,NaN,0.6340507472586449,0.4395049075061275,645.1170607391272,0.22601461286376823,0.7410121197341297,0.5149975068703615,27.145984870012548,11.147727272727275,37.596172066513375,29.31799696149801,33.08583097198861,4936331816
1469107800,24.3975,24.4875,23.99275,24.1575,18.129615384615384,23.19485294117647,22.8175,19.0675,22.245,14.68,22.8675,16.1975,24.2875,21.5025,20.417670250000004,21.320167999999995,21.996799999999993,22.58962500000003,22.20681466117806,23.093334974270903,23.430961538461546,25.262382317803617,21.599540759119474,20.417670250000004,21.320167999999995,21.996799999999993,22.58962500000003,24.212583333333335,2946176,6693150.8,63.23100301689101,2.912703782382118,1.5,2.75,NaN,NaN,0.6241006938830272,0.4401777411021428,643.0259966512505,0.1802492576636726,0.7403090789499522,0.5600598212862796,29.285368225488284,4.998370096707589,15.51280968578151,55.29901135107558,29.188178963142924,4933385640
1469194200,24.2525,24.5125,24.114525,24.4825,18.08826923076923,23.205514705882354,22.8175,19.0675,22.245,14.68,22.8675,16.1975,24.2875,21.5025,20.445357750000007,21.379942999999994,22.064449999999997,22.68262500000003,22.296057223484805,23.22563640529272,23.64557692307693,25.251866428842117,22.039287417311744,20.445357750000007,21.379942999999994,22.064449999999997,22.68262500000003,24.36984166666667,2503704,6575750.4,65.43204173581948,3.3269953452733843,1.5,2.75,NaN,NaN,0.607948858605668,0.3807480283923185,645.7469085102672,0.15775023796809162,0.7572476187463941,0.5994973807783025,19.22215353509095,5.312399182707831,35.22699775715097,31.54991446562614,33.22308777722291,4935889344
1469453400,24.405,24.4225,24.07,24.29,18.046923076923076,23.216176470588238,22.8175,19.0675,22.245,14.68,22.8675,16.1975,24.2875,21.5025,20.469745250000006,21.435417999999995,22.128649999999997,22.88800000000003,22.37425105785795,23.327004366693416,23.81750000000001,25.16333545685314,22.47166454314688,20.469745250000006,21.435417999999995,22.128649999999997,22.88800000000003,24.260833333333334,4178156,6059578.4,63.02549542307655,2.145314214934833,1.5,2.75,NaN,NaN,0.5939882258481204,0.6895126565240908,643.0287566538465,0.11762835668566551,0.7465328266353843,0.6289044699497188,20.582116491756555,2.3383189382768053,12.549412637500243,60.11512687824667,27.335460484253097,4931711188
1469539800,24.25,24.457475,23.992775,24.3075,18.005576923076923,23.226838235294117,22.8175,19.0675,22.245,14.68,22.8675,16.1975,24.2875,21.5025,20.49157025000001,21.488942999999995,22.204349999999994,23.15000000000003,22.45006474186352,23.420384903198805,23.995000000000008,24.856813829619306,23.13318617038071,20.49157025000001,21.488942999999995,22.204349999999994,23.15000000000003,24.252583333333334,3252116,5568478.6,63.15815454742244,1.7761503769732148,1.5,2.75,NaN,NaN,0.5847533525732543,0.5840223575610042,645.5715935376194,0.08169767307031306,0.7310265612876101,0.6493288882172971,17.779571739382142,2.368919772583702,42.52452174297507,25.015549920484695,32.45992833654026,4934963304
1469626200,24.47,24.5,23.9375,24.24,17.96423076923077,23.2375,22.8175,19.0675,22.245,14.68,22.8675,16.1975,24.2875,21.5025,20.512932750000008,21.539892999999992,22.266799999999993,23.35900000000003,22.520258281398284,23.498443483846536,24.0898076923077,24.741873821382345,23.437741563233057,20.512932750000008,21.539892999999992,22.266799999999993,23.35900000000003,24.22583333333333,4436392,5120876.8,62.2307058466052,1.5892220452454906,1.5,2.75,NaN,NaN,0.5831638273894504,0.8663344527249709,644.0774974120895,0.04466678981627625,0.7051623754876424,0.6604955856713661,18.00188334640134,0.47668393782382773,15.52657984779125,55.308720044955,29.16470010725375,4930526912
1469712600,24.19,24.4425,23.9825,24.32,17.922884615384614,23.248161764705884,22.8175,19.0675,22.245,14.68,22.8675,16.1975,24.2875,21.5025,20.534307750000007,21.591267999999996,22.34184999999999,23.517375000000033,22.590836388010118,23.576686961575437,24.1723076923077,24.61498947391082,23.72962591070458,20.534307750000007,21.591267999999996,22.34184999999999,23.517375000000033,24.24833333333333,3035268,4683120.4,62.92557932579557,1.543362492464106,1.5,2.75,NaN,NaN,0.5743664111473465,0.6481293968013293,645.0040000184788,0.01819884359788415,0.6832441401687213,0.6650452965708371,15.785987536399974,1.2384223124154414,36.10621199086275,30.738385692703655,33.155402316433594,4933562180
1469799000,24.23,24.5825,24.1125,24.4525,17.88153846153846,23.258823529411764,24.4825,19.0675,22.245,14.68,22.8675,16.1975,24.2875,21.5025,20.55838275000001,21.650342999999992,22.41954999999999,23.64050000000003,22.663842804166585,23.660097727139682,24.227500000000006,24.61362971116732,23.841370288832692,20.55838275000001,21.650342999999992,22.41954999999999,23.64050000000003,24.382500000000004,3334784,4422930.2,64.10353546331329,1.8120388880078255,1.5,2.75,NaN,NaN,0.5669116674939646,0.753976176246236,648.2759844855784,0.0030479836569308194,0.6688552761420006,0.6658072924850698,15.6279448366622,0.9182831200990513,39.22215243457698,27.872023479344982,32.905824086078034,4936896964
1470058200,24.48,24.61375,24.195,24.3525,17.84019230769231,23.269485294117647,24.4825,19.0675,22.245,14.68,22.8675,16.1975,24.2875,21.5025,20.58339525000001,21.705517999999994,22.49959999999999,23.752375000000033,22.730064654983583,23.726040800745427,24.274230769230776,24.54540616390101,24.003055374560542,20.58339525000001,21.705517999999994,22.49959999999999,23.752375000000033,24.387083333333333,3550200,4304098,62.48979875924368,1.3257123959863102,1.5,2.75,NaN,NaN,0.5563286912443957,0.824841813546067,645.8433879770723,-0.0190598665489089,0.6419824592989336,0.6610423258478425,15.294552263573552,0.9116336890085937,38.28922140723402,28.675172253430404,33.03560633933559,4933346764
1470144600,24.265,24.33425,23.577775,23.9,23.577775,23.28014705882353,24.4825,19.0675,22.245,19.0675,22.8675,14.68,24.2875,16.1975,20.601745250000008,21.755767999999993,22.563549999999992,23.86275000000003,22.775944472435206,23.742608343531575,24.256923076923083,24.586434100703624,23.927412053142543,20.601745250000008,21.755767999999993,22.563549999999992,23.86275000000003,23.93734166666667,4800948,4261517.2,55.66155108066762,0.8142257425758619,1.5,2.75,NaN,NaN,0.5719284275840817,1.1265818661954479,641.0358235150668,-0.06682157863864502,0.5775153525495362,0.6443369311881813,18.812228700856654,-2.2594826704835986,13.531850230918279,58.43321868679959,28.034931082282128,4928545816
1470231000,23.87,24.13,23.7675,24.11,23.767585999999998,23.290808823529414,24.4825,19.0675,22.245,19.0675,22.8675,14.68,24.2875,16.1975,20.619832750000004,21.799092999999992,22.632949999999987,23.96550000000003,22.82826037547696,23.777598025099998,24.263653846153854,24.576909795723576,23.950397896584132,20.619832750000004,21.799092999999992,22.632949999999987,23.96550000000003,24.002499999999998,4232364,4052039.4,57.957559380619585,0.19977416396174674,1.5,2.75,NaN,NaN,0.5569692541852188,1.0445021832709722,644.3018098387777,-0.0857273843155465,0.5371777007937482,0.6229050851092947,17.73851253676122,-0.19662630653006077,40.27396380762538,26.906530530915965,32.819505661458656,4932778180
1470317400,24.16,24.3075,23.995,24.18,23.957397,23.301470588235293,24.4825,19.0675,22.245,19.0675,22.8675,14.68,24.2875,16.1975,20.638032750000008,21.843842999999993,22.687749999999987,24.074500000000032,22.88126977251708,23.815922022709522,24.2598076923077,24.575837520126225,23.943777864489174,20.638032750000008,21.843842999999993,22.687749999999987,24.074500000000032,24.160833333333333,3210796,3983959.6,58.72482425620516,0.3900316940299972,1.5,2.75,NaN,NaN,0.5395071646005604,0.8059308633551404,646.3449231314282,-0.09429487619549637,0.5050364898649242,0.5993313660604206,16.46759056367112,-1.2355764321454181,40.78826227381261,26.459106947104598,32.75263077908278,4935988976
1470403800,24.4575,24.79,24.4075,24.7825,24.147208,23.312132352941177,24.4825,19.0675,22.245,19.0675,22.8675,14.68,24.2875,16.1975,20.659682750000005,21.89544299999999,22.746449999999985,24.16325000000003,22.955827820653663,23.907977068165756,24.3098076923077,24.72084512995533,23.89877025466007,20.659682750000005,21.89544299999999,22.746449999999985,24.16325000000003,24.659999999999997,3713804,3871820.6,64.69676624875801,2.3175116744530233,1.5,2.75,NaN,NaN,0.5445423671290918,0.959188036759761,649.8268492541094,-0.061735568112833095,0.5221619059193792,0.5838974740322123,20.535622238288763,2.0275833676410033,42.166733224247345,25.281371012208393,32.55189576354425,4939702780
1470663000,24.8575,24.8925,24.63,24.7375,24.337018999999998,23.32279411764706,24.4825,19.0675,22.245,19.0675,22.8675,14.68,24.2875,16.1975,20.68293275000001,21.943242999999992,22.803499999999985,24.23775000000003,23.02569731788293,23.986979252149972,24.331730769230777,24.797614481262112,23.865847057199442,20.68293275000001,21.943242999999992,22.803499999999985,24.23775000000003,24.75333333333333,1892012,3606064.8,63.95250678131267,2.026727570477761,1.5,2.75,NaN,NaN,0.5243964837627281,0.5246749864284191,651.5441946947005,-0.04628682077790758,0.5260389480598278,0.5723257688377353,19.834899838552364,1.769001337035893,52.09508994831619,17.625173446481057,30.279736605202764,4937810768
1470749400,24.7625,24.97,24.655,24.775,24.52683,23.333455882352943,24.4825,19.0675,22.245,19.0675,22.8675,14.68,24.2875,16.1975,20.701382750000008,21.987717999999994,22.85594999999999,24.28975000000003,23.094297423063992,24.062028847183306,24.379230769230773,24.88828866459082,23.870172873870725,20.701382750000008,21.987717999999994,22.85594999999999,24.28975000000003,24.8,2493548,3536349.6,64.32085592007695,1.9104341337648174,1.5,2.75,NaN,NaN,0.5094395920653902,0.7051191997533275,652.9365296009742,-0.0370020360037866,0.5260732238330021,0.5630752598367887,19.82396282541417,2.207095709570958,86.50102195499335,1.6307180275566915,11.86826001744996,4940304316
1470835800,24.83,24.85,24.45,24.5975,24.716641,23.344117647058823,24.4825,19.0675,22.245,19.0675,22.8675,14.68,24.2875,16.1975,20.715407750000008,22.028067999999994,22.906899999999993,24.33237500000003,23.153246543728148,24.113026099832517,24.38807692307693,24.907888848555583,23.868264997598278,20.715407750000008,22.028067999999994,22.906899999999993,24.33237500000003,24.632499999999997,2476008,3461087.8,61.13639314783383,1.0859758336888925,1.5,2.75,NaN,NaN,0.5016224783464339,0.7153843366816641,651.0776467255475,-0.04570388990322183,0.5059453974577615,0.5516492873609833,20.358289109153635,1.1410361842105257,60.16058962702822,12.469674757977232,27.369735614994536,4937828308
1470922200,24.815,25.03,24.69525,24.94,24.906451999999998,23.354779411764707,24.4825,19.0675,22.245,19.0675,22.8675,14.68,24.2875,16.1975,20.731970250000007,22.070817999999996,22.962299999999992,24.37312500000003,23.2233153067192,24.191785518896086,24.438076923076927,25.030507230065904,23.84564661608795,20.731970250000007,22.070817999999996,22.962299999999992,24.37312500000003,24.888416666666668,3703536,3455389.6,64.76171089709536,2.047421027732878,1.5,2.75,NaN,NaN,0.49668515846454586,1.071814304239383,654.0999217529835,-0.031933901308382695,0.511731910725505,0.5436658120338876,21.563497218717846,1.9936611798384651,62.07564855855516,11.37304179424199,26.551309647202856,4941531844
1471008600,24.81,24.945,24.707275,24.86,25.096263,23.36544117647059,24.4825,19.0675,22.245,19.0675,22.8675,14.68,24.2875,16.1975,20.748745250000006,22.113142999999994,23.012149999999988,24.415000000000028,23.287499020181194,24.255424993286937,24.480576923076928,25.107695344742964,23.85345850141089,20.748745250000006,22.113142999999994,23.012149999999988,24.415000000000028,24.837425,3075228,3430619.2,63.27692967683459,1.3315587374931204,1.5,2.75,NaN,NaN,0.478188004288507,0.8964061065127834,653.3017383315862,-0.031691021888353266,0.5040520346734461,0.5357430565617993,21.70569348879017,2.0839749512370407,28.29538549327701,38.65599980291717,33.04861470380583,4938456616
1471267800,25.0025,25.215,25.0025,25.1025,25.286074,23.376102941176473,24.4825,19.0675,22.245,19.0675,22.8675,14.68,24.2875,16.1975,20.76305775000001,22.161867999999995,23.07054999999999,24.45862500000003,23.358675529193697,24.336098803450085,24.546923076923083,25.237483478799017,23.856362675047148,20.76305775000001,22.161867999999995,23.07054999999999,24.45862500000003,25.106666666666662,1999792,3373833.6,65.83401126398951,2.2010626586850197,1.5,2.75,NaN,NaN,0.46938886112504224,0.592735812459749,656.6352799917429,-0.019285977745463256,0.5116355843799703,0.5309215621254335,21.812607698426593,5.031380753138078,49.55445814760906,19.543473772292426,30.902068080098516,4940456408
1471354200,24.9075,24.935,24.6925,24.7025,25.475884999999998,23.386764705882353,24.4825,19.0675,22.245,19.0675,22.8675,14.68,24.2875,16.1975,20.77550775000001,22.206892999999994,23.11449999999999,24.487125000000027,23.411374528048846,24.37099415550246,24.57634615384616,25.25826543449853,23.89442687319379,20.77550775000001,22.206892999999994,23.11449999999999,24.487125000000027,24.776666666666667,2612564,3220552.4,58.58728427925207,0.7518105023014344,1.5,2.75,NaN,NaN,0.46514679961611066,0.8112161131115271,653.2618544330563,-0.04086710964531759,0.4798376750687865,0.5207047847141041,20.86470316823173,2.4574865201161393,24.60458627098764,43.07017989322243,32.32523383578994,4937843844
1471440600,24.7,24.87975,24.365,24.815,25.665695999999997,23.397426470588236,24.4825,19.0675,22.245,19.0675,22.8675,14.68,24.2875,16.1975,20.79005775000001,22.252799999999997,23.15874999999999,24.50525000000003,23.466418664203793,24.413280426406985,24.604230769230774,25.29322218543103,23.91523935303052,20.79005775000001,22.252799999999997,23.15874999999999,24.50525000000003,24.68658333333333,5244648,3334602.2,59.923446425057165,0.4745153757054688,1.5,2.75,NaN,NaN,0.46868988535781725,1.5727956995889945,654.2510433046355,-0.049819102555800354,0.4584309065193537,0.508250009075154,20.601673447045627,2.626137303556665,58.37981169739166,13.61986501813773,28.00032328447062,4943088492
1471527000,24.8025,25,24.765875,25,25.855507,23.40808823529412,24.4825,19.0675,22.245,19.0675,22.8675,14.68,24.2875,16.1975,20.80168275000001,22.294799999999995,23.20239999999999,24.547375000000027,23.52655910874482,24.469158481034892,24.654038461538466,25.356521799587625,23.951555123489307,20.80168275000001,22.294799999999995,23.20239999999999,24.547375000000027,24.921958333333336,1747512,3274669,62.08959275741535,0.9695730040110817,1.5,2.75,NaN,NaN,0.4519352506894016,0.5336453852282474,657.8115325032335,-0.04564578911511513,0.4511927726812601,0.49683856179637526,20.765870101098884,0.8776354282255671,51.826061186892204,17.91597781713354,30.257960995974262,4944836004
1471613400,24.8,24.9425,24.6075,24.875,26.045317999999998,23.418750000000003,24.4825,19.0675,22.245,19.0675,22.8675,14.68,24.2875,16.1975,20.811720250000008,22.332824999999993,23.245149999999988,24.56700000000003,23.579439143696003,24.507810054269665,24.72903846153847,25.286765781394337,24.1713111416826,20.811720250000008,22.332824999999993,23.245149999999988,24.56700000000003,24.808333333333334,2481520,3273559.8,59.74003635279252,0.6350587094335457,1.5,2.75,NaN,NaN,0.4476898756401585,0.7580493870923024,655.6296333853355,-0.05314399971648115,0.43040856215077383,0.483552561867255,16.105411089017156,0.5558362809499718,55.551321306080936,15.40253099885756,29.046147695061514,4942354484
1471872600,24.78,24.955,24.6275,24.865,26.235129,23.429411764705883,25.1025,19.0675,22.245,19.0675,22.8675,14.68,24.2875,16.1975,20.82265775000001,22.37249999999999,23.30044999999999,24.595750000000024,23.62985329492361,24.54182814433922,24.78711538461539,25.21763316837139,24.35659760085939,20.82265775000001,22.37249999999999,23.30044999999999,24.595750000000024,24.81583333333333,3160872,3222695.6,59.545905911729484,0.43008584723170495,1.5,2.75,NaN,NaN,0.4391048845230041,0.9808161838182917,655.2978326271699,-0.06010446961816923,0.40842197484454346,0.4685264444627127,16.055516106642973,0.3632694248234101,29.608431814322504,37.28565313348686,33.105915052190646,4939193612
1471959000,25.1125,25.2275,24.9925,24.9975,26.42494,25.2275,25.1025,19.0675,22.245,19.0675,22.8675,14.68,24.2875,16.1975,20.83469525000001,22.409449999999993,23.36894999999999,24.630250000000025,23.683486499044253,24.585225463925962,24.850000000000005,25.114073125070725,24.585926874929285,20.83469525000001,22.409449999999993,23.36894999999999,24.630250000000025,25.0725,2219872,3171083.4,61.338600436351044,1.193767942405439,1.5,2.75,NaN,NaN,0.4336331070570753,0.7000358300257887,658.4615876420837,-0.05713200739502755,0.3971114352189282,0.4542434426139558,16.287988521992077,1.6261815225124447,52.08188194012513,17.681624273445696,30.23649378642916,4941413484
1472045400,24.965,24.9975,24.4625,24.655,26.614751,25.27188679245283,25.1025,19.0675,22.245,19.0675,22.8675,14.68,24.2875,16.1975,20.845182750000006,22.444899999999993,23.43334999999999,24.65100000000002,23.721585067709185,24.591870657837774,24.84019230769231,25.122411954411106,24.557972660973512,20.845182750000006,22.444899999999993,23.43334999999999,24.65100000000002,24.705,2969036,3097715.6,54.60281526057861,0.3434943084177079,1.5,2.75,NaN,NaN,0.44087359941014137,0.9584598405353932,654.9110407857919,-0.07827277204233496,0.35640247756103705,0.434675249603372,17.849876946548246,-1.1427425821972739,13.80179140623698,58.005890089804176,28.19231850395884,4938444448
1472131800,24.4775,24.74,24.42,24.565,26.804561999999997,25.31627358490566,25.1025,19.0675,22.245,19.0675,22.8675,14.68,24.2875,16.1975,20.858395250000008,22.485699999999994,23.497799999999994,24.663250000000026,23.75466016309314,24.589311547567508,24.826923076923077,25.14156667167113,24.512279482175025,20.858395250000008,22.485699999999994,23.497799999999994,24.663250000000026,24.575,2613572,3076630.8,52.95713498555159,0.8556949884971656,1.5,2.75,NaN,NaN,0.4322397708808453,0.8494915932064387,656.7805963734218,-0.09712664673054039,0.3132669411901965,0.4103935879207369,15.669285034543082,-1.1866452131938783,3.5135541752753316,79.80215843635712,16.684287388367554,4935830876
1472218200,24.6375,25.0425,24.0825,24.4275,26.994373,25.36066037735849,25.1025,19.0675,22.245,19.0675,22.8675,14.68,24.2875,16.1975,20.870220250000006,22.51857499999999,23.555099999999992,24.662000000000024,23.78104603905027,24.57390092398965,24.80019230769231,25.18019464340609,24.42018997197853,20.870220250000006,22.51857499999999,23.555099999999992,24.662000000000024,24.5175,7179076,3268845.4,50.45517138823239,1.434981286536997,1.5,2.75,NaN,NaN,0.4699369301036421,2.1962115430726703,654.4342666527954,-0.11636875958783427,0.26493263843594406,0.3813013980237783,15.823842489046045,-2.688975201673143,1.8941620413166866,85.4309752864486,12.67486267223472,4928651800
1472477400,24.4925,24.8925,24.475,24.785,27.184184,25.40504716981132,25.1025,19.0675,22.245,19.0675,22.8675,14.68,24.2875,16.1975,20.885145250000004,22.56257499999999,23.624849999999995,24.68362500000002,23.820416782616928,24.5940055978954,24.814615384615387,25.176553788607038,24.452676980623735,20.885145250000004,22.56257499999999,23.624849999999995,24.68362500000002,24.7175,2393488,3211009.8,56.24354630842275,0.43828123023958154,1.5,2.75,NaN,NaN,0.46958429223909626,0.7454004033248357,658.1939763047055,-0.10299053772419764,0.2525632258685313,0.35555376359272894,17.273604260420672,0.33397429409978574,8.861917586690485,66.8082786795045,24.32980373380503,4931045288
1472563800,24.7575,24.8625,24.45,24.6575,27.373994999999997,25.44943396226415,25.1025,19.0675,22.245,19.0675,22.8675,14.68,24.2875,16.1975,20.903845250000007,22.603549999999988,23.684199999999997,24.72150000000002,23.85324357545548,24.600052683810123,24.79288461538462,25.15602183332469,24.429747397444547,20.903845250000007,22.603549999999988,23.684199999999997,24.72150000000002,24.656666666666666,4769132,3209419,53.82815957841726,0.39634166059185244,1.5,2.75,NaN,NaN,0.4655068427934466,1.485979861152439,657.3110677256017,-0.10058466119819076,0.22982293709499046,0.3304075982931812,14.822338265608908,-0.6346967559943679,1.6187300210193198,86.54620016921427,11.835069809766404,4926276156
1472650200,24.545,24.58,24.150025,24.4525,27.563806,25.49382075471698,25.1025,19.0675,22.245,19.0675,22.8675,14.68,24.2875,16.1975,20.92505775000001,22.644099999999984,23.7355,24.73862500000002,23.876743827398403,24.58600004725678,24.761538461538464,25.16428164398345,24.358795279093478,20.92505775000001,22.644099999999984,23.7355,24.73862500000002,24.394175,4132828,3204442.2,50.1025114496775,1.0864616520497243,1.5,2.75,NaN,NaN,0.46850456830820036,1.2897183790676578,654.7309237650555,-0.10989877433998735,0.19303413036819705,0.3029329047081844,15.159922311313176,-2.1899999999999977,1.4410173645688655,87.34127828017384,11.21770435525729,4922143328
1472736600,24.4525,24.575,24,24.46,27.753617,25.53820754716981,25.1025,19.0675,22.245,19.0675,22.8675,14.68,24.2875,16.1975,20.94170775000001,22.678849999999983,23.789599999999997,24.75262500000002,23.89961661848082,24.574000042756133,24.712115384615384,25.092428242434423,24.331802526796345,20.94170775000001,22.678849999999983,23.789599999999997,24.75262500000002,24.345,4662460,3277025.4,50.23821161282375,1.1704545104571735,1.5,2.75,NaN,NaN,0.47611138485761456,1.422772005368039,653.488057944802,-0.11225875365168342,0.16260946264358012,0.27486821629526353,14.149941739912311,-1.6683417085427101,11.712459361563099,61.46004685145328,26.827493786983638,4926805788
1472823000,24.77,24.9525,24.5625,24.7775,27.943427999999997,25.58259433962264,25.1025,19.0675,22.245,19.0675,22.8675,14.68,24.2875,16.1975,20.96029525000001,22.710624999999986,23.832699999999996,24.75237500000002,23.934043417756083,24.59338099106507,24.717884615384612,25.09971142949846,24.336057801270766,20.96029525000001,22.710624999999986,23.832699999999996,24.75237500000002,24.764166666666668,4949480,3338809.2,55.727351915098055,0.45196974623851827,1.5,2.75,NaN,NaN,0.4772820002249278,1.4824087581883982,657.8874713954426,-0.09009696639677389,0.16224700829929617,0.25234397469607006,16.38907487843257,-0.35190026141161707,43.50143655098909,24.113643477255817,32.384919971755096,4931755268
1473168600,24.905,25.025,24.6075,25.0125,28.133239,25.62698113207547,25.1025,19.0675,22.245,19.0675,22.8675,14.68,24.2875,16.1975,20.975045250000008,22.744574999999987,23.929299999999998,24.76612500000002,23.97633583274604,24.633297087154112,24.733076923076922,25.14377592312325,24.322377923030594,20.975045250000008,22.744574999999987,23.929299999999998,24.76612500000002,24.881666666666664,4488324,3468624.8,59.305458908357814,0.8415092379793768,1.5,2.75,NaN,NaN,0.47301185735171847,1.2939779476869335,660.1235393729424,-0.05878677648579664,0.17886050408882426,0.2376472805746209,17.330707361549248,0.06000600060006228,50.07264092872389,19.05210439637641,30.875254674899693,4936243592
1473255000,24.94,25.0675,24.755,25.0075,28.32305,25.6713679245283,25.1025,19.0675,22.245,19.0675,22.8675,14.68,24.2875,16.1975,20.99007025000001,22.77932499999999,24.048099999999994,24.77775000000002,24.01677364322659,24.6689354598061,24.733653846153842,25.14586932091569,24.321438371391995,20.99007025000001,22.77932499999999,24.048099999999994,24.77775000000002,24.94333333333333,3725784,3530236.6,59.195837388911755,0.8393216288436511,1.5,2.75,NaN,NaN,0.4615467246837386,1.0553921513362587,662.7602761729247,-0.03856612927806152,0.18943961897704398,0.2280057482551055,17.068376186356957,1.4297302778341072,54.11324531576466,16.24690723220456,29.63984745203077,4932517808
1473341400,24.865,24.97,24.7025,24.8225,28.512860999999997,25.71575471698113,25.1025,19.0675,22.245,19.0675,22.8675,14.68,24.2875,16.1975,21.00280775000001,22.80767499999999,24.143349999999995,24.78900000000002,24.04837075525692,24.68356065411028,24.729615384615382,25.137215519333814,24.32201524989695,21.00280775000001,22.80767499999999,24.143349999999995,24.78900000000002,24.831666666666667,3178372,3565354.8,55.135005801049736,0.35185764517929524,1.5,2.75,NaN,NaN,0.4503648157777573,0.8914602271841221,660.9603919173868,-0.03775547181366937,0.1808114084880188,0.21856688030168817,15.502093235112156,1.0482393649501334,58.11022771545091,13.692519548638586,28.197252735910503,4929339436
1473427800,24.3025,24.31,23.0225,23.025,28.702672,25.76014150943396,25.1025,19.0675,22.245,19.0675,22.8675,14.68,24.2875,16.1975,21.00713275000001,22.81602499999999,24.180799999999998,24.69325000000002,24.008238568776257,24.525602496575967,24.58807692307692,25.575209822410514,23.600944023743324,21.00713275000001,22.81602499999999,24.180799999999998,24.69325000000002,23.452499999999997,8130812,3786718.6,32.09622106990055,4.980733370624796,1.5,2.75,NaN,NaN,0.5467673289364889,2.147192030588172,650.8315917617616,-0.15197304643881868,0.028600572253164813,0.1805736186919835,46.33091924212226,-5.741479889468836,20.955428442662893,47.50494724508116,31.539624312255935,4921208624
1473687000,22.755,24.175,22.71,24.03,22.71,25.80452830188679,25.1025,19.0675,22.245,19.0675,22.8675,14.68,24.2875,16.1975,21.015982750000006,22.833874999999992,24.2216,24.65175000000002,24.009091958236013,24.478402258806828,24.513653846153844,25.511916982777063,23.515390709530624,21.015982750000006,22.833874999999992,24.2216,24.65175000000002,23.638333333333335,8086652,4037289.8,45.74650560172431,3.3430852495992416,1.5,2.75,NaN,NaN,0.6123553768695968,2.0029902237882453,654.8871272900307,-0.15310523431025141,-0.010807924195830765,0.14229731011442065,54.262525297932356,-3.0461972967520636,27.040930940130956,40.10210601651725,32.85696304335181,4929295276
1473773400,23.5325,23.62,22.7475,22.985,22.679008035714286,25.84891509433962,25.1025,19.0675,22.245,19.0675,22.8675,14.68,24.2875,16.1975,21.019670250000004,22.844799999999996,24.238999999999997,24.54587500000002,23.96893148928558,24.336173472253797,24.385192307692304,25.66713713660605,23.103247478778556,21.019670250000004,22.844799999999996,24.238999999999997,24.54587500000002,23.117499999999996,9060356,4390318,37.34092457123223,5.365636009779067,1.5,2.75,NaN,NaN,0.6602228499503402,2.0637129246674157,646.7730754145595,-0.21377559446060146,-0.12492218296133117,0.08885341149927029,58.23434003521964,-6.782926087397342,7.553107614107115,69.57407936613888,22.872813019754002,4920234920
1473859800,23,23.455,22.7375,22.9425,22.64801607142857,25.89330188679245,25.1025,19.0675,22.245,19.0675,22.8675,14.68,24.2875,16.1975,21.022745250000003,22.855199999999996,24.263999999999996,24.457875000000023,23.92867927401948,24.203442665372485,24.26038461538461,25.74751122806094,22.77325800270828,21.022745250000003,22.855199999999996,24.263999999999996,24.457875000000023,23.044999999999998,5171476,4518263.6,37.04281826898941,4.808601396809026,1.5,2.75,NaN,NaN,0.6643140749538871,1.1445715562057956,645.7930774351718,-0.24411844121786555,-0.21629464002306165,0.027823801194803897,58.314499363058424,-6.175237705756064,7.031864287921109,70.7179747570061,22.250160955072793,4915063444
1473946200,22.89,23.785,22.8325,23.6375,22.617024107142857,25.937688679245284,25.1025,19.0675,22.245,19.0675,22.8675,14.68,24.2875,16.1975,21.030732750000002,22.87377499999999,24.295649999999995,24.399000000000026,23.917260478959893,24.14954336390844,24.199615384615377,25.718681198444905,22.68054957078585,21.030732750000002,22.87377499999999,24.295649999999995,24.399000000000026,23.418333333333333,5913608,4551711.6,44.80316027550107,2.4198878274726585,1.5,2.75,NaN,NaN,0.6848987838857523,1.2992053362959113,649.646450613114,-0.20624004558257342,-0.22997625578341285,-0.02373621020083945,62.031982208688454,-3.3626328699918298,19.407954960552292,49.62644608863222,30.96559895081549,4920977052
1474032600,23.4,23.465,23.0975,23.3475,22.586032142857142,25.982075471698113,25.1025,19.0675,22.245,19.0675,22.8675,14.68,24.2875,16.1975,21.03404525,22.88824999999999,24.322599999999998,24.31637500000003,23.894916930765387,24.073158281631446,24.089038461538454,25.630670387155863,22.547406535921045,21.03404525,22.88824999999999,24.322599999999998,24.31637500000003,23.30333333333333,4321672,4680419.6,42.45174668690382,2.5491701944104057,1.5,2.75,NaN,NaN,0.6745488707510557,0.9233514020836936,646.2582357438945,-0.18997788104945096,-0.26120856151265315,-0.07123068046320219,62.18042957332986,-5.7713651498335174,24.40117738359877,43.202655999394736,32.396166617006486,4916655380
1474291800,23.62,23.855,23.25,23.3675,22.55504017857143,26.026462264150943,25.1025,19.0675,22.245,19.0675,22.8675,14.68,24.2875,16.1975,21.04105775,22.901899999999987,24.3298,24.241000000000028,23.874233913872626,24.00595273099988,23.98980769230769,25.538355972196932,22.441259412418447,21.04105775,22.901899999999987,24.3298,24.241000000000028,23.49083333333333,6420804,4877383.8,42.675196312867946,1.5279297071768754,1.5,2.75,NaN,NaN,0.6695810942688375,1.3164442790005577,649.8842152353874,-0.167900367128999,-0.28110613937445095,-0.11320577224545195,61.31685511630895,-6.576711644177909,21.633121945503763,46.613206854279255,31.753671200216974,4923076184
1474378200,23.6975,23.75525,23.3659,23.3775,22.524048214285717,26.070849056603773,25.1025,19.0675,25.1025,19.0675,22.245,14.68,22.8675,16.1975,21.052720249999997,22.92159999999999,24.332400000000003,24.166625000000028,23.854754152544288,23.94610008995227,23.90711538461538,25.46279461563394,22.351436153596822,21.052720249999997,22.92159999999999,24.332400000000003,24.166625000000028,23.49955,3504636,4894572,42.79479810736416,1.1100487256444327,1.5,2.75,NaN,NaN,0.6495645875353491,0.7160250171005759,648.4435104592098,-0.14359074237441571,-0.2926942002134716,-0.14910345783905588,60.710711396864674,-6.518044586624008,51.75461003288135,17.851294211828424,30.394095755290245,4926580820
1474464600,23.64,24.226975,23.3825,24.145,22.493056250000002,26.115235849056603,25.1025,19.0675,25.1025,19.0675,22.245,14.68,22.8675,16.1975,21.06213275,22.95244999999999,24.340600000000006,24.124000000000027,23.86613634264059,23.965042938528246,23.88288461538461,25.412964862342324,22.3528043684269,21.06213275,22.95244999999999,24.340600000000006,24.124000000000027,23.918158333333334,6676204,5117388.6,51.208751771871086,0.43061177310190724,1.5,2.75,NaN,NaN,0.6638439027113954,1.3046114965746398,654.0501835019952,-0.07048727180238776,-0.23721254759204058,-0.16672527578965282,64.71858010235714,-2.7293785879746277,81.71846035519543,2.896712339464393,15.384827305340163,4933257024
1474551000,24.5625,24.73,24.46,24.6,22.462064285714288,26.159622641509433,25.1025,19.0675,25.1025,19.0675,22.245,14.68,22.8675,16.1975,21.075907750000002,22.98292499999999,24.357700000000005,24.121250000000025,23.894915309595863,24.025515039620792,23.86923076923077,25.3700220792446,22.368439459216944,21.075907750000002,22.98292499999999,24.357700000000005,24.121250000000025,24.596666666666664,4320856,5184979.6,55.39712295059857,2.8069740750622896,1.5,2.75,NaN,NaN,0.6582121953748672,0.833340983636657,659.559129394676,0.009584666116521784,-0.1547444431440006,-0.16432910926052238,65.86039305859353,6.84039087947884,80.56391760822919,3.2516012337749616,16.184481157995855,4937577880
1474637400,24.455,24.5025,24.1725,24.1975,22.431072321428573,26.204009433962263,25.1025,19.0675,25.1025,19.0675,22.245,14.68,22.8675,16.1975,21.09017025,23.014899999999994,24.359150000000003,24.102875000000026,23.906781375886222,24.041894559656907,23.806538461538462,25.173153508430065,22.43992341464686,21.09017025,23.014899999999994,24.359150000000003,24.102875000000026,24.290833333333335,3593184,5233960.2,51.20927386699343,1.3458631868690833,1.5,2.75,NaN,NaN,0.6417327528480911,0.6865134358492064,656.2993345198008,0.03508130895199141,-0.12047747307053314,-0.15555878202252454,47.8268091264908,0.69704535996671,83.12023141510745,2.491030156941185,14.388738427951361,4933984696
1474896600,23.89,23.945,23.5425,23.625,22.40008035714286,26.248396226415093,25.1025,19.0675,25.1025,19.0675,22.245,14.68,22.8675,16.1975,21.10358275,23.04469999999999,24.351200000000002,24.062750000000026,23.89573112585147,24.002190315880057,23.70019230769231,24.87864543580048,22.521739179584138,21.10358275,23.04469999999999,24.351200000000002,24.062750000000026,23.704166666666666,6629148,5206463.8,45.89478565516862,1.1616515835652819,1.5,2.75,NaN,NaN,0.6426804133589418,1.273253450835479,652.1555376339027,0.014105677731362537,-0.13792668485832138,-0.15203236258968392,43.70307874721489,2.7844246247552777,45.706237931000594,22.33993427574769,31.953827793251723,4927355548
1474983000,23.5575,24.0875,23.4125,24.055,22.369088392857144,26.292783018867922,25.1025,19.0675,25.1025,19.0675,22.245,14.68,22.8675,16.1975,21.11843275,23.07902499999999,24.347700000000003,24.026250000000026,23.90197696405337,24.007219809605765,23.64115384615385,24.654062102658195,22.628245589649502,21.11843275,23.07902499999999,24.347700000000003,24.026250000000026,23.85166666666667,3959152,5284747,50.084869284394394,0.635804463392357,1.5,2.75,NaN,NaN,0.6449889552618744,0.7491658541080586,654.4180688754655,0.029046760983474335,-0.11572391136034099,-0.14477067234381533,35.24424646441497,4.849079219788606,47.013917612284814,21.323904182727038,31.662178204988138,4931314700
1475069400,24.1475,24.4625,23.7625,24.415,22.33809642857143,26.337169811320752,25.1025,19.0675,25.1025,19.0675,22.245,14.68,22.8675,16.1975,21.141207750000003,23.114649999999994,24.353350000000006,24.014125000000025,23.922095514482653,24.04605601821474,23.74807692307693,24.771647509583854,22.724506336570006,21.141207750000003,23.114649999999994,24.353350000000006,24.014125000000025,24.213333333333328,4882664,5290423.6,53.34265363261337,1.0937076560129584,1.5,2.75,NaN,NaN,0.6489183156003119,0.9229249620011525,659.4131484215919,0.06118306886059324,-0.06829183626807378,-0.12947490512866702,35.43691021541842,3.2892649391856157,42.70382357040381,24.77191793151788,32.52425849807831,4936197364
1475155800,24.33,24.4775,23.545,23.7275,22.307104464285715,26.381556603773582,25.1025,19.0675,25.1025,19.0675,22.245,14.68,22.8675,16.1975,21.158907750000004,23.142774999999993,24.33885,23.977875000000026,23.914464317836273,24.015717349813336,23.724807692307703,24.735354881360138,22.714260503255268,21.158907750000004,23.142774999999993,24.33885,23.977875000000026,23.916666666666668,8038828,5485723.6,47.02989718567288,0.317348500399245,1.5,2.75,NaN,NaN,0.6691741502002895,1.4654088660245297,653.9591808096726,0.03542392060516006,-0.08519500437221694,-0.120618924977377,37.0026344664717,1.6275832530249448,13.971887588021838,57.648012626224784,28.38009978575338,4928158536
1475242200,24.05,24.5375,23.9625,24.295,22.276112500000004,26.425943396226415,25.1025,19.0675,25.1025,19.0675,22.245,14.68,22.8675,16.1975,21.176432750000004,23.169199999999993,24.341600000000003,23.96962500000003,23.929387285764264,24.04231569745016,23.825576923076934,24.78067891893141,22.870474927222457,21.176432750000004,23.169199999999993,24.341600000000003,23.96962500000003,24.265,5385568,5521879,52.07199867123161,1.669115400872679,1.5,2.75,NaN,NaN,0.6792331394716975,0.9753143812097295,657.9110517527346,0.054737788994326464,-0.05219668873446892,-0.10693447772879539,38.213192272192515,3.9691879747512657,33.035780988515526,33.63207100773177,33.332148003752685,4933544104
1475501400,24.105,24.1725,23.8475,24.065,22.24512053571429,26.470330188679245,25.1025,19.0675,25.1025,19.0675,22.245,14.68,22.8675,16.1975,21.188370250000002,23.198849999999993,24.333250000000003,23.93400000000003,23.934705431420568,24.044476107216813,23.911923076923088,24.72438172402732,23.099464429818855,21.188370250000002,23.198849999999993,24.333250000000003,23.93400000000003,24.028333333333332,3845888,5466699.4,49.99491838362631,0.03552496294566102,1.5,2.75,NaN,NaN,0.6626807723665763,0.7035118850690784,655.3425108055425,0.050270740723254465,-0.04409605182472731,-0.09436679254798178,38.97680185072378,2.940861939899476,40.11164468488086,26.987060705987297,32.90129460913184,4929698216
1475587800,24.135,24.2225,23.4905,23.7475,22.214128571428574,26.514716981132075,25.1025,19.0675,25.1025,19.0675,22.245,14.68,22.8675,16.1975,21.203507750000004,23.225524999999994,24.322400000000002,23.87075000000003,23.927364041953094,24.016192668434257,23.920384615384627,24.723472037950827,23.117297192818427,21.203507750000004,23.225524999999994,24.322400000000002,23.87075000000003,23.820166666666665,5207584,5502662.4,47.196215537473726,1.227601008506374,1.5,2.75,NaN,NaN,0.6676321457689636,0.946375340053571,651.3358496851913,0.02543382188339785,-0.06257451519373447,-0.08800833707713232,40.07595453907458,-1.646303582522265,18.959113295606837,50.19272127124312,30.848165433150022,4924490632
1475674200,23.965,24.205,23.9375,24.0225,22.18313660714286,26.559103773584905,25.1025,19.0675,25.1025,19.0675,22.245,14.68,22.8675,16.1975,21.225932750000002,23.260524999999994,24.316700000000004,23.82150000000003,23.931094863837288,24.016793366678613,23.9723076923077,24.704694363872928,23.239921020742475,21.225932750000002,23.260524999999994,24.316700000000004,23.82150000000003,24.054999999999996,3939272,5513336.8,49.816597934134194,0.430354374469233,1.5,2.75,NaN,NaN,0.6526227067854661,0.7144987043055305,654.1601142953572,0.026885452114803976,-0.05440152193362735,-0.08128697404843133,35.80007725692737,-2.3475609756097584,16.500195285087173,53.72587010426808,29.77393461064473,4928429904
1475760600,23.945,24.1625,23.7325,24.09,22.152144642857145,26.603490566037735,25.1025,19.0675,25.1025,19.0675,22.245,14.68,22.8675,16.1975,21.246007750000004,23.290249999999997,24.313700000000004,23.784875000000028,23.937326437804455,24.023765426994935,24.02788461538462,24.672667960493797,23.383101270275446,21.246007750000004,23.290249999999997,24.313700000000004,23.784875000000028,23.995,2600732,5484454.8,50.466361885040435,0.38064159822439175,1.5,2.75,NaN,NaN,0.6367210848722185,0.47420064433751924,652.3744269640242,0.031434696128911546,-0.0419936038872919,-0.07342830001620344,33.79687116896965,-0.444260770740786,43.23181675007514,24.33375404111836,32.434429208806485,4931030636
1475847000,24.1825,24.2525,23.55,23.8425,22.12115267857143,26.647877358490565,25.1025,19.0675,25.1025,19.0675,22.245,14.68,22.8675,16.1975,21.262120250000002,23.322999999999997,24.304150000000003,23.825750000000028,23.933607753968985,24.006502052995415,24.063653846153848,24.603142975525387,23.52416471678231,21.262120250000002,23.322999999999997,24.304150000000003,23.825750000000028,23.88166666666667,5418416,5348835,48.01166219085577,0.42575843587407114,1.5,2.75,NaN,NaN,0.6414195788099172,1.013008627112259,649.2949248397624,0.017512775429150695,-0.051537330729765074,-0.06905010615891577,33.013108455087654,0.9206349206349255,12.475153924153284,60.13515504690949,27.389691028937232,4925612220
1476106200,24.19,24.38,24.1375,24.1875,22.090160714285716,26.692264150943394,25.1025,19.0675,25.1025,19.0675,22.245,14.68,22.8675,16.1975,21.27622025,23.359199999999998,24.29885,23.83362500000003,23.94356431263687,24.023739952710137,24.066923076923082,24.60885393344856,23.524992220397603,21.27622025,23.359199999999998,24.29885,23.83362500000003,24.235,4122592,5150632,51.54938832857401,0.935800599687485,1.5,2.75,NaN,NaN,0.6339967517520658,0.800405076503233,653.1664734819583,0.030515347274920092,-0.030905922065265656,-0.06142126934018575,30.719760045478214,0.5508210351278332,32.70209887538991,34.011936448289454,33.28596467632065,4929734812
1476192600,24.0375,24.05,23,23.305,22.05916875,26.736650943396224,25.1025,19.0675,25.1025,19.0675,22.245,14.68,22.8675,16.1975,21.286499000000003,23.388749999999995,24.277900000000002,23.849625000000028,23.918522574886403,23.955288528642505,23.967307692307696,24.55483007007615,23.37978531453924,21.286499000000003,23.388749999999995,24.277900000000002,23.849625000000028,23.451666666666664,8120132,5103620.8,43.411631814249375,2.83148819933119,1.5,2.75,NaN,NaN,0.6735326980554897,1.591053159748859,647.8618301851542,-0.018693679853002118,-0.08478836915643839,-0.06609468930343627,36.23223328745954,-4.5463854187999155,25.437262030821245,41.95694503830311,32.60579293087563,4921614680
1476279000,23.3325,23.57,23.1525,23.385,22.028176785714287,26.781037735849054,25.1025,19.0675,25.1025,19.0675,22.245,14.68,22.8675,16.1975,21.297861500000003,23.415575,24.2676,23.871750000000027,23.89760012096929,23.900975335438456,23.904807692307696,24.55101693901695,23.25859844559844,21.297861500000003,23.415575,24.2676,23.871750000000027,23.369166666666672,5792924,5134693.2,44.27049953653264,1.9851683759914436,1.5,2.75,NaN,NaN,0.6552446481943832,1.128192819777431,647.6766661651997,-0.04284900536034465,-0.11965594600386709,-0.07680694064352243,34.71781507827683,-1.443472763670836,29.992302015294268,36.83436285207894,33.173335132626804,4927407604
1476365400,22.87,23.3325,22.555,23.155,21.997184821428572,26.825424528301884,25.1025,19.0675,25.1025,19.0675,22.245,14.68,22.8675,16.1975,21.304599000000003,23.440725,24.248500000000003,23.84762500000003,23.868478547597945,23.8299300653967,23.868653846153848,24.61782419595271,23.119483496354984,21.304599000000003,23.440725,24.248500000000003,23.84762500000003,23.014166666666668,5972132,5137619.4,42.28352269605719,3.1194885903611977,1.5,2.75,NaN,NaN,0.667727173323356,1.1624317675225222,643.9780177634183,-0.06972070821768393,-0.16395782591562735,-0.09423711769794342,31.452195827304493,-4.692323523358718,14.162740796374232,57.384278409240856,28.45298079438492,4921435472
1476451800,23.5125,23.685,23.145,23.165,21.96619285714286,26.869811320754714,25.1025,19.0675,25.1025,19.0675,22.245,14.68,22.8675,16.1975,21.313699,23.457975,24.2282,23.83850000000003,23.840891153574496,23.766603392501775,23.80019230769231,24.627338610299752,22.973046005084868,21.313699,23.457975,24.2282,23.83850000000003,23.33166666666667,5942148,5218643.2,42.404561137231745,1.7005534179352835,1.5,2.75,NaN,NaN,0.658603803800259,1.1386384874903883,644.9024340411554,-0.08141117779254338,-0.19600108993862264,-0.11458991214607926,26.914228998547035,-3.7398711822148436,36.52366101304335,30.283330121002198,33.193008865954454,4927377620
1476711000,23.1525,23.25,22.858075,22.935,21.935200892857146,26.914198113207547,25.1025,19.0675,25.1025,19.0675,22.245,14.68,22.8675,16.1975,21.324774,23.468850000000003,24.19125,23.81687500000003,23.805366010297064,23.68740306940637,23.686346153846156,24.55026080281911,22.8224315048732,21.324774,23.468850000000003,24.19125,23.81687500000003,23.014358333333334,4492340,5122220,40.310661095179015,2.615170790234982,1.5,2.75,NaN,NaN,0.6395553178145262,0.8770298815747859,642.4810381844775,-0.09810419749686963,-0.2372201590171663,-0.13911596152029668,26.945572747150834,-3.4214127802926626,20.2685922106759,48.42177111372779,31.309636675596288,4922885280
1476797400,23.5275,23.5475,23.215,23.3325,21.904208928571432,26.958584905660377,25.1025,19.0675,25.1025,19.0675,22.245,14.68,22.8675,16.1975,21.342374000000003,23.483325,24.16315,23.814625000000028,23.786822245187373,23.653602777081954,23.655961538461536,24.539511063566728,22.772412013356345,21.342374000000003,23.483325,24.16315,23.814625000000028,23.365,5958084,5244892.4,45.33465862966047,0.6670971020626617,1.5,2.75,NaN,NaN,0.6376227951134886,1.1359783091069704,646.7145027493725,-0.07678845967391787,-0.23510153611269402,-0.15831307643877615,29.026416403409744,-2.872307211988766,52.53969022793662,17.315699466239426,30.144610305823953,4928843364
1476883800,23.445,23.65,23.323725,23.525,21.873216964285717,27.002971698113207,25.1025,19.0675,25.1025,19.0675,22.245,14.68,22.8675,16.1975,21.360274000000004,23.497049999999998,24.13815,23.78362500000003,23.776554706160418,23.64135489355034,23.596730769230764,24.40062844884549,22.792833089616035,21.360274000000004,23.497049999999998,24.13815,23.78362500000003,23.499575000000004,2146176,5018391,47.63337565444263,0.3268120889188361,1.5,2.75,NaN,NaN,0.6153836668910965,0.42766217299528875,650.5796061619922,-0.04567457983445189,-0.215406301231841,-0.16973172139738912,28.533278998297373,-2.3453715234537205,44.5274732421773,23.288924938640722,32.18360181918199,4930989540
1476970200,23.4025,23.615,23.15,23.4,21.842225000000003,27.047358490566037,25.1025,19.0675,25.1025,19.0675,22.245,14.68,22.8675,16.1975,21.381511500000002,23.51055,24.1142,23.723625000000027,23.76178785493844,23.618368713212213,23.545576923076915,24.30730106516449,22.78385278098934,21.381511500000002,23.51055,24.1142,23.723625000000027,23.388333333333332,4296468,5017171.6,46.27267675540555,0.4940765912142371,1.5,2.75,NaN,NaN,0.6046419763988753,0.8563526111006449,648.7472131273032,-0.030208462050667156,-0.20749229896072308,-0.17728383691005592,28.40412306717367,-1.8559295375904479,50.45619673924457,18.77957458560361,30.764228675151838,4926693072
1477056600,23.1025,23.4625,23.03605,23.43,21.811233035714288,27.091745283018867,25.1025,19.0675,25.1025,19.0675,22.245,14.68,22.8675,16.1975,21.409736500000005,23.523149999999998,24.084,23.68525000000003,23.74877656650948,23.60042883576343,23.52115384615384,24.275741393668312,22.76656629863937,21.409736500000005,23.523149999999998,24.084,23.68525000000003,23.309516666666667,3824756,5028750.2,46.666450798044124,0.7847490198147126,1.5,2.75,NaN,NaN,0.59191397808467,0.760577846956884,649.407791386379,-0.015400228739336164,-0.1965341228342261,-0.18113389409488995,28.074441358025055,-3.1317829457364352,44.92403213068086,22.970870494608462,32.10509737471069,4930517828
1477315800,23.75,23.865,23.595,23.7075,21.780241071428573,27.136132075471696,25.1025,22.935,25.1025,19.0675,22.245,14.68,22.8675,16.1975,21.44227400000001,23.53655,24.060950000000002,23.689375000000027,23.747157877626755,23.610626089500247,23.49692307692307,24.204313062515162,22.78953309133098,21.44227400000001,23.53655,24.060950000000002,23.689375000000027,23.722499999999997,4127104,4903648,50.295353201846375,0.8374081908645251,1.5,2.75,NaN,NaN,0.5807058367929078,0.8416395304067502,651.7327441612554,0.01404935530168977,-0.16357219996777772,-0.1776215552694675,27.566193741741706,1.7270971894443246,75.08569738460417,5.18654801079884,19.72775460459698,4934644932
1477402200,23.66,23.7517,23.425,23.5075,21.74924910714286,27.180518867924526,25.1025,22.935,25.1025,19.0675,22.245,14.68,22.8675,16.1975,21.473761500000005,23.5498,24.02905,23.662000000000027,23.737759529484528,23.60080455716689,23.45211538461538,24.07193498043415,22.832295788796607,21.473761500000005,23.5498,24.02905,23.662000000000027,23.561400000000003,5372092,4974295,47.77243112448109,0.2588518231599389,1.5,2.75,NaN,NaN,0.5625625627362714,1.0799705284869514,649.5208879967845,0.02062710267587095,-0.1518376769246288,-0.17246477960049975,17.140343582436188,0.5238400684199218,35.44223964268597,31.27501268004186,33.28274767727216,4929272840
1477488600,23.1825,23.565,23.08,23.3525,21.718257142857144,27.224905660377356,25.1025,22.935,25.1025,19.0675,22.245,14.68,22.8675,16.1975,21.502274000000007,23.558275,24.00205,23.608875000000026,23.722651312641997,23.577156504103375,23.41442307692307,23.99291632482647,22.835929829019673,21.502274000000007,23.558275,24.00205,23.608875000000026,23.3325,4628148,4961569.2,45.85275571283539,0.7063852634253133,1.5,2.75,NaN,NaN,0.5570223796836807,0.9327992442391008,646.7391863453363,0.015349191074176594,-0.153278290757779,-0.16862748183195558,17.553931624922846,0.8529475275318419,17.06640105082464,52.897237813996384,30.036361135178982,4924644692
1477575000,23.6275,23.6275,23.1275,23.16,21.687265178571433,27.269292452830186,25.1025,22.935,25.1025,19.0675,22.245,14.68,22.8675,16.1975,21.536311500000007,23.56385,23.96895,23.580500000000026,23.700586555283486,23.537427313236385,23.335384615384612,23.71708045761548,22.953688773153743,21.536311500000007,23.56385,23.96895,23.580500000000026,23.305000000000003,3555616,4737408.6,43.51411077107318,0.9528076439523626,1.5,2.75,NaN,NaN,0.5529493525634178,0.7505402848299807,643.2043259385822,0.0004889126517391151,-0.1680163410172817,-0.1685052536690208,17.249898121202097,-0.021584286639322277,18.394734745083007,50.98939868621498,30.61586656870199,4921089076
1477661400,23.15,23.394775,22.6825,22.9425,21.65627321428572,27.313679245283016,25.1025,22.935,25.1025,19.0675,22.245,14.68,22.8675,16.1975,21.565449000000008,23.565099999999997,23.9278,23.512875000000026,23.670857670762565,23.480767569118633,23.307499999999997,23.7431515897966,22.871848410203395,21.565449000000008,23.565099999999997,23.9278,23.512875000000026,23.006591666666665,7927324,4864496.4,40.971422591248306,1.726893156508359,1.5,2.75,NaN,NaN,0.564329755951745,1.6296289169830611,640.7989747613703,-0.02119496322856715,-0.19499895770472975,-0.1738039944761626,18.071761956850455,0.03270111183780373,3.201426922307262,80.72758351136129,16.070989566331452,4913161752
1477920600,23.0775,23.15,22.8825,22.92,21.625281250000004,27.358066037735846,25.1025,22.935,25.1025,19.0675,22.245,14.68,22.8675,16.1975,21.599911500000008,23.566924999999998,23.888700000000004,23.455625000000026,23.641412271909132,23.427361133964478,23.271730769230768,23.75029988896883,22.793161649492706,21.599911500000008,23.566924999999998,23.888700000000004,23.455625000000026,22.984166666666667,3772444,4860824.2,40.706429869448606,1.515051788492443,1.5,2.75,NaN,NaN,0.5431276305266202,0.776091429103731,641.594006503943,-0.03352628114292072,-0.21571184590481352,-0.1821855647618928,17.14590083415283,-1.7679202828672362,0,100,0,4909389308
1478007000,23.0475,23.0775,21.9825,22.45,21.59428928571429,27.40245283018868,25.1025,22.935,25.1025,19.0675,22.245,14.68,22.8675,16.1975,21.631686500000004,23.570424999999997,23.840400000000002,23.390750000000025,23.594690222030344,23.334279121205956,23.217499999999998,23.866220634432462,22.568779365567533,21.631686500000004,23.570424999999997,23.840400000000002,23.390750000000025,22.503333333333334,8181896,5009539.8,35.536053889436474,3.740267552658485,1.5,2.75,NaN,NaN,0.5825470854890044,1.6332629995274217,637.0129256958953,-0.06783116023377578,-0.2669745150541125,-0.19914335482033674,16.989903051994883,-4.569606801275237,0,100,0,4901207412
1478093400,22.3225,22.465,21.875,22.0275,21.563297321428575,27.44683962264151,25.1025,22.935,25.1025,19.0675,22.245,14.68,22.8675,16.1975,21.664224000000004,23.574974999999995,23.781000000000002,23.291000000000025,23.53323178195072,23.209823966805388,23.129999999999995,24.038343801398156,22.221656198601835,21.664224000000004,23.574974999999995,23.781000000000002,23.291000000000025,22.122500000000002,5886532,5106902.8,31.644916194514465,4.086479339651106,1.5,2.75,NaN,NaN,0.5830794365255041,1.152661844278689,632.6001065320305,-0.11092438335702698,-0.3377988340166205,-0.2268744506595935,17.091808075219202,-5.8653846153846105,0,100,0,4895320880
1478179800,22.1025,22.19,21.635,21.7325,21.53230535714286,27.49122641509434,25.1025,22.935,25.1025,19.0675,22.245,14.68,22.8675,16.1975,21.694336500000006,23.577949999999998,23.722550000000005,23.173125000000027,23.462614849325202,23.069126446157256,23.037499999999998,24.212271663574864,21.862728336425132,21.694336500000006,23.577949999999998,23.722550000000005,23.173125000000027,21.852500000000003,6000744,5276903.4,29.237620647182382,4.7915020014471335,1.5,2.75,NaN,NaN,0.581073762487968,1.1371714706772915,630.2692290812147,-0.14887738105285575,-0.4129711769756632,-0.26409379592280746,17.50824261621933,-7.244985061886462,0,100,0,4889320136
1478266200,21.78,22.0725,21.61,21.64,21.61,27.53561320754717,25.1025,22.935,25.1025,19.0675,22.245,14.68,22.8675,16.1975,21.719136500000005,23.580924999999993,23.664050000000007,23.063000000000027,23.391139757194804,22.93301916557085,22.90730769230769,24.280783717046578,21.5338316675688,21.719136500000005,23.580924999999993,23.664050000000007,23.063000000000027,21.77416666666667,4517668,5231866,28.505375291284892,4.126542480745455,1.5,2.75,NaN,NaN,0.5726042080245419,0.8634907698324078,631.4670531954717,-0.1683566275906231,-0.47453958041108635,-0.30618295282046326,16.77867037366635,-8.720868923336493,0,100,0,4884802468
1478529000,22.5625,23.095,22.5075,23.0575,21.58179487179487,27.58,25.1025,22.935,25.1025,19.0675,22.245,14.68,22.8675,16.1975,21.754811500000006,23.595874999999992,23.636650000000003,23.006500000000027,23.378055845147948,22.944874483135532,22.871346153846154,24.202062582322842,21.540629725369467,21.754811500000006,23.595874999999992,23.636650000000003,23.006500000000027,22.886666666666663,6525368,5352004.8,49.41350571265252,1.0069299076162541,1.5,2.75,NaN,NaN,0.6356324788799316,1.219238069442688,636.7083725495494,-0.07848735933311907,-0.4042921519868621,-0.325804792653743,43.61875827508064,-1.9142826757417815,5.034693269818553,75.61594936024848,19.349357369932978,4891327836
1478615400,22.9425,23.6125,22.8325,23.38,21.553589743589743,27.624386792452828,25.1025,22.935,25.1025,19.0675,22.245,14.68,22.8675,16.1975,21.788849000000006,23.61669999999999,23.608550000000005,23.010250000000028,23.378132086514697,22.986315008551195,22.869807692307692,24.19811989717877,21.541495487436613,21.788849000000006,23.61669999999999,23.608550000000005,23.010250000000028,23.275000000000002,6891876,5290592,52.79581739904356,2.5608285127882073,1.5,2.75,NaN,NaN,0.6459444446742222,1.3026663178714215,638.820991278695,0.005506890709251644,-0.31892117926717845,-0.3244280699764301,44.4291263449853,0.11776041109088903,26.628004746450017,40.718024723646565,32.65397052990344,4898219712
1478701800,22.79,24.37,22.79,24.13,21.525384615384613,27.668773584905658,25.1025,22.935,25.1025,19.0675,22.245,14.68,22.8675,16.1975,21.829336500000004,23.64109999999999,23.598000000000006,23.047500000000028,23.407617102729805,23.095237388689178,22.923653846153847,24.388201052873406,21.45910663943429,21.829336500000004,23.64109999999999,23.598000000000006,23.047500000000028,23.763333333333332,10286904,5515291,59.56655544276599,4.658030318903805,1.5,2.75,NaN,NaN,0.7126626986260636,1.8651606959632774,641.220991278695,0.10868517573545017,-0.1885716003071174,-0.29725677604256756,47.7890789766119,4.188255613126074,61.431111409322185,11.832412388870859,26.736476201806937,4908506616
1478788200,24.465,24.7775,23.745,24.285,21.497179487179487,27.713160377358488,25.1025,22.935,25.1025,19.0675,22.245,14.68,22.8675,16.1975,21.869299000000005,23.66507499999999,23.594650000000005,23.10400000000003,23.442024275171775,23.208548113575922,22.968076923076925,24.554957212592942,21.381196633560908,21.869299000000005,23.66507499999999,23.594650000000005,23.10400000000003,24.269166666666667,8039432,5618656,60.81740155031156,4.9527064525010625,1.5,2.75,NaN,NaN,0.7355082201527733,1.4308460955787292,638.8089005220729,0.1802596405661302,-0.07193222533490484,-0.25219186590103504,47.23120851270265,5.851585485452768,86.37855326500288,1.678949723155601,11.942497011841514,4916546048
1478874600,24.0275,24.2287,23.775,24.1475,21.468974358974357,27.757547169811318,25.1025,21.64,25.1025,19.0675,22.245,14.68,22.8675,16.1975,21.902674000000005,23.688999999999993,23.588400000000007,23.153125000000028,23.469689989870922,23.297972102759168,23.017307692307693,24.704605784545993,21.330009600069392,21.902674000000005,23.688999999999993,23.588400000000007,23.153125000000028,24.050399999999996,5265272,5584812.2,59.07158952274213,3.0686366950481707,1.5,2.75,NaN,NaN,0.719400490141861,0.9427840742791673,640.8501419743923,0.20919587659808406,0.009302979846570025,-0.19989289675151403,46.867181013623345,5.355584642233853,82.46168983253156,2.710983232674915,14.827326934793522,4911280776
1479133800,24.3425,24.4225,23.8975,24.185,21.44076923076923,27.80193396226415,25.1025,21.64,25.1025,19.0675,22.245,14.68,22.8675,16.1975,21.93619900000001,23.704624999999993,23.576550000000008,23.215625000000028,23.49774136281716,23.382450950115437,23.081346153846155,24.874539068287422,21.28815323940489,21.93619900000001,23.704624999999993,23.576550000000008,23.215625000000028,24.168333333333333,4454184,5582904.4,59.413774967461066,3.0109498851132783,1.5,2.75,NaN,NaN,0.7055147408460137,0.7978255905653695,642.620773255923,0.22058170300044816,0.07583423199904615,-0.144747471001402,46.769228449671914,7.728285077951,82.41683230743298,2.6918539899645944,14.891313702602446,4915734960
1479220200,24.345,24.750025,24.26325,24.7375,21.4125641025641,27.846320754716977,25.1025,21.64,25.1025,19.0675,22.245,14.68,22.8675,16.1975,21.977259000000014,23.750174999999995,23.571050000000003,23.28587500000003,23.546359348589036,23.511503240580634,23.202692307692306,25.20236484005514,21.203019775329473,21.977259000000014,23.750174999999995,23.571050000000003,23.28587500000003,24.583591666666667,5877908,5578895.6,64.1671656814969,4.026803271107907,1.5,2.75,NaN,NaN,0.6954797593570129,1.0535970596044135,647.0860237011345,0.2527337553665887,0.17116972320683388,-0.08156403215975483,44.481456561698124,12.302803314039274,82.04015879118086,2.801912744186242,15.157928464632901,4921612868
1479306600,24.525,24.705675,24.4675,24.6425,21.384358974358975,27.89070754716981,25.1025,21.64,25.1025,19.0675,22.245,14.68,22.8675,16.1975,22.016509000000013,23.80592499999999,23.563750000000006,23.34175000000003,23.589345256487505,23.619217217668194,23.33346153846154,25.465905548423184,21.201017528499893,22.016509000000013,23.80592499999999,23.563750000000006,23.34175000000003,24.605225,2623404,5602757,62.80510699415484,3.3817580268351444,1.5,2.75,NaN,NaN,0.6650883479743691,0.46823447813281927,648.2758683704417,0.2543182434711985,0.23633377217924334,-0.017984471291955198,41.67200330578177,13.390083975612544,61.70624531139755,11.574767192282078,26.718987496320374,4918989464
1479393000,24.685,25.0175,24.6375,24.985,21.356153846153845,27.93509433962264,25.1025,21.64,25.1025,19.0675,22.245,14.68,22.8675,16.1975,22.057034000000012,23.855174999999996,23.567000000000004,23.42100000000003,23.64407681505662,23.74929176836646,23.49230769230769,25.77989246294248,21.2047229216729,22.057034000000012,23.855174999999996,23.567000000000004,23.42100000000003,24.88,3218192,5548843.2,65.63711355317936,3.9562963674019644,1.5,2.75,NaN,NaN,0.6447248945476284,0.5799753000769602,649.907631405447,0.26400109820418594,0.3120169014632772,0.048015803259091286,38.58912055805675,15.457486136783729,52.0548053595312,17.645182802705442,30.30001183776336,4922207656
1479479400,25.02,25.08,24.755,24.815,21.32794871794872,27.97948113207547,25.1025,21.64,25.1025,19.0675,22.245,14.68,22.8675,16.1975,22.10149650000001,23.891799999999993,23.602800000000002,23.49025000000003,23.689995371328912,23.8507877904268,23.674230769230768,25.977422855658265,21.37103868280327,22.10149650000001,23.891799999999993,23.602800000000002,23.49025000000003,24.88333333333333,2643652,5489788,63.070217406379214,3.267281626776688,1.5,2.75,NaN,NaN,0.6218874020799406,0.48155812209870397,648.7574502602935,0.2449439963918503,0.35419579874890417,0.10925180235705387,39.05556360349834,7.62224872601106,64.44787739997146,10.075627908038532,25.47649469199001,4919564004
1479738600,25.0575,25.3925,24.9975,25.3625,21.29974358974359,28.0238679245283,25.1025,21.64,25.1025,19.0675,22.245,14.68,22.8675,16.1975,22.151909000000014,23.925524999999997,23.629450000000002,23.573000000000032,23.755583788139543,23.994760381814725,23.930769230769233,26.18555762661909,21.675980834919375,22.151909000000014,23.925524999999997,23.629450000000002,23.573000000000032,25.250833333333333,2594276,5413146.6,67.48100213926182,4.123601458774774,1.5,2.75,NaN,NaN,0.6187168733599446,0.4792547092665106,652.6532278891287,0.25410314824408453,0.4268807376621595,0.17277758941807497,24.136753297115664,8.47946963216425,61.20036589565718,11.86312178039322,26.936512323949593,4922158280
1479825000,25.525,25.605,25.24,25.53,21.271538461538462,28.06825471698113,25.1025,21.64,25.1025,19.0675,22.245,14.68,22.8675,16.1975,22.203259000000013,23.959675,23.680350000000004,23.674125000000036,23.825168737624267,24.14097367878475,24.222884615384615,26.233554084983318,22.212215145785912,22.203259000000013,23.959675,23.680350000000004,23.674125000000036,25.458333333333332,4909252,5390004.6,68.71220452116847,4.037899949261916,1.5,2.75,NaN,NaN,0.6005942395485201,0.9108066438384859,657.1745797832882,0.2556376986533794,0.49232471273479916,0.23668701408141982,24.01783581969305,5.801906340654797,58.95436859858622,13.179635905787455,27.865995495626308,4927067532
1479911400,25.32,25.59,25.24,25.5775,21.243333333333332,28.11264150943396,25.1025,21.64,25.1025,19.0675,22.245,14.68,22.8675,16.1975,22.254959000000014,23.998525,23.733050000000002,23.785375000000034,23.89388761065861,24.27778570937668,24.525769230769228,26.004870289124742,23.046668172413714,22.254959000000014,23.998525,23.733050000000002,23.785375000000034,25.469166666666663,2710480,5294121.2,69.06983783930141,3.571904157006039,1.5,2.75,NaN,NaN,0.5826946510093401,0.5119792119606177,656.8644929468152,0.24407208323959723,0.5417771181309163,0.2977050348913191,19.30876662068767,5.322215359275275,81.59022413579706,2.9363367209055515,15.473439143297385,4929778012
1480084200,25.7125,25.8575,25.6825,25.85,21.215128205128202,28.15702830188679,25.1025,21.64,25.1025,19.0675,22.245,14.68,22.8675,16.1975,22.310809000000013,24.036475,23.7773,23.919875000000033,23.970597900436704,24.427520403721758,24.740576923076922,26.1114920495613,23.369661796592545,22.310809000000013,24.036475,23.7773,23.919875000000033,25.79666666666667,2276164,5230148.6,71.11001510234075,4.122613709774053,1.5,2.75,NaN,NaN,0.561073604508673,0.4352006365555273,659.7273370376905,0.23870451106212137,0.5960856737189708,0.35738116265684944,19.50322550778738,7.050419298063984,80.41989449729945,3.2984175636088953,16.281687939091643,4932054176
1480343400,25.725,25.825,25.442475,25.4925,21.186923076923076,28.20141509433962,25.1025,21.64,25.1025,19.0675,22.245,14.68,22.8675,16.1975,22.360509000000015,24.071399999999997,23.8202,24.047375000000034,24.030280335713698,24.528947031938735,24.903076923076924,26.077026787433862,23.729127058719985,22.360509000000015,24.071399999999997,23.8202,24.047375000000034,25.586658333333332,2603856,4963975.2,65.04804005113809,2.7826070455632914,1.5,2.75,NaN,NaN,0.5501058470437677,0.5245505658448898,655.7969730349511,0.1967539452413551,0.6033235942085433,0.4065696489671882,21.78342493382474,5.4062435393839205,81.16597655562892,3.090928155743487,15.7430952886276,4929450320
1480429800,25.4925,25.8125,25.3675,25.62,21.158717948717946,28.24580188679245,25.1025,21.64,25.1025,19.0675,22.245,14.68,22.8675,16.1975,22.406984000000016,24.097524999999997,23.865249999999996,24.182375000000032,24.09262228333277,24.63285683842076,25.017692307692307,26.15780947700576,23.877575138378855,22.406984000000016,24.097524999999997,23.865249999999996,24.182375000000032,25.599999999999998,2066604,4878683.2,66.15614778439817,2.6514497089190834,1.5,2.75,NaN,NaN,0.5425982865406415,0.4235987284437735,655.2296644060199,0.16457611062681143,0.6122897872507025,0.44771367662389105,21.649288241667744,3.5674583122789296,80.42217782537821,3.3248520524292737,16.252970122192515,4931516924
1480516200,25.8875,25.9475,25.41,25.4125,21.13051282051282,28.290188679245283,25.1025,21.64,25.1025,19.0675,22.245,14.68,22.8675,16.1975,22.44840900000002,24.119174999999995,23.905949999999994,24.330500000000036,24.144382193790307,24.707108568094974,25.104423076923077,26.177995749835194,24.03085040401096,22.44840900000002,24.119174999999995,23.905949999999994,24.330500000000036,25.590000000000003,4189728,4679074.8,62.67367134260578,2.1333941510141883,1.5,2.75,NaN,NaN,0.54223412321631,0.8954180429002759,652.3821904187624,0.11845643023955033,0.595784214423329,0.47732778418377864,20.035509659289716,3.124682966419816,37.13309987496805,29.80225696704064,33.06464315799131,4927327196
1480602600,25.555,25.5575,25.020025,25.1525,21.10230769230769,28.33457547169811,25.1025,21.64,25.1025,19.0675,22.245,14.68,22.8675,16.1975,22.48960900000002,24.133349999999997,23.92609999999999,24.486750000000036,24.183916225406374,24.749526799704977,25.18173076923077,26.102387693170215,24.261073845291328,22.48960900000002,24.133349999999997,23.92609999999999,24.486750000000036,25.243341666666666,3791296,4574313,58.51705116474375,0.7177840307981415,1.5,2.75,NaN,NaN,0.5418941858437165,0.8288230385633865,649.4190016288137,0.06239552735922549,0.5553221933828105,0.49292666602358504,21.112937723598186,0.6704022413448086,12.03201647870568,61.03332957636994,26.934653944924392,4923535900
1480689000,25.185,25.3825,25.05,25.18,21.074102564102564,28.378962264150942,25.85,21.64,25.1025,19.0675,22.245,14.68,22.8675,16.1975,22.53095900000002,24.147699999999997,23.937699999999996,24.65912500000003,24.222978334213966,24.79052424735212,25.258269230769233,25.978334357672523,24.538204103865944,22.53095900000002,24.147699999999997,23.937699999999996,24.65912500000003,25.20416666666667,2244884,4386520,58.82807978755104,0.49492819513542174,1.5,2.75,NaN,NaN,0.5269374582834511,0.5117687825428814,651.3425400349809,0.021247830298381398,0.5194864538965618,0.4982386235981804,19.742360091240585,1.4708845456377126,11.661760024423108,61.680937855845826,26.657302119731057,4925780784
1480948200,25.5325,25.787475,25.4475,25.615,21.045897435897434,28.423349056603772,25.85,21.64,25.1025,19.0675,22.245,14.68,22.8675,16.1975,22.57094650000002,24.162599999999994,23.966049999999996,24.85787500000003,24.277567419146752,24.8690457476043,25.325769230769232,26.00103095955805,24.650507501980414,22.57094650000002,24.162599999999994,23.966049999999996,24.85787500000003,25.616658333333334,3278764,4324574.8,63.49113268621358,1.7982464797657194,1.5,2.75,NaN,NaN,0.5326901398346332,0.7581702598831219,655.1678940490995,0.017561741904105643,0.5201908009783125,0.5026290590742069,21.101810013517998,0.9955643173977239,32.59712443866002,34.08845815715199,33.31441740418799,4929059548
1481034600,25.72,25.9,25.525,25.875,21.017692307692307,28.467735849056602,25.85,21.64,25.1025,19.0675,22.245,14.68,22.8675,16.1975,22.615384000000017,24.181124999999994,24.011049999999997,24.99875000000003,24.340211834082172,24.964850914499127,25.420576923076926,26.028189381316786,24.812964464837066,22.615384000000017,24.181124999999994,24.011049999999997,24.99875000000003,25.766666666666666,2393692,4117991,65.9718449684797,2.107852701856517,1.5,2.75,NaN,NaN,0.5214265584178737,0.5812766467920887,658.5569914670577,0.026340976984410736,0.5355552803047203,0.5092143033203096,18.188400837622964,1.3513513513513469,34.11162181281138,32.574308741748936,33.31406944543969,4931453240
1481121000,25.8225,26.925,25.7773,26.8875,20.989487179487178,28.512122641509432,25.85,21.64,25.1025,19.0675,22.245,14.68,22.8675,16.1975,22.663859000000016,24.207699999999992,24.067699999999995,25.174125000000032,24.44010548764758,25.147960351213495,25.56692307692308,26.508866962737763,24.624979191108395,22.663859000000016,24.207699999999992,24.067699999999995,25.174125000000032,26.52993333333333,3237736,3935284,73.51812796222708,4.495049551157492,1.5,2.75,NaN,NaN,0.5661603756737399,0.8227451945018454,662.8623038001776,0.09043576892323679,0.6222590144743556,0.5318232455511188,27.738380717918204,5.121688984458992,70.08103858505851,7.305559446422759,22.613401968518737,4934690976
1481207400,26.8975,27.295,26.784975,27.1025,20.96128205128205,28.556509433962262,25.85,21.64,25.1025,19.0675,22.245,14.68,22.8675,16.1975,22.710334000000017,24.23739999999999,24.121449999999996,25.32275000000003,24.544513115582966,25.33410698443126,25.742884615384618,26.889610466455743,24.596158764313493,22.710334000000017,24.23739999999999,24.121449999999996,25.32275000000003,27.06082500000001,3366868,3589282.2,74.79629379708264,5.0308520244339325,1.5,2.75,NaN,NaN,0.5621507059827586,0.9380337940549784,665.9188485411269,0.13474061705027607,0.7002490168639639,0.5655083998136878,27.6921972966421,4.845261121856858,100,0,0,4938057844
1481293800,27.2,27.5875,27.175,27.5875,20.93307692307692,28.60089622641509,25.85,21.64,25.1025,19.0675,22.245,14.68,22.8675,16.1975,22.759784000000014,24.26874999999999,24.198649999999997,25.487875000000027,24.66384593457971,25.548715843056854,25.91403846153846,27.397359240245606,24.430717682831315,22.759784000000014,24.26874999999999,24.198649999999997,25.487875000000027,27.45,3374824,3356051.8,77.44137554378526,5.378225823074485,1.5,2.75,NaN,NaN,0.5566399412697044,1.005593537024667,665.0892871853425,0.1812426465511887,0.7920617080026737,0.610819061451485,28.43676527633765,8.218103363734427,100,0,0,4941432668
1481553000,27.545,27.75,27.3155,27.4875,20.904871794871795,28.64528301886792,25.85,21.64,25.1025,21.64,22.245,19.0675,22.8675,14.68,22.811109000000016,24.302049999999994,24.262499999999996,25.654875000000025,24.774577466556977,25.733361953241914,26.064615384615387,27.74567028024794,24.383560488982834,22.811109000000016,24.302049999999994,24.262499999999996,25.654875000000025,27.517666666666667,3563332,3270954.8,75.67783148601751,4.785204585203799,1.5,2.75,NaN,NaN,0.5479156597504398,1.0893858881816405,661.9063714809997,0.18893769155692586,0.8469911758976423,0.6580534843407164,26.26627393659269,7.289227166276345,73.74258017293488,5.748802666642251,20.508617160422872,4937869336
1481639400,27.76,28.2531,27.76,28.0125,20.876666666666665,28.2531,25.85,21.64,25.1025,21.64,22.245,19.0675,22.8675,14.68,22.858646500000013,24.337349999999994,24.341449999999995,25.846250000000033,24.901554820809643,25.95042271959983,26.25192307692308,28.196161264537324,24.307684889308838,22.858646500000013,24.337349999999994,24.341449999999995,25.846250000000033,28.008533333333332,4047820,3250636.6,78.45217753770183,5.755748998879927,1.5,2.75,NaN,NaN,0.5634645411968369,1.2452391633072735,664.5277823362063,0.21136129619146915,0.9222551045800529,0.7108938083885837,26.977349784686506,10.231185440236095,76.95698891004973,4.5022529043878645,18.540758185562414,4941917156
1481725800,27.91,28.2238,27.157775,27.355,20.848461538461535,28.291889743589742,25.85,21.64,25.1025,21.64,22.245,19.0675,22.8675,14.68,22.90170900000001,24.36799999999999,24.413599999999995,25.977125000000036,24.997768357248482,26.084191984399844,26.36769230769231,28.38043676158763,24.354947853796986,22.90170900000001,24.36799999999999,24.413599999999995,25.977125000000036,27.578858333333333,6147020,3264092.2,67.9920368359068,3.6827748747695037,1.5,2.75,NaN,NaN,0.5993617168256342,1.8832249897842959,659.9692203036266,0.16589487164113403,0.9182623979400013,0.7523675262988673,31.661323522028496,8.75658483252162,38.95411873335294,28.094393146949333,32.95148811969773,4935770136
1481812200,27.4575,28.035,27.385,27.68,20.82025641025641,28.330679487179488,25.85,21.64,25.1025,21.64,22.245,19.0675,22.8675,14.68,22.945334000000013,24.401724999999992,24.486749999999997,26.12900000000003,25.102953911866187,26.23617370017129,26.535961538461542,28.5931670164579,24.478756060465184,22.945334000000013,24.401724999999992,24.486749999999997,26.12900000000003,27.7,4765072,3371175.6,70.11324629764722,3.451734439379081,1.5,2.75,NaN,NaN,0.6051215941952318,1.413474872089131,662.0685003574035,0.1425824638820855,0.9305956061514742,0.7880131422693887,29.63327225464363,9.928514694201748,43.4280726967987,24.248552396952277,32.32337490624903,4940535208
1481898600,27.8575,27.90475,27.385,27.5275,20.79205128205128,28.36946923076923,25.85,21.64,25.1025,21.64,22.245,19.0675,22.8675,14.68,22.987246500000012,24.434599999999996,24.5555,26.256125000000033,25.198034150616532,26.359157157297833,26.682692307692307,28.729722484406537,24.635662130978076,22.987246500000012,24.434599999999996,24.5555,26.256125000000033,27.60575,4379284,3429230.2,67.84133653141839,2.722156055332085,1.5,2.75,NaN,NaN,0.5990236231812867,1.2770457929595977,664.783777004953,0.10357993084025441,0.9174880558197067,0.8139081249794523,30.55310254991174,7.466328323248103,21.116608669648244,47.37777775635847,31.5056135739933,4936155924
1482157800,27.61,27.875,27.535,27.6775,20.763846153846153,28.408258974358976,25.85,21.64,25.1025,21.64,22.245,19.0675,22.8675,14.68,23.029721500000008,24.46817499999999,24.632199999999997,26.39925000000003,25.295268105494316,26.484713618507563,26.856923076923074,28.82592922396797,24.887916929878177,23.029721500000008,24.46817499999999,24.632199999999997,26.39925000000003,27.695833333333333,2588108,3426453,68.90851859339796,2.60907254841997,1.5,2.75,NaN,NaN,0.5810576500969091,0.755331533804783,667.8563127965226,0.07585647216048685,0.9087287151800609,0.8328722430195741,30.137842527283148,6.966183574879221,37.303273209850694,29.532884900208956,33.163841889940336,4938744032
1482244200,27.9325,28.075,27.8291,28,20.735641025641023,28.447048717948718,28.0125,21.64,25.1025,21.64,22.245,19.0675,22.8675,14.68,23.07699650000001,24.503649999999993,24.70845,26.53112500000003,25.40133602292591,26.629026607221128,27.075961538461538,28.86292774543135,25.288995331491726,23.07699650000001,24.503649999999993,24.70845,26.53112500000003,27.96803333333333,2748092,3434143.8,71.12699898813285,3.0275457453402765,1.5,2.75,NaN,NaN,0.5679463893757014,0.8002262456219801,670.4426375306293,0.06749148305802222,0.9172365968421019,0.8497451137840797,30.192190996039887,4.1376104137610445,33.16370707951902,33.52177835569314,33.314514564787835,4941492124
1482330600,27.97,28.0225,27.78,27.79,20.707435897435897,28.48583846153846,28.0125,21.64,25.1025,21.64,22.245,19.0675,22.8675,14.68,23.12177150000001,24.538024999999994,24.798149999999996,26.64412500000003,25.495009120066072,26.739595501771497,27.27673076923077,28.71993551590686,25.83352602255468,23.12177150000001,24.538024999999994,24.798149999999996,26.64412500000003,27.864166666666666,2389892,3308175.8,67.73763308407685,2.3546844298132172,1.5,2.75,NaN,NaN,0.5447002187060084,0.7224198907446213,669.4868857121841,0.037561781477056244,0.8966973406304,0.8591355591533437,24.126231814065896,2.5366663591919565,48.20495010976716,20.435211482405997,31.35983840782683,4939102232
1482417000,27.7125,27.7575,27.463825,27.6425,20.679230769230767,28.524628205128206,28.0125,21.64,25.1025,21.64,22.245,19.0675,22.8675,14.68,23.165609000000007,24.575449999999993,24.883299999999995,26.747375000000034,25.579224448690933,26.82558640636469,27.432692307692307,28.517617795276347,26.347766820108266,23.165609000000007,24.575449999999993,24.883299999999995,26.747375000000034,27.621274999999997,3383336,3341818.6,65.38099492730015,1.2457478123955024,1.5,2.75,NaN,NaN,0.529091274512722,1.0124235947456872,667.4968310746634,-0.00041230660351587733,0.8586201758989489,0.8590324825024648,24.38928432663353,0.19936565473493328,16.019667219245914,54.466270285999975,29.51406249475412,4935718896
1482503400,27.635,27.7375,27.5525,27.7175,20.65102564102564,28.563417948717948,28.0125,21.64,25.1025,21.64,22.245,19.0675,22.8675,14.68,23.205309000000007,24.611524999999993,24.974549999999994,26.840750000000032,25.663078391879523,26.91053055813948,27.574423076923075,28.186865079973643,26.961981073872508,23.205309000000007,24.611524999999993,24.974549999999994,26.840750000000032,27.669166666666666,2654440,3360732.4,66.0281904366415,1.1880847329125432,1.5,2.75,NaN,NaN,0.504513326333242,0.7898397385046189,669.5024202797853,-0.0272374259204079,0.8249857001019549,0.8522231260223628,22.273069646316294,0.8367439745338806,45.51444647724658,22.50643812440333,31.9791153983501,4938373336
1482849000,27.8325,28.1025,27.8275,27.9175,20.62282051282051,28.602207692307694,28.0125,21.64,25.1025,21.64,22.245,19.0675,22.8675,14.68,23.246371500000006,24.648899999999994,25.069599999999994,26.962000000000035,25.751487082394053,27.006432409745244,27.653653846153848,28.144573765146657,27.16273392716104,23.246371500000006,24.648899999999994,25.069599999999994,26.962000000000035,27.949166666666663,1785236,3319801.4,67.75912688467018,1.93484592508309,1.5,2.75,NaN,NaN,0.4959766601665817,0.537753854793844,672.0171914570644,-0.0376290829461966,0.8051867723396171,0.8428158552858137,22.4088444981471,-0.33913431503792546,42.361020967768496,25.097755404796978,32.54122362743454,4940158572
1482935400,28.0325,28.0425,27.2025,27.2725,20.594615384615384,28.640997435897436,28.0125,21.64,25.1025,21.64,22.245,19.0675,22.8675,14.68,23.284621500000004,24.673799999999996,25.156349999999996,27.044625000000035,25.811134647790364,27.031772180245696,27.666730769230767,28.104396714090473,27.22906482437106,23.284621500000004,24.673799999999996,25.156349999999996,27.044625000000035,27.50583333333334,2704940,3351718.2,57.57127361252628,0.7401077617272981,1.5,2.75,NaN,NaN,0.5205497558689688,0.8070308536081583,668.2289116588199,-0.09101597797861427,0.7290458828125459,0.8200618607911602,23.528057249092658,-0.30159020288795313,16.24245296306549,54.15771728872523,29.59982974820929,4937453632
1483021800,27.2775,27.4225,27.04,27.225,20.566410256410254,28.679787179487178,28.0125,21.64,25.1025,21.64,22.245,19.0675,22.8675,14.68,23.320959000000002,24.698674999999994,25.234199999999998,27.135250000000035,25.86658034787702,27.050174829746105,27.638846153846153,28.135382678897493,27.142309628794813,23.320959000000002,24.698674999999994,25.234199999999998,27.135250000000035,27.229166666666668,3390736,3311768.6,56.892865138369615,0.6776650288538079,1.5,2.75,NaN,NaN,0.5106890590211853,1.0238444799555138,670.4827186642441,-0.13021432802663935,0.657293950757861,0.7875082787845004,19.341723728750125,-1.643786127167624,14.00844171595713,57.634068634330895,28.357489649711987,4934062896
1483108200,27.3625,27.3825,26.625,26.9375,26.625,28.718576923076924,28.0125,21.64,25.1025,21.64,22.245,19.0675,22.8675,14.68,23.354009,24.720299999999995,25.302449999999993,27.224500000000035,25.90857719697988,27.039443893579808,27.59653846153846,28.215966046123114,26.97711087695381,23.354009,24.720299999999995,25.302449999999993,27.224500000000035,26.981666666666666,4903640,3367385.8,52.83466633189788,1.8175600905910732,1.5,2.75,NaN,NaN,0.5283184119482435,1.4562156792369916,668.7878590772552,-0.17348418519754039,0.5706530472875748,0.7441372324851152,18.389308340350553,-2.1433112342203247,11.425254886240541,62.010433743646985,26.564311370112467,4929159256
1483453800,27.4675,27.744975,27.05105,27.5075,26.756973684210525,28.757366666666666,28.0125,21.64,25.1025,21.64,22.245,19.0675,22.8675,14.68,23.388734,24.749399999999994,25.384599999999992,27.34087500000004,25.971280052000278,27.084020665619825,27.557692307692307,28.129405191316398,26.985979424068216,23.388734,24.749399999999994,25.384599999999992,27.34087500000004,27.43450833333334,3557280,3433005.6,59.06849568348573,0.5821365201201543,1.5,2.75,NaN,NaN,0.5482581682376547,1.0361998826917147,673.763606711142,-0.16191865446795595,0.5417389144001703,0.7036575688681262,22.672209490530552,-0.6142173245415885,13.67649344795225,58.143102159609334,28.180404392438405,4932716536
1483540200,27.6525,28.0775,27.6525,27.995,26.888947368421054,28.796156410256412,28.0125,21.64,25.1025,21.64,22.245,19.0675,22.8675,14.68,23.425383999999998,24.779949999999996,25.47589999999999,27.45987500000004,26.050641618588504,27.17078060222746,27.606923076923074,28.20971834082079,27.00412781302536,23.425383999999998,24.779949999999996,25.47589999999999,27.45987500000004,27.908333333333335,3548692,3446502,63.51054907622281,1.9836077597099075,1.5,2.75,NaN,NaN,0.5498111562206794,1.0296503527344536,679.9744097247686,-0.12148556107097097,0.5518006175294126,0.6732861786003835,24.721699333201137,-0.017857142857139303,20.292657423635177,48.391464957231,31.31587761913382,4936265228
1483626600,27.9075,28.0175,27.616025,27.93,27.02092105263158,28.834946153846154,28.0125,21.64,25.1025,21.64,22.245,19.0675,22.8675,14.68,23.4618965,24.810649999999992,25.56034999999999,27.562625000000036,26.124341947271308,27.24308721153913,27.626153846153844,28.252537285444628,26.99977040686306,23.4618965,24.810649999999992,25.56034999999999,27.562625000000036,27.854508333333328,3352108,3494422.8,62.53605330831393,1.3123980047513935,1.5,2.75,NaN,NaN,0.5392157164906307,0.9592737318449274,678.2070072974176,-0.10006077731165286,0.5482102069608175,0.6482709842724703,23.8467962415277,0.5037783375314882,18.66095016609224,50.62374922676444,30.71530060714334,4932913120
1483713000,28.0025,28.4375,27.765,28.245,27.152894736842104,28.873735897435896,28.0125,21.64,25.1025,21.64,22.245,19.0675,22.8675,14.68,23.501971500000003,24.84207499999999,25.65509999999999,27.630500000000033,26.20750500816263,27.338507477106834,27.681346153846157,28.384918399834756,26.977773907857557,23.501971500000003,24.84207499999999,25.65509999999999,27.630500000000033,28.14916666666667,3386716,3501871.8,65.31368189474702,2.5168921885199667,1.5,2.75,NaN,NaN,0.5487360224555856,0.9671159292581757,677.027110326176,-0.06719438534608924,0.5642780025898588,0.6314723879359481,24.176317366764657,2.1796147237044505,41.55900110444458,25.74982887550157,32.691170020053846,4936299836
1483972200,28.1325,28.18775,27.9475,27.9775,27.284868421052632,28.912525641025642,28.0125,21.64,25.1025,21.64,22.245,19.0675,22.8675,14.68,23.540859000000005,24.87482499999999,25.747599999999988,27.674250000000036,26.27691657646998,27.399363907858564,27.704423076923078,28.425440397333176,26.98340575651298,23.540859000000005,24.87482499999999,25.747599999999988,27.674250000000036,28.037583333333334,1995400,3433298.4,61.16632910778962,1.3379469268288522,1.5,2.75,NaN,NaN,0.5307905922801865,0.5811903794904631,673.9064314955949,-0.06590016517116992,0.5490971814719856,0.6149973466431555,24.729299491320177,0.9380355371155336,56.707593889330255,14.56011761127734,28.732288499392407,4934304436
1484058600,27.975,28.3207,27.7925,27.9525,27.416842105263157,28.951315384615384,28.0125,21.64,25.1025,21.64,22.245,19.0675,22.8675,14.68,23.579500000000007,24.90619999999999,25.84344999999999,27.692500000000035,26.3426257303339,27.452043535681558,27.700769230769232,28.416217945846228,26.985320515692237,23.579500000000007,24.90619999999999,25.84344999999999,27.692500000000035,28.0219,2475744,3388344.4,60.77789854130925,1.2201803630073427,1.5,2.75,NaN,NaN,0.5306055499744587,0.730664804911803,676.6566380994042,-0.06883663249774208,0.5289515560209779,0.59778818851872,24.735503493888668,0.1253693919584495,29.82566765443503,36.970410116272184,33.20392222929277,4931828692
1484145000,27.92,28.185,27.6375,28.185,27.548815789473686,28.99010512820513,28.0125,21.64,25.1025,21.64,22.245,19.0675,22.8675,14.68,23.616425000000007,24.93804999999999,25.948299999999985,27.727375000000034,26.414875701693354,27.521848913235694,27.731153846153845,28.491332507807233,26.970975184500457,23.616425000000007,24.93804999999999,25.948299999999985,27.727375000000034,28.002499999999994,3181468,3369251.2,63.12331763086547,0.9596456160097774,1.5,2.75,NaN,NaN,0.5318122964048545,0.9442655982433129,680.0189681185865,-0.05768093727593837,0.525687016923797,0.5833679541997354,24.84559143058143,3.3458612155101215,28.218668139393884,38.72625490008556,33.055076960520566,4935010160
1484231400,27.975,28.059975,27.3925,27.9825,27.68078947368421,29.028894871794872,28.0125,21.64,25.1025,21.64,22.245,19.0675,22.8675,14.68,23.650975000000006,24.96912499999999,26.049549999999986,27.72587500000003,26.476351164372048,27.565720445308486,27.757307692307695,28.526824177707308,26.98779120690808,23.650975000000006,24.96912499999999,26.049549999999986,27.72587500000003,27.811658333333337,3253256,3329523,59.770841307769096,0.4698538201611498,1.5,2.75,NaN,NaN,0.5504328466616506,0.9770937158265613,677.5822695323842,-0.06590656479378532,0.5009847482075038,0.5668913130012891,20.39757575142654,2.7823691460055104,28.59139168047582,38.31366385865404,33.094944460870146,4931756904
1484317800,28.0525,28.285125,28.03,28.16,27.812763157894736,29.067684615384614,28.245,21.64,25.1025,21.64,22.245,19.0675,22.8675,14.68,23.687287500000007,25.00207499999999,26.163749999999986,27.766125000000027,26.542376608906476,27.62231849813625,27.791346153846156,28.589424652454426,26.993267655237887,23.687287500000007,25.00207499999999,26.163749999999986,27.766125000000027,28.158375,2796916,3162017.8,61.69141100466144,1.08054440278758,1.5,2.75,NaN,NaN,0.5327322861858184,0.8845351850960486,679.9477691065322,-0.06144790229613495,0.49008143513112046,0.5515293374272554,20.298698475283672,4.538283062645012,25.667205829777494,41.64217394489997,32.69062022532252,4934553820
1484663400,27.875,28.055,27.6971,27.8575,27.944736842105264,29.10647435897436,28.245,21.64,25.1025,21.64,22.245,19.0675,22.8675,14.68,23.720062500000008,25.03067499999999,26.280349999999988,27.775000000000027,26.59395007522387,27.644716736408988,27.786730769230772,28.582528348381555,26.99093319007999,23.720062500000008,25.03067499999999,26.280349999999988,27.775000000000027,27.869866666666667,2405456,3044037,56.72150081929871,0.10309564438441415,1.5,2.75,NaN,NaN,0.5277442657439743,0.7902190413585644,678.2901886965568,-0.07976512944153524,0.4518229256253363,0.5315880550668716,20.34521623422719,1.2723802599291154,24.5982289161422,42.928033364212155,32.47373771964565,4932148364
1484749800,27.96,28.05,27.7325,28.0375,28.07671052631579,29.145264102564102,28.245,21.64,25.1025,21.64,22.245,19.0675,22.8675,14.68,23.75470000000001,25.06449999999999,26.406449999999985,27.800500000000028,26.650559876195484,27.6821246662748,27.845576923076926,28.592187607967585,27.098966238186268,23.75470000000001,25.06449999999999,26.406449999999985,27.800500000000028,27.939999999999994,1934744,2921810,58.84605178163336,0.2774552960100492,1.5,2.75,NaN,NaN,0.5127268181908332,0.6621731050273632,679.8508435476871,-0.08042380000130323,0.43105830506524256,0.5114821050665458,17.23090466920495,0.15181282371852267,45.92607631946214,22.17947218148213,31.89445149905574,4934083108
1484836200,28.075,28.125,27.54025,27.7375,28.208684210526314,29.184053846153844,28.245,21.64,25.1025,21.64,22.245,19.0675,22.8675,14.68,23.790962500000013,25.09622499999999,26.528399999999984,27.803500000000025,26.69318497908978,27.68739850758196,27.885000000000005,28.545535912958332,27.224464087041678,23.790962500000013,25.09622499999999,26.528399999999984,27.803500000000025,27.800916666666666,2534944,2919151.8,54.08094470912776,0.46957348206795857,1.5,2.75,NaN,NaN,0.5178713311772023,0.8683837544864916,675.8756457158556,-0.10042907732135198,0.3859457584148558,0.48637483573620777,15.384383129467183,-0.6892230576441067,18.16235176249856,51.32605712768928,30.511591109812155,4931548164
1484922600,28.005,28.2325,27.775,28.01,28.340657894736843,29.22284358974359,28.245,21.64,25.1025,21.64,22.245,19.0675,22.8675,14.68,23.825312500000013,25.132049999999996,26.627449999999985,27.804000000000023,26.744824783831355,27.71812245924082,27.967500000000005,28.338522495689542,27.596477504310467,23.825312500000013,25.132049999999996,26.627449999999985,27.804000000000023,28.005833333333335,3196856,2941590,57.4512703725343,0.44337024735842656,1.5,2.75,NaN,NaN,0.5162376646645451,1.0867782389795995,678.542135823005,-0.09474721254087859,0.36794082006010953,0.4626880326009881,16.504858095529244,-0.8320056647194173,50.79293254950638,18.54022713163184,30.666840318861787,4934745020
1485181800,27.88,28.042475,27.4775,27.81,28.472631578947368,29.261633333333332,28.245,21.64,25.1025,21.64,22.245,19.0675,22.8675,14.68,23.862437500000013,25.162299999999995,26.71604999999998,27.805000000000025,26.786596360936006,27.726872701217886,27.990769230769235,28.27008422124652,27.71145424029195,23.862437500000013,25.162299999999995,26.71604999999998,27.805000000000025,27.776658333333334,3571596,3000675.2,54.30108848287982,0.42646534978905876,1.5,2.75,NaN,NaN,0.519718902902792,1.1902641112240337,679.8944778022502,-0.10320089556614215,0.33368691314331045,0.4368878087094526,15.386691864884424,-0.5986953802162467,18.63306030729459,50.64718357398814,30.719756118717278,4931173424
1485268200,27.885,28.5,27.8425,28.3275,28.604605263157893,29.300423076923078,28.245,21.64,25.1025,21.64,22.245,19.0675,22.8675,14.68,23.901275000000012,25.198999999999998,26.799999999999983,27.83925000000002,26.847023954624788,27.784075301101897,28.016346153846158,28.348435202287497,27.684257105404818,23.901275000000012,25.198999999999998,26.799999999999983,27.83925000000002,28.22333333333333,2754152,2969216,60.35806489249492,1.5226957982451113,1.5,2.75,NaN,NaN,0.5318818384097355,0.9275687588912359,684.0048730189185,-0.07404692056617451,0.34432915800173447,0.418376078567909,18.1914086323538,1.3415615776764154,42.49710023213057,24.944408470853823,32.558491297015614,4933927576
1485354600,28.7325,29.065,28.67,29.03,28.73657894736842,29.33921282051282,28.245,21.64,25.1025,21.64,22.245,19.0675,22.8675,14.68,23.944437500000014,25.244775,26.89489999999998,27.904875000000022,26.93263085836499,27.90273479623505,28.100961538461544,28.729851092362637,27.47207198456045,23.944437500000014,25.244775,26.89489999999998,27.904875000000022,28.921666666666667,3774420,3025215,66.7924558184364,3.0406785171453565,1.5,2.75,NaN,NaN,0.5465688499518973,1.247653472563107,687.0209589251135,-0.01087445792516567,0.4047830061614519,0.4156574640866176,22.429740304569002,2.9980486074153005,50.271812980200615,18.90222038891961,30.825966630879773,4937701996
1485441000,29,29.1125,28.85775,28.9625,28.868552631578947,29.378002564102566,28.245,21.64,25.1025,21.64,22.245,19.0675,22.8675,14.68,23.984325000000013,25.2898,26.99119999999998,27.95712500000002,27.01223356980166,28.003664815641233,28.15615384615385,28.934175537033536,27.378132155274162,23.984325000000013,25.2898,26.99119999999998,27.95712500000002,28.97758333333333,3257288,3098817.6,65.68916884260084,2.6260353531717104,1.5,2.75,NaN,NaN,0.5257246463839047,1.0511389892712626,685.9563776302688,0.02119371279212029,0.4421496050767679,0.42095589228464764,22.477013910144297,3.502188868042515,45.66039742416501,22.375855442164582,31.963747133670406,4934444708
1485527400,28.9975,29.0625,28.75,28.8475,29.000526315789475,29.416792307692308,28.245,21.64,25.1025,21.64,22.245,19.0675,22.8675,14.68,24.02056250000001,25.330499999999997,27.084449999999983,28.035875000000015,27.084204802358457,28.08403007129445,28.223076923076924,29.074338777950107,27.37181506820374,24.02056250000001,25.330499999999997,27.084449999999983,28.035875000000015,28.886666666666667,2080684,3067604.8,63.756902280177485,2.009116710604195,1.5,2.75,NaN,NaN,0.5104943144993401,0.678276419439688,683.8350572867091,0.029005605632910325,0.45721289932578557,0.42820729369287525,22.027588282440657,2.44140625,23.866557107222256,43.801195785067016,32.33224710771072,4932364024
1485786600,28.525,28.5325,27.86665,28.325,29.1325,29.45558205128205,28.245,21.64,25.1025,21.64,22.245,19.0675,22.8675,14.68,24.05410000000001,25.363625,27.156199999999984,28.09087500000002,27.132863437560086,28.106979588314026,28.25173076923077,29.08960441634035,27.413857122121193,24.05410000000001,25.363625,27.156199999999984,28.09087500000002,28.24138333333333,4163788,3106257.4,55.735047670613866,0.47826739281439995,1.5,2.75,NaN,NaN,0.5440911491779586,1.3404516959863018,679.7908932002885,-0.004867186556518521,0.42212331049722707,0.4269904970537456,25.00305506353234,1.6781836130305934,21.92267199178228,46.23897031372134,31.838357694496388,4928200236
1485873000,28.0775,28.295,27.83,28.2875,29.264473684210525,29.494371794871796,28.245,21.64,25.1025,21.64,22.245,19.0675,22.8675,14.68,24.087875000000007,25.396424999999994,27.229099999999985,28.158375000000017,27.17814330275381,28.124172008474595,28.25961538461539,29.09675760705535,27.422473162175432,24.087875000000007,25.396424999999994,27.229099999999985,28.158375000000017,28.137499999999996,2991032,3010627,55.19825988931059,0.6509996649416487,1.5,2.75,NaN,NaN,0.5405846385223902,0.9934913890030216,682.305138329831,-0.03212880376337485,0.386829492349527,0.41895829611290186,23.997897011524845,0.8916629514043691,6.720551013283107,71.37749205374095,21.90195693297596,4925209204
1485959400,28.5525,28.668,28.0625,28.325,29.396447368421054,29.53316153846154,29.03,21.64,25.1025,21.64,22.245,19.0675,22.8675,14.68,24.119562500000008,25.43144999999999,27.29589999999999,28.199250000000017,27.223118075194837,28.14329848385797,28.285961538461542,29.107981888344256,27.46394118857883,24.119562500000008,25.43144999999999,27.29589999999999,28.199250000000017,28.35183333333333,3903228,3027924.4,55.65816956337499,0.2309901816297215,1.5,2.75,NaN,NaN,0.5452214500565052,1.2890770984903057,681.2791599777458,-0.04895801272013833,0.35776078021272895,0.4067187929328673,23.79419948742929,2.1180712032446998,6.820473213023855,71.1504666867728,22.02906010020335,4929112432
1486045800,28.155,28.4825,28.0075,28.345,29.52842105263158,29.57195128205128,29.03,21.64,25.1025,21.64,22.245,19.0675,22.8675,14.68,24.15033750000001,25.484649999999988,27.366499999999988,28.21675000000002,27.26711344479504,28.16250815206197,28.300192307692306,29.11939797722474,27.480986638159873,24.15033750000001,25.484649999999988,27.366499999999988,28.21675000000002,28.278333333333332,2627384,2981859,55.918078725042776,0.12672008821517686,1.5,2.75,NaN,NaN,0.5402056321953264,0.8811228163370568,682.8531604470843,-0.059371399255243595,0.3325045438638128,0.3918759431190564,22.600264072015214,1.1960014280613969,22.545420337056584,45.44543123956431,32.009148423379116,4931739816
1486132200,28.735,29.01,28.6125,28.93,29.660394736842107,29.610741025641026,29.03,21.64,25.1025,21.64,22.245,19.0675,22.8675,14.68,24.18376250000001,25.533649999999984,27.43784999999999,28.26675000000002,27.332324682254058,28.235602613770354,28.382692307692306,29.222704811121368,27.542679804263244,24.18376250000001,25.533649999999984,27.43784999999999,28.26675000000002,28.850833333333334,3748256,3001666.4,62.78866471927681,1.8684586381066755,1.5,2.75,NaN,NaN,0.5491195156099461,1.2487250415302646,687.2311356259388,-0.029025286176632636,0.35559433539826557,0.3846196215748982,24.64184628049573,4.0273282991729635,46.13904463447978,22.00056667047185,31.860388695048382,4935488072
1486391400,28.7575,28.9225,28.64,28.795,29.792368421052632,29.64953076923077,29.03,21.64,25.1025,21.64,22.245,19.0675,22.8675,14.68,24.218275000000013,25.591749999999983,27.50314999999999,28.294250000000016,27.389684498636253,28.288878555316035,28.440961538461536,29.282200410742583,27.59972266618049,24.218275000000013,25.591749999999983,27.50314999999999,28.294250000000016,28.785833333333333,2288344,2946747.8,60.447280858824705,1.1373683929797966,1.5,2.75,NaN,NaN,0.5306109787806642,0.7765659483991131,684.6937954362726,-0.020605265225335623,0.35886304004322866,0.3794683052685643,24.297448962108128,1.6503397758362055,58.58303022156979,13.491413016922525,27.925556761507686,4933199728
1486477800,28.955,29.0475,28.6975,28.795,29.924342105263158,29.688320512820514,29.03,21.64,25.1025,21.64,22.245,19.0675,22.8675,14.68,24.252737500000013,25.650274999999983,27.567499999999992,28.335125000000016,27.44479491045444,28.33708059766689,28.522307692307688,29.275645040222496,27.76897034439288,24.252737500000013,25.650274999999983,27.567499999999992,28.335125000000016,28.846666666666668,2212580,2957606.8,60.447280858824705,1.1816029763192333,1.5,2.75,NaN,NaN,0.5177101945820451,0.7480980906589747,683.2428429360525,-0.017707137269289963,0.3573343836819518,0.37504152095124177,22.376944653820907,-0.809507406131586,79.81820466637738,3.523559706648385,16.658235626974243,4933199728
1486564200,28.6525,28.94,28.55,28.89,30.056315789473686,29.727110256410256,29.03,21.64,25.1025,21.64,22.245,19.0675,22.8675,14.68,24.288287500000013,25.702799999999982,27.628299999999996,28.382000000000016,27.501469619848383,28.38973958836528,28.589999999999996,29.304164385299888,27.875835614700105,24.288287500000013,25.702799999999982,27.628299999999996,28.382000000000016,28.793333333333333,1586396,2913139.4,61.61545339490795,1.1121763947759367,1.5,2.75,NaN,NaN,0.5085880378261848,0.5445657698357999,684.8172102625149,-0.012318913311909152,0.3596428793113553,0.37196179262326445,17.16337902446916,-0.2503236944324489,74.60331325676741,5.4209312538218954,19.9757554894107,4934786124
1486650600,29.0125,29.5325,28.995,29.4,30.18828947368421,29.7659,29.03,21.64,25.1025,21.64,22.245,19.0675,22.8675,14.68,24.325787500000015,25.763324999999988,27.706449999999997,28.442750000000018,27.575921791619034,28.485954865663825,28.712307692307686,29.39412218754606,28.030493197069312,24.325787500000015,25.763324999999988,27.706449999999997,28.442750000000018,29.30916666666667,2447600,2876446,67.2137251421143,2.6061554071740045,1.5,2.75,NaN,NaN,0.5181531779814572,0.8509111591178836,687.7565366546734,0.020860002754096107,0.3980367960658846,0.3771767933117885,19.925424627076556,1.9152439552820815,74.34822170441775,5.523121467060116,20.128656828522125,4937233724
1486737000,29.56,29.8425,29.5225,29.74,30.320263157894736,29.804689743589744,29.03,21.64,25.1025,21.64,22.245,19.0675,22.8675,14.68,24.364475000000017,25.827049999999986,27.788849999999996,28.530625000000022,27.660787603712407,28.605387735600605,28.820961538461535,29.655860285112745,27.986062791810326,24.364475000000017,25.827049999999986,27.788849999999996,28.530625000000022,29.701666666666668,2306732,2829119.8,70.32139236542054,3.0714091098354688,1.5,2.75,NaN,NaN,0.5127493795542104,0.8153532416690167,691.3832515903265,0.0588217456180542,0.45070397533435624,0.39188222971630204,20.342561503852263,4.995586937334507,69.53969393906861,7.6099179620592965,22.850388098872102,4939540456
1486996200,29.9775,30.3412,29.965,30.2125,30.452236842105265,29.843479487179486,29.03,21.64,25.1025,21.64,22.245,19.0675,22.8675,14.68,24.408500000000014,25.895399999999984,27.88485,28.63325000000002,27.760854756508,28.758446046495784,28.91192307692307,30.028311749670628,27.795534404175513,24.408500000000014,25.895399999999984,27.88485,28.63325000000002,30.1729,2523288,2815438.4,74.0084668331944,4.003597793054849,1.5,2.75,NaN,NaN,0.5190672810146241,0.8962327145925125,693.5877127768315,0.10611302816963625,0.5245235149283474,0.4184104867587111,16.264919180219888,6.805125939018991,100,0,0,4942063744
1487082600,30.155,30.605,29.99,30.605,30.58421052631579,29.882269230769232,29.03,21.64,25.1025,21.64,22.245,19.0675,22.8675,14.68,24.456225000000007,25.959999999999987,27.993900000000004,28.770625000000024,27.872389864095922,28.9343083277819,29.038269230769227,30.47482277821344,27.601715683325015,24.456225000000007,25.959999999999987,27.993900000000004,28.770625000000024,30.400000000000002,2171964,2803763.8,76.60817729621215,4.082436890470745,1.5,2.75,NaN,NaN,0.5259196180850082,0.7746601193723951,694.4525639083419,0.15142553211664034,0.6076924019045116,0.45626686978787123,15.8208825971868,8.04942630185349,100,0,0,4944235708
1487169000,30.5,31.15,30.475,31.055,30.716184210526315,29.921058974358974,29.03,21.64,25.1025,21.64,22.245,19.0675,22.8675,14.68,24.50373750000001,26.024549999999987,28.111400000000003,28.92150000000002,27.99719810471961,29.13627896323124,29.208076923076916,30.99374115398992,27.422412692163913,24.50373750000001,26.024549999999987,28.111400000000003,28.92150000000002,30.893333333333338,2554612,2834757.2,79.17942195641372,4.836913457360102,1.5,2.75,NaN,NaN,0.5365682167932218,0.9011748872178541,696.4580508871023,0.19644680588893393,0.7018253771490386,0.5053785712601047,15.643120309697524,9.560769095078502,100,0,0,4946790320
1487255400,31.0675,31.155,30.65,30.9975,30.848157894736843,29.959848717948717,29.03,21.64,25.1025,21.64,22.245,19.0675,22.8675,14.68,24.553725000000014,26.09254999999998,28.219050000000003,29.08450000000002,28.114857002573743,29.31353810959017,29.413653846153842,31.353974612047,27.473333080260684,24.553725000000014,26.09254999999998,28.219050000000003,29.08450000000002,30.934166666666666,3195504,2867785.2,77.99961269855274,3.904021604653893,1.5,2.75,NaN,NaN,0.5343133441651347,1.1142759227573946,693.9949904601808,0.20609024626931904,0.7629913790967535,0.5569011328274345,16.20894049680228,7.146560663670926,68.7455408660607,7.92050997241318,23.333949161526128,4943594816
1487341800,30.675,31.1075,30.6675,31.1075,30.98013157894737,29.998638461538462,29.03,21.64,25.1025,21.64,22.245,19.0675,22.8675,14.68,24.60603750000001,26.167374999999982,28.323700000000002,29.239375000000017,28.23221555149242,29.484391622962534,29.63057692307692,31.64780384087021,27.61335000528363,24.60603750000001,26.167374999999982,28.323700000000002,29.239375000000017,30.960833333333337,2228460,2819365.4,78.65486404494499,3.3405944431172605,1.5,2.75,NaN,NaN,0.5275766767247679,0.7904119132624668,692.5781009946346,0.20327375831285777,0.8109933307185067,0.6077195724056489,14.657780557291316,8.03090814377496,68.81208641045983,7.889063282624696,23.298850306915476,4945823276
1487687400,31.2975,31.7475,31.285,31.65,31.112105263157893,30.037428205128204,29.03,21.64,25.1025,21.64,22.245,19.0675,22.8675,14.68,24.661175000000007,26.243324999999984,28.418950000000006,29.43137500000002,28.36624631417899,29.690640039823244,29.886346153846148,32.016569702411864,27.756122605280435,24.661175000000007,26.243324999999984,28.418950000000006,29.43137500000002,31.560833333333335,2731916,2777381.4,81.57020782358089,4.6393169488594,1.5,2.75,NaN,NaN,0.53560691410157,0.9836301200836155,695.9878177313004,0.21993311120437842,0.8826359614111219,0.6627028502067435,13.490269353181207,9.914915783990264,70.06343044051627,7.311887603213482,22.624681956270237,4948555192
1487773800,31.4875,31.69,31.412475,31.6025,31.244078947368422,30.07621794871795,29.03,21.64,25.1025,21.64,22.245,19.0675,22.8675,14.68,24.714925000000008,26.315199999999987,28.508950000000006,29.595125000000017,28.493158223426875,29.87272194079246,30.136923076923075,32.24924603613733,28.02460011770882,24.714925000000008,26.315199999999987,28.508950000000006,29.595125000000017,31.568324999999998,2665756,2772961.6,80.53305306737266,3.8454155285120035,1.5,2.75,NaN,NaN,0.5171724916657436,0.9613389525480627,694.1201989265119,0.2097725393220785,0.9249185243593416,0.7151459850372631,13.895803258269192,9.389061959155413,42.47177921029614,24.9735912464825,32.55462954322137,4945889436
1487860200,31.85,31.85,31.3025,31.6575,31.376052631578947,30.115007692307692,29.03,21.64,25.1025,21.64,22.245,19.0675,22.8675,14.68,24.768637500000008,26.394499999999983,28.590350000000004,29.726500000000023,28.61725005780229,30.042700803574128,30.346730769230767,32.479583125020454,28.213878413441076,24.768637500000008,26.394499999999983,28.590350000000004,29.726500000000023,31.603333333333335,3489020,2758691.6,80.83688393080266,3.4311719814572763,1.5,2.75,NaN,NaN,0.5193387422610478,1.2647372399292476,695.7554840097224,0.1893975886390229,0.9518929708360417,0.7624953821970188,14.16718105225132,7.67857142857143,46.82780313338574,21.474174747662627,31.698022118951634,4949378456
1487946600,31.2325,31.7875,31.228325,31.7875,31.508026315789472,30.153797435897435,29.03,21.64,25.1025,21.64,22.245,19.0675,22.8675,14.68,24.81931250000001,26.469424999999983,28.676350000000003,29.867750000000022,28.7415735849473,30.20887215561469,30.576923076923077,32.63481889719693,28.519027256649224,24.81931250000001,26.469424999999983,28.676350000000003,29.867750000000022,31.60110833333333,2390688,2715361.6,81.56911082589487,2.7320441728101073,1.5,2.75,NaN,NaN,0.5221841892424015,0.8804308052378733,696.4182451555725,0.16804320116249694,0.97254938365014,0.804506182487643,13.341890363424163,6.884667114996647,76.88446311572717,4.507379279872235,18.60815760440059,4951769144
1488205800,31.735,31.9725,31.6025,31.905,31.64,30.19258717948718,29.03,21.64,25.1025,21.64,22.245,19.0675,22.8675,14.68,24.873337500000005,26.547824999999985,28.7542,30.020625000000024,28.865629522792503,30.370408140794243,30.816153846153842,32.70605170194538,28.926255990362307,24.873337500000005,26.547824999999985,28.7542,30.020625000000024,31.826666666666668,3122296,2767442.2,82.23002572652575,3.1346398763502465,1.5,2.75,NaN,NaN,0.5113138900108015,1.1282244666211998,698.6702284084918,0.14601362871182433,0.9870232183774235,0.8410095896655991,13.30412698665811,5.601985932974771,79.2559039370736,3.692642651872971,17.051453411053433,4954891440
1488292200,31.7325,31.8325,31.4375,31.645,31.771973684210526,30.231376923076922,29.03,21.64,25.1025,21.64,22.245,19.0675,22.8675,14.68,24.92616250000001,26.626799999999985,28.84,30.18662500000002,28.974624443467306,30.491797841670984,31.02807692307692,32.59711772982939,29.45903611632445,24.92616250000001,26.626799999999985,28.84,30.18662500000002,31.63833333333333,2719584,2695232,75.7565213691607,1.9964840062353544,1.5,2.75,NaN,NaN,0.5081843264386016,1.0090352147792843,695.8650262983926,0.10029172730334923,0.9663742487947857,0.8660825214914365,14.58260006389035,3.3981375592223464,52.929850574485435,17.091304709252025,29.978844716262536,4952171856
1488378600,32.415,33.19,32.4125,32.9575,31.903947368421054,33.19,29.03,21.64,25.1025,21.64,22.245,19.0675,22.8675,14.68,24.98833750000001,26.716149999999985,28.945549999999997,30.42012500000002,29.130815641762705,30.7266266186547,31.301730769230765,32.88040156432705,29.72305997413448,24.98833750000001,26.716149999999985,28.945549999999997,30.42012500000002,32.85333333333333,3872076,2739284.2,83.02249166829496,5.370985851737583,1.5,2.75,NaN,NaN,0.5822425888358441,1.4135356966611934,699.61828575142,0.14224144194432053,1.0438843239218372,0.9016428819775166,25.155373592332896,6.126227660602169,80.81772730123804,3.186688845035863,15.995583853726094,4956043932
1488465000,32.8825,32.8875,32.325,32.3725,32.03592105263158,33.28494038461538,29.03,21.64,25.1025,21.64,22.245,19.0675,22.8675,14.68,25.044612500000014,26.79897499999998,29.04245,30.622500000000013,29.257940518556325,30.883376464497108,31.504230769230766,32.893654258717,30.114807279744532,25.044612500000014,26.79897499999998,29.04245,30.622500000000013,32.528333333333336,3061748,2697210.2,72.58099324944169,3.360132036303678,1.5,2.75,NaN,NaN,0.5858324039189983,1.1351536487590028,695.6065382958766,0.11552473957084641,1.0460488064410747,0.9305240668702283,28.447558875485452,4.435841600129054,52.06244214865759,17.689518697186134,30.248039154156274,4952982184
1488551400,32.3125,32.48,32.1275,32.4225,32.16789473684211,33.379880769230766,29.03,21.64,25.1025,21.64,22.245,19.0675,22.8675,14.68,25.10388750000001,26.88477499999998,29.137349999999998,30.826375000000013,29.382040890377645,31.029959658354525,31.674230769230768,32.9236081289513,30.424853409510234,25.10388750000001,26.88477499999998,29.137349999999998,30.826375000000013,32.34333333333333,3098576,2720769.8,72.89476872941748,2.458403112436765,1.5,2.75,NaN,NaN,0.5691658036390698,1.1388600388022538,696.3445867002204,0.08743070326243463,1.0398124459482716,0.952381742685837,28.251654717503044,4.227276380294134,54.6885124293111,15.910324036863742,29.40116353382515,4956080760
1488810600,32.02,32.275,31.83,32.12,32.29986842105263,33.47482115384615,29.03,21.64,25.1025,21.64,22.245,19.0675,22.8675,14.68,25.16165000000001,26.96409999999998,29.219749999999994,30.985875000000014,29.48941183585303,31.133773024225523,31.79076923076923,32.89348856987071,30.68804989166775,25.16165000000001,26.96409999999998,29.219749999999994,30.985875000000014,32.074999999999996,2941596,2680436.8,67.83683733477548,1.5985441491063648,1.5,2.75,NaN,NaN,0.5708325319505648,1.0974315827927748,692.6807208397557,0.03725111777960155,0.9989456399103389,0.9616945221307374,29.35875822751107,1.4849921011058416,27.246588042277942,39.82323265857206,32.93017929915,4953139164
1488897000,31.97,32.13,31.725,31.8475,32.43184210526316,33.569761538461535,29.03,21.64,25.1025,21.64,22.245,19.0675,22.8675,14.68,25.219137500000006,27.04952499999998,29.3009,31.138500000000015,29.58188588150585,31.20174702191833,31.85173076923077,32.869347488326056,30.834114050135486,25.219137500000006,27.04952499999998,29.3009,31.138500000000015,31.90083333333333,3066784,2719358.8,63.558490792368914,0.6778314376668182,1.5,2.75,NaN,NaN,0.5589873510969532,1.1277599704753931,689.3202254457805,-0.022311138186741908,0.93380559939731,0.9561167375840519,28.554530344401527,0.7752551222213464,26.01319073929166,41.24232470545564,32.74448455525272,4950072380
1488983400,31.9575,32.07,31.575,31.6625,32.563815789473686,33.66470192307692,32.9575,21.64,25.1025,21.64,22.245,19.0675,22.8675,14.68,25.273937500000006,27.132299999999976,29.381299999999996,31.28187500000002,29.663478592035034,31.245628257926107,31.902884615384615,32.8037556600149,31.002013570754333,25.273937500000006,27.132299999999976,29.381299999999996,31.28187500000002,31.769166666666667,4086140,2813036.8,60.75695440421358,0.2773492188639146,1.5,2.75,NaN,NaN,0.5544168260185994,1.452572536555512,685.3307815433546,-0.07899702117884544,0.8573704611104951,0.9363674822893405,28.77859231051914,0.015794045644799994,4.510618191039537,76.87378580503453,18.615596003925944,4945986240
1489069800,31.69,31.905,31.3075,31.7475,32.695789473684215,33.7596423076923,32.9575,21.64,25.1025,21.64,22.245,19.0675,22.8675,14.68,25.329475000000006,27.218224999999975,29.461899999999996,31.424750000000017,29.74520492175915,31.29342556669505,31.952115384615386,32.736108727782394,31.168122041448378,25.329475000000006,27.218224999999975,29.461899999999996,31.424750000000017,31.653333333333336,3415984,2904516.2,61.59457462282038,0.12107272012762967,1.5,2.75,NaN,NaN,0.5574941955886995,1.1760939739292897,682.024222405318,-0.11349766223838376,0.7944954044913608,0.9079930667297446,28.802159220598664,-0.12583562721196287,20.74806673142157,47.7768247149426,31.47510855363583,4949402224
1489156200,32.2075,32.2175,31.65125,32.055,32.827763157894736,33.85458269230769,32.9575,21.64,25.1025,21.64,22.245,19.0675,22.8675,14.68,25.38255000000001,27.307124999999974,29.544649999999997,31.557500000000015,29.83578512090585,31.365956465105043,31.98326923076923,32.74873385743369,31.217804604104774,25.38255000000001,27.307124999999974,29.544649999999997,31.557500000000015,31.974583333333342,3942536,2979263,64.54304494981233,0.7220690261253752,1.5,2.75,NaN,NaN,0.5581196101895067,1.323325936649433,684.9803581834477,-0.11782632851031272,0.7607101560918537,0.8785364846021664,29.241736754306697,0.47014574518100166,23.96859866301559,43.6832987217142,32.34810261527021,4953344760
1489411800,32.055,32.1375,31.9,32.11,32.959736842105265,33.94952307692307,32.9575,21.64,25.1025,21.64,22.245,19.0675,22.8675,14.68,25.43386250000001,27.398874999999975,29.641399999999994,31.676000000000016,29.92497001812523,31.43681775414266,32.02230769230769,32.757270960721264,31.28734442389412,25.43386250000001,27.398874999999975,29.641399999999994,31.676000000000016,32.049166666666665,1492664,2938559.6,65.05973796675862,0.7898838922514289,1.5,2.75,NaN,NaN,0.5352182094616851,0.507957708259516,687.0803191510787,-0.11886227975237029,0.7299586349117035,0.8488209146640738,29.193304204263775,1.4694264496760938,41.94817614821395,25.43438505929978,32.617438792486254,4954837424
1489498200,31.865,31.8775,31.465,31.7375,33.091710526315794,34.044463461538456,32.9575,21.64,25.1025,21.64,22.245,19.0675,22.8675,14.68,25.48312500000001,27.482924999999977,29.731649999999995,31.752250000000014,29.996049625257573,31.465454158510024,32.02846153846154,32.752360007918995,31.30456306900409,25.48312500000001,27.482924999999977,29.731649999999995,31.752250000000014,31.69333333333333,3264456,2975618,58.80910502356817,0.2958988847600533,1.5,2.75,NaN,NaN,0.5430597659287075,1.09706823926996,684.0042398037693,-0.14479125483138344,0.6678318461248445,0.8126231009562279,29.642766171123572,-3.701737085640605,41.04510927098005,26.205202880745965,32.74968784827399,4951572968
1489584600,32.025,32.7575,31.908925,32.5325,33.223684210526315,34.13940384615384,32.9575,21.64,25.1025,21.64,22.245,19.0675,22.8675,14.68,25.535025000000008,27.572999999999976,29.843549999999997,31.848625000000016,30.095518267404334,31.56707757198526,32.08576923076923,32.841545410028736,31.329993051509724,25.535025000000008,27.572999999999976,29.843549999999997,31.848625000000016,32.39964166666667,4504880,3092263.8,66.25963263505345,1.8262494588053506,1.5,2.75,NaN,NaN,0.5771269255052284,1.4568226682341916,690.4455569080374,-0.11012632420900359,0.6749651956949734,0.785091519903977,22.21425699876252,0.49424665997373257,77.61201728154835,4.250630904163781,18.13735181428788,4956077848
1489671000,32.655,32.669975,32.225,32.4,33.355657894736844,34.23434423076923,32.9575,21.64,25.1025,21.64,22.245,19.0675,22.8675,14.68,25.586775000000006,27.662999999999975,29.941399999999998,31.915875000000018,30.185890100055143,31.64640351751047,32.12384615384615,32.88917317139289,31.358519136299414,25.586775000000006,27.662999999999975,29.941399999999998,31.915875000000018,32.43165833333333,5067852,3217925.8,64.17613602362606,1.4371041588251052,1.5,2.75,NaN,NaN,0.5676875022548549,1.5748815587979066,692.5705190059407,-0.0982393833580757,0.6622922907063824,0.7605316740644581,19.712955070755243,-0.06939625260236211,40.59576146683631,26.593743756284862,32.81049477687883,4951009996
1489757400,32.5175,32.58,32.2125,32.2125,33.48763157894737,34.329284615384616,32.9575,21.64,25.1025,21.64,22.245,19.0675,22.8675,14.68,25.636987500000004,27.750824999999978,30.025750000000002,31.97662500000002,30.265364998092195,31.70031746822376,32.167500000000004,32.88162129975883,31.45337870024118,25.636987500000004,27.750824999999978,30.025750000000002,31.97662500000002,32.335,2408440,3178572.6,61.241465005042585,1.2056564566271397,1.5,2.75,NaN,NaN,0.5533883949509366,0.7577111814277893,695.1988351925917,-0.1045384423780591,0.6298586210918842,0.7343970634699433,19.962745971045106,0.2879825653798292,17.588594013024693,52.16423954481479,30.247166442160513,4948601556
1490016600,32.185,32.325,31.915,32.075125,33.619605263157894,34.424225,32.9575,21.64,25.1025,21.64,22.245,19.0675,22.8675,14.68,25.685525625000004,27.834501249999974,30.1086525,32.02500625000002,30.33633597855917,31.736013423631018,32.099625,32.649293973809904,31.549956026190102,25.685525625000004,27.834501249999974,30.1086525,32.02500625000002,32.10504166666667,2757776,3205038.4,59.10876931196922,0.2906982531334372,1.5,2.75,NaN,NaN,0.5431463667401557,0.8604502211268358,693.0753731823144,-0.11846880205823829,0.5863110608971454,0.7047798629553836,19.353976506600556,0.7147342805557728,7.98645716448594,68.60885952313035,23.4046833123837,4945843780
1490103000,32.375,32.4325,30.8,30.88,33.75157894736842,34.519165384615384,32.9575,21.64,25.1025,21.64,22.245,19.0675,22.8675,14.68,25.729013125000005,27.908226249999974,30.161352500000007,31.98650625000002,30.357656136262733,31.65448833566616,31.98481730769231,32.81197478162723,31.157659833757396,25.729013125000005,27.908226249999974,30.161352500000007,31.98650625000002,31.370833333333334,6515244,3394204.8,44.56776292873076,2.5453239051723817,1.5,2.75,NaN,NaN,0.6209573405444301,1.9195200006788042,688.5191646549774,-0.20368518021557502,0.45017338768591486,0.6538585679014899,28.977575015891453,-2.471377812870122,5.720941597072394,73.74247481971315,20.536583583214448,4939328536
1490189400,30.875,31.19,30.585,31.05,33.88355263157895,34.61410576923077,32.9575,21.64,25.1025,21.64,22.245,19.0675,22.8675,14.68,25.771738125000006,27.985201249999978,30.222802500000007,31.95888125000002,30.384806876017137,31.59691801798367,31.879240384615386,32.80094929318152,30.95753147604925,25.771738125000006,27.985201249999978,30.222802500000007,31.95888125000002,30.941666666666666,3771076,3449470.8,46.58083764955074,2.5576343306043836,1.5,2.75,NaN,NaN,0.6198175305055422,1.0932331997128373,689.7084562148627,-0.2415317423122495,0.351943890011178,0.5934756323234275,29.31080543577181,-2.197023387668314,3.8931962933185584,78.6147517030239,17.49205200365753,4943099612
1490275800,30.9625,31.4775,30.8,30.96,34.01552631578947,34.70904615384615,32.9575,21.64,25.1025,21.64,22.245,19.0675,22.8675,14.68,25.813525625000008,28.063201249999977,30.282952500000007,31.92400625000002,30.407363469114504,31.536259159128083,31.790009615384616,32.819506694160026,30.76051253660921,25.813525625000008,28.063201249999977,30.282952500000007,31.92400625000002,31.07916666666667,3348196,3442429.6,45.6359442786074,1.762968849782797,1.5,2.75,NaN,NaN,0.6239377068980033,0.9726258454203391,692.6485357710329,-0.2637459349793676,0.26379321359921803,0.5275391485785856,29.16290396786594,-3.4160037435657427,4.799510528381531,76.09289116017908,19.107598311439407,4939751416
1490362200,31.1125,31.3525,30.5425,30.9125,34.1475,34.80398653846154,32.9575,21.64,25.1025,21.64,22.245,19.0675,22.8675,14.68,25.85400062500001,28.142901249999976,30.337502500000006,31.88025625000002,30.427172744835502,31.476853524925406,31.718086538461538,32.847283485004894,30.588889591918182,25.85400062500001,28.142901249999976,30.337502500000006,31.88025625000002,30.935833333333335,4364012,3541095.8,45.1157809029703,2.035556297955622,1.5,2.75,NaN,NaN,0.637227870691003,1.2323902674420726,693.8976734045971,-0.2716841756021514,0.18793392907589634,0.45961810467804776,28.149140649668748,-3.729367798193703,3.934707355065025,78.49376992994546,17.571522714989523,4935387404
1490621400,30.115,30.91,30,30.78,30,34.89892692307692,32.9575,21.64,25.1025,21.64,22.245,19.0675,22.8675,14.68,25.894213125000007,28.221501249999978,30.393452500000002,31.824006250000018,30.44100910778313,31.410486522551558,31.650201923076924,32.885707049994274,30.41469679615958,25.894213125000007,28.221501249999978,30.393452500000002,31.824006250000018,30.563333333333333,3237760,3546869,43.622138502026296,2.773535179138719,1.5,2.75,NaN,NaN,0.6568901656416457,0.9128501785659409,693.1208540717647,-0.27506366859617326,0.11578851893283115,0.3908521875290044,27.942720935805138,-3.016935801496651,3.4241336717860467,80.07602053525018,16.499845792963768,4932149644
1490707800,30.655,31.637475,30.62,31.4325,30.058189655172413,34.993867307692305,32.9575,21.64,25.1025,21.64,22.245,19.0675,22.8675,14.68,25.940875625000004,28.31132624999998,30.4589025,31.81338125000002,30.47989110355634,31.412583044213314,31.625971153846155,32.86524283881745,30.38669946887486,25.940875625000004,28.31132624999998,30.4589025,31.81338125000002,31.22999166666667,2798888,3550834.2,52.04238907975848,0.8234023469469156,1.5,2.75,NaN,NaN,0.6826462252386708,0.7882339310576653,696.4386846882971,-0.22468487644975843,0.10999609196680638,0.3346809684165648,30.88087441431681,-3.381234150464913,17.47404931058259,52.379793548218636,30.146157141198774,4934948532
1490794200,31.335,31.65,31.2175,31.5625,30.11637931034483,35.08880769230769,32.9575,21.64,25.1025,21.64,22.245,19.0675,22.8675,14.68,25.990825625000003,28.40667624999998,30.5330025,31.74363125000002,30.522346354397268,31.42686084952633,31.58808653846154,32.80244121587023,30.373731861052843,25.990825625000003,28.40667624999998,30.5330025,31.74363125000002,31.47666666666667,2461564,3480308.6,53.53148519025407,0.44069435021992154,1.5,2.75,NaN,NaN,0.6647786377216226,0.7072832564330646,699.3787919600188,-0.17608499924191212,0.11457471936417463,0.29065971860608675,26.577992754519702,-2.584876543209872,12.939410044582486,59.42880059799891,27.63178935741861,4937410096
1490880600,31.5125,31.93,31.4425,31.8125,30.174568965517242,35.183748076923074,32.9575,21.64,25.1025,21.64,22.245,19.0675,22.8675,14.68,26.042713125,28.50747624999998,30.6085025,31.715631250000023,30.572940615009138,31.463588387666682,31.565201923076923,32.750210295079405,30.38019355107444,26.042713125,28.50747624999998,30.6085025,31.715631250000023,31.728333333333335,2553500,3454896.2,56.33911025458663,1.04729331274915,1.5,2.75,NaN,NaN,0.6521158778843639,0.7390960110465836,702.3384361397955,-0.1230883443352499,0.13679928818702436,0.25988763252227426,27.28096968723535,-1.2417539774932047,33.46417032635248,33.28167524349093,33.2541544301566,4939963596
1490967000,31.6675,31.9062,31.58,31.5875,30.232758620689655,35.27868846153846,32.9575,21.64,25.1025,21.64,22.245,19.0675,22.8675,14.68,26.093938125,28.60695124999998,30.685502500000002,31.673881250000022,30.6127272575578,31.47538949360319,31.55366346153846,32.73465073343877,30.372676189638153,26.093938125,28.60695124999998,30.685502500000002,31.673881250000022,31.69123333333333,2183004,3409117.6,53.222362466973316,0.7339888848867654,1.5,2.75,NaN,NaN,0.628836172321195,0.6403428265425634,703.06621427697,-0.10014689364817761,0.13470401546205224,0.23485090911022985,27.359735418926345,-1.5202590792709345,44.87797277353864,23.06398146237893,32.05804576408242,4937780592
1491226200,31.65,31.7125,30.865,31.4625,30.290948275862068,35.37362884615384,32.9575,21.64,25.1025,21.64,22.245,19.0675,22.8675,14.68,26.143438125,28.69100124999998,30.754552500000003,31.64100625000002,30.646051678830045,31.474161922783836,31.471355769230765,32.508362722726076,30.43434881573545,26.143438125,28.69100124999998,30.754552500000003,31.64100625000002,31.346666666666664,4154460,3469760.8,51.51723671155032,0.4879413784074334,1.5,2.75,NaN,NaN,0.6444550171553953,1.1973332570936879,700.9041091002542,-0.09063607004382088,0.12155582155545375,0.21219189159927462,27.350775613120053,1.8863341968911904,39.14452302376209,27.900176372946227,32.955300603291704,4933626132
1491312600,31.285,31.525,31.1275,31.5125,30.349137931034484,35.468569230769226,32.9575,21.64,25.1025,21.64,22.245,19.0675,22.8675,14.68,26.194513125,28.772326249999978,30.828602500000006,31.624256250000023,30.68003004436612,31.477813168232995,31.403086538461537,32.29298193737419,30.51319113954888,26.194513125,28.772326249999978,30.828602500000006,31.624256250000023,31.388333333333332,4488448,3540844,52.17723322180306,0.36052723012649657,1.5,2.75,NaN,NaN,0.6268153730728668,1.2676209400922491,701.4970361615358,-0.07866720728414084,0.11385788249409856,0.1925250897782394,14.87509038805901,1.489533011272137,46.006193234212226,22.156128591063386,31.837678174724388,4938114580
1491399000,31.7925,32.255,31.1225,31.18,30.407327586206897,35.56350961538461,32.9575,21.64,32.9575,21.64,25.1025,19.0675,22.245,14.68,26.241963125,28.842826249999977,30.885652500000006,31.60013125000002,30.69963670929294,31.44945000935366,31.323663461538462,32.085510012465726,30.561816910611203,26.241963125,28.842826249999977,30.885652500000006,31.60013125000002,31.519166666666663,4515048,3562289.4,47.5423261575377,0.5289485015753307,1.5,2.75,NaN,NaN,0.6629357035676623,1.2674568214474657,698.6590696264875,-0.09001607869762407,0.08000499140620931,0.17002107010383338,16.300420227956973,0.7105943152454743,19.458089813651473,49.57120249818435,30.970707688164183,4933599532
1491485400,31.2675,31.695,31.0925,31.445,30.46551724137931,35.658449999999995,32.9575,21.64,32.9575,21.64,25.1025,19.0675,22.245,14.68,26.289750625,28.914426249999977,30.933952500000004,31.585006250000028,30.728866642261842,31.449026198939027,31.275192307692308,31.909061566046418,30.641323049338197,26.289750625,28.914426249999977,30.933952500000004,31.585006250000028,31.410833333333333,1854572,3484218.8,51.258513993616546,0.13850992363321366,1.5,2.75,NaN,NaN,0.6586188675985435,0.5322777088511204,702.1512211053354,-0.07704890857586494,0.0737099343840022,0.15075884295986713,16.750802196116307,1.7226041245450832,16.835339032770097,53.294453436935264,29.870207530294646,4935454104
1491571800,31.335,31.67475,31.1425,31.36,30.523706896551722,35.75339038461538,32.9575,21.64,32.9575,21.64,25.1025,19.0675,22.245,14.68,26.337775625,28.98655124999998,30.9819025,31.55025625000003,30.753616970016278,31.440547513325786,31.312115384615385,31.904142041219778,30.720088728010992,26.337775625,28.98655124999998,30.9819025,31.55025625000003,31.392416666666666,1833840,3378784,50.03414355787754,0.2043831564911133,1.5,2.75,NaN,NaN,0.6495925199129333,0.5427514750868951,701.1981225025849,-0.07168124747298363,0.06115728361863759,0.13283853109162122,16.8428687681234,1.8843404808317032,17.633756458868863,52.131362868451625,30.234880672679523,4933620264
1491831000,31.415,31.775,31.175025,31.3975,30.58189655172414,35.84833076923076,32.9575,21.64,32.9575,21.64,25.1025,19.0675,22.245,14.68,26.381650625,29.05867624999998,31.0329025,31.51463125000003,30.7788672849176,31.436447750151903,31.338846153846152,31.912205402836143,30.76548690485616,26.381650625,29.05867624999998,31.0329025,31.51463125000003,31.449174999999997,2067624,3407532,50.59482513831027,0.19312249433225076,1.5,2.75,NaN,NaN,0.6460484113477235,0.6067805085909684,704.0475167573428,-0.06337715318055029,0.05361708961593337,0.11699424279648366,16.450158981338454,-0.1113497176489307,43.68836042425976,23.962503693100665,32.34913588263958,4935687888
1491917400,31.2325,31.332475,30.6175,31.3025,30.64008620689655,35.94327115384615,32.9575,21.64,32.9575,21.64,25.1025,19.0675,22.245,14.68,26.437250624999997,29.124326249999978,31.0924525,31.492881250000032,30.79940190119534,31.42369082156601,31.365192307692308,31.896426217995124,30.83395839738949,26.437250624999997,29.124326249999978,31.0924525,31.492881250000032,31.08415833333333,2908820,3389750.2,49.09192529695844,1.0595279989488868,1.5,2.75,NaN,NaN,0.6556163819657433,0.8581222297737455,706.599026914413,-0.06197926490160646,0.039520161669475584,0.10149942657108205,11.274607477968352,-0.8237623762376287,11.484092719377145,61.866384931636404,26.64952234898645,4932779068
1492003800,31.1725,31.2525,30.7825,30.905,30.698275862068964,36.03821153846153,32.9575,21.64,32.9575,21.64,25.1025,19.0675,22.245,14.68,26.496438124999994,29.18695124999998,31.1448025,31.41150625000003,30.803543003109247,31.374291695702578,31.364615384615384,31.897827155771466,30.8314036134593,26.496438124999994,29.18695124999998,31.1448025,31.41150625000003,30.980000000000004,2782848,3303648.6,43.29662206152334,1.3257667981045969,1.5,2.75,NaN,NaN,0.6459294975396188,0.8423559333762071,703.6391816886143,-0.08414691239297911,-0.0036842139201418433,0.08046269847283727,12.843864058476358,-2.85265225933202,15.572006562019276,55.133084690219135,29.294908747761593,4929996220
1492090200,30.725,31.0525,30.2975,30.3025,30.75646551724138,36.13315192307692,32.9575,21.64,32.9575,21.64,25.1025,19.0675,22.245,14.68,26.547650624999992,29.240126249999975,31.1843525,31.30663125000003,30.783894257889276,31.272216296111857,31.32788461538462,32.04959158275127,30.606177648017972,26.547650624999992,29.240126249999975,31.1843525,31.30663125000003,30.55083333333333,4100388,3255275.4,36.301500329435626,2.1806284074416538,1.5,2.75,NaN,NaN,0.6537202477153602,1.2596132419395298,700.4728524218384,-0.13281374970119203,-0.08555448865365278,0.047259261047539254,14.614490370732932,-4.06806489908983,2.7534360620983382,82.20476723735337,15.041796700548298,4925895832
1492435800,30.5175,31.0725,30.4225,31.0675,30.814655172413794,36.22809230769231,32.9575,21.64,32.9575,21.64,25.1025,19.0675,22.245,14.68,26.597225624999993,29.302651249999975,31.238802500000002,31.249381250000035,30.79501605169754,31.252719506005967,31.299807692307695,32.03138255187295,30.568232832742435,26.597225624999993,29.302651249999975,31.238802500000002,31.249381250000035,30.854166666666668,2580208,3263863.8,47.82735597297717,1.0363010827544337,1.5,2.75,NaN,NaN,0.6620259443071204,0.7905378894793343,704.0898358068347,-0.10796520511047425,-0.08769724534055356,0.020267959769920692,22.32351028570264,-1.255462852602303,13.661136127567401,58.15457405525983,28.184289817172775,4928476040
1492522200,30.7575,31.0375,30.482525,30.7925,30.872844827586206,36.32303269230769,32.9575,21.64,32.9575,21.64,25.1025,19.0675,22.245,14.68,26.64123812499999,29.356951249999973,31.276052500000002,31.185250000000035,30.79491738300352,31.20888907686254,31.240576923076926,32.001578676451416,30.479575169702432,26.64123812499999,29.356951249999973,31.276052500000002,31.185250000000035,30.77084166666667,3318644,3291907.2,44.696430324466924,1.1381831692048088,1.5,2.75,NaN,NaN,0.6565223054280404,1.00812197865116,702.9516554408757,-0.10446554097165102,-0.11031396644464309,-0.005848425472992063,22.68478991829078,-2.2848076160253834,3.225166637446377,80.64815094159849,16.12668242095513,4925157396
1492608600,31.05,31.2075,30.525,30.6275,30.93103448275862,36.417973076923076,32.9575,21.64,32.9575,21.64,25.1025,19.0675,22.245,14.68,26.68380062499999,29.407926249999974,31.3127025,31.17262500000004,30.788351995434752,31.15351868858992,31.14942307692308,31.89835091016757,30.400495243678595,26.68380062499999,29.407926249999974,31.3127025,31.17262500000004,30.786666666666665,2571724,3094731.2,42.88253281628859,1.151925512175121,1.5,2.75,NaN,NaN,0.6583778550403233,0.8310007667224862,701.8955377318183,-0.10727235856158344,-0.13993887367497138,-0.03266651511338793,22.61658060753114,-1.7719692110327083,3.4066857825809613,80.07773958885772,16.51557462856131,4922585672
1492695000,30.88,31.555,30.752525,31.3475,30.989224137931036,36.51291346153846,32.9575,21.64,32.9575,21.64,25.1025,19.0675,22.245,14.68,26.73207562499999,29.46562624999997,31.3637525,31.18750000000004,30.8102793681628,31.171993099200403,31.130961538461545,31.84688895866971,30.41503411825338,26.73207562499999,29.46562624999997,31.3637525,31.18750000000004,31.21834166666666,2454388,3028896.8,52.03074295943501,1.0095692612609846,1.5,2.75,NaN,NaN,0.6776008653945859,0.810324075749296,705.2962457191078,-0.057161690823377395,-0.10411862864260968,-0.04695693781923228,26.383377524914092,-0.31006519319446696,15.026701099499332,55.973509726298666,28.999789174201997,4925040060
1492781400,31.305,31.3275,30.87,31.0425,31.04741379310345,36.607853846153844,32.9575,21.64,32.9575,21.64,25.1025,19.0675,22.245,14.68,26.777013124999986,29.517551249999975,31.406802499999998,31.191625000000037,30.819386059607396,31.15966042308608,31.09865384615386,31.789279580778224,30.408028111529493,26.777013124999986,29.517551249999975,31.406802499999998,31.191625000000037,31.080000000000002,2191948,2971084.4,48.48789474824671,0.08178317376601922,1.5,2.75,NaN,NaN,0.6633079464378298,0.7377602601932143,703.9196176302236,-0.04179307482742976,-0.09919828135351949,-0.05740520652608973,26.454147966340578,-1.0124362244897929,19.78734877964128,49.05813191421014,31.15451930614857,4922848112
1493040600,32.0875,32.1625,31.8525,32.04,31.10560344827586,36.70279423076923,32.9575,21.64,32.9575,21.64,25.1025,19.0675,22.245,14.68,26.827213124999986,29.583026249999975,31.459602499999995,31.248000000000037,30.867253272956127,31.243502287554072,31.13923076923078,31.970095436113755,30.308366102347808,26.827213124999986,29.583026249999975,31.459602499999995,31.248000000000037,32.01833333333334,2588468,2882307.2,58.4520385567468,2.650382601527172,1.5,2.75,NaN,NaN,0.6959288074065563,0.8980541699371947,707.4776780308398,0.034212009949824575,-0.014640194088809011,-0.048852204038633586,32.427252307057564,2.0463412692093264,19.77989794746617,49.07118375532005,31.148918297213786,4925436580
1493127000,32.3725,32.7825,32.325,32.6075,31.163793103448278,36.79773461538461,32.9575,21.64,32.9575,21.64,25.1025,19.0675,22.245,14.68,26.875213124999988,29.652901249999978,31.5169525,31.339375000000036,30.935498242644123,31.37340683159654,31.249038461538476,32.39136998162148,30.10670694145547,26.875213124999988,29.652901249999978,31.5169525,31.339375000000036,32.571666666666665,2316520,2836245.2,62.854309499473786,3.886296759896119,1.5,2.75,NaN,NaN,0.6992553211632309,0.8167558996662206,710.761944732402,0.11671897496647035,0.09704651466945435,-0.019672460297015998,33.58755576177631,4.168996086574566,49.30185942000829,19.610264417862588,31.087876162129113,4927753100
1493213400,32.6175,33.025,32.545,32.5825,31.22198275862069,36.892675,32.9575,21.64,32.9575,21.64,25.1025,19.0675,22.245,14.68,26.921888124999988,29.724601249999978,31.564352499999995,31.396875000000033,31.000086546854156,31.48855856192068,31.336538461538474,32.681750109829636,29.991326813247312,26.921888124999988,29.724601249999978,31.564352499999995,31.396875000000033,32.7175,2221652,2807383.4,62.539937888906266,3.61267773866074,1.5,2.75,NaN,NaN,0.6835942267944285,0.7913603820554044,713.0600417712583,0.16089804914660955,0.18145010113624593,0.02055205198963639,33.444763793767635,5.427924284096431,50.835942607981366,18.501568908218264,30.66248848380038,4925531448
1493299800,32.7175,32.78,32.385275,32.66,31.280172413793103,36.98761538461538,32.9575,21.64,32.9575,21.64,25.1025,19.0675,22.245,14.68,26.966513124999988,29.799676249999976,31.6054525,31.451750000000033,31.065181192075563,31.60012441316633,31.436538461538476,32.955868448561525,29.917208474515427,26.966513124999988,29.799676249999976,31.6054525,31.451750000000033,32.608425000000004,2266360,2797623.2,63.15515913170927,2.7518382711178138,1.5,2.75,NaN,NaN,0.6629607105948265,0.8101019465380469,713.2323872681447,0.18491259515506303,0.25169279593346516,0.06678020077840215,31.753320813729253,7.779886148007585,50.406147623199246,18.80879688605813,30.785055490742625,4927797808
1493386200,32.78,32.78,32.3643,32.44,31.338362068965516,37.082555769230765,32.9575,21.64,32.9575,21.64,25.1025,19.0675,22.245,14.68,27.009988124999985,29.872276249999977,31.633152499999998,31.48312500000003,31.119095655131424,31.680112564293346,31.516730769230783,33.12669897796538,29.906762560496183,27.009988124999985,29.872276249999977,31.633152499999998,31.48312500000003,32.5281,2041344,2772015.4,60.13588730460816,2.1222665474168725,1.5,2.75,NaN,NaN,0.6452992312666248,0.7364114932406219,710.7497200806956,0.17562231517932309,0.28630809475255603,0.11068577957323293,28.72698420996717,4.41779995171803,50.85596037343019,18.487323618401447,30.65671600816836,4925756464
1493645400,32.63,32.86,32.4601,32.63,31.396551724137932,37.17749615384615,32.9575,21.64,32.9575,21.64,25.1025,19.0675,22.245,14.68,27.052513124999987,29.94242624999998,31.665802499999998,31.53525000000003,31.178346805910586,31.770578034360646,31.618846153846167,33.32691818370076,29.910774123991573,27.052513124999987,29.94242624999998,31.665802499999998,31.53525000000003,32.65003333333333,1042139,2714972.15,61.83294884480918,2.4227595096136114,1.5,2.75,NaN,NaN,0.6292064290332945,0.38384887299856835,712.7164240564637,0.17170919071038626,0.32532226796121577,0.1536130772508295,26.315316753586433,5.967362182349605,43.35584720751504,24.23440707884134,32.40974571364362,4926798603
1493731800,32.75,32.78,32.5048,32.7,31.454741379310345,37.272436538461534,32.9575,21.64,32.9575,21.64,25.1025,19.0675,22.245,14.68,27.095900624999985,30.010676249999978,31.6976525,31.597125000000034,31.2380194801886,31.859094412040584,31.756923076923087,33.50166259224661,30.012183561599564,27.095900624999985,30.010676249999978,31.6976525,31.597125000000034,32.6616,1100146,2562256.45,62.46690466563923,1.8418197370875073,1.5,2.75,NaN,NaN,0.6039202555309161,0.42936607692020834,712.7164240564637,0.16332201595414678,0.357765597193513,0.1944435812393662,24.926876624675575,6.766794547383892,34.950558832494906,31.74509241884865,33.30434874865643,4927898749
1493818200,32.48,32.655,32.25,32.54,31.512931034482758,37.36737692307692,32.9575,21.64,32.9575,21.64,25.1025,19.0675,22.245,14.68,27.13745062499999,30.06720124999998,31.715452499999998,31.64850000000003,31.289077539789048,31.923942563274814,31.929038461538475,33.49856869314569,30.35950822993126,27.13745062499999,30.06720124999998,31.715452499999998,31.64850000000003,32.48166666666666,2750737,2475370.9,60.0131918105267,1.2192851936151499,1.5,2.75,NaN,NaN,0.5929259515644223,1.1112423596803211,709.7464485149851,0.1375199561253875,0.36634352639610057,0.22882357027071307,24.850213656662884,3.804131110933883,31.08339581784309,35.63845056623502,33.27815361592188,4925148012
1493904600,32.71,32.72,32.28,32.65,31.57112068965517,37.4623173076923,32.9575,21.64,32.9575,21.64,25.1025,19.0675,22.245,14.68,27.18003812499999,30.12267624999998,31.7364025,31.72200000000003,31.342447048032614,31.993090890581975,32.05076923076924,33.579069423561855,30.522469037976627,27.18003812499999,30.12267624999998,31.7364025,31.72200000000003,32.550000000000004,1366721,2317954.55,61.14324191833591,1.2068929884850255,1.5,2.75,NaN,NaN,0.5820026693098205,0.5896237266602143,706.8772459720608,0.11907250376099765,0.3776641999719601,0.25859169621096245,22.316863767756164,5.178384472900051,24.065197360373173,43.56178775852533,32.37301488110151,4926514733
1493991000,32.85,33.04,32.64,33.04,31.629310344827587,37.55725769230769,32.9575,21.64,32.9575,21.64,25.1025,19.0675,22.245,14.68,27.222975624999986,30.17720124999998,31.7640525,31.801750000000027,31.409017752031335,32.092796520050356,32.22365384615386,33.64846775489991,30.798839937407802,27.222975624999986,30.17720124999998,31.7640525,31.801750000000027,32.906666666666666,1258763,2288164.1,64.92768517412321,1.7689705413760488,1.5,2.75,NaN,NaN,0.5690024786448332,0.5501191981816339,710.0893263442589,0.12379937835574512,0.41334091915564386,0.28954154079989874,20.812440001343255,3.1210986267166043,52.93092773858066,17.040616820705214,30.02845544071412,4927773496
1494250200,33.08,33.1299,32.83,33.05,31.6875,37.65219807692307,32.9575,21.64,32.9575,21.64,25.1025,19.0675,22.245,14.68,27.267438124999984,30.23282624999998,31.789302499999998,31.886250000000025,31.473369997049716,32.18395875623604,32.41000000000001,33.55777711586019,31.262222884139835,27.267438124999984,30.23282624999998,31.789302499999998,31.886250000000025,33.0033,1425171,2267730.65,65.02175568822452,1.74623177057441,1.5,2.75,NaN,NaN,0.5497808730273451,0.6284569113179292,708.617366199871,0.11827080547409152,0.43738004764251315,0.3191092421684216,13.223537253663764,1.3570497584911307,55.251120384150504,15.492179238940698,29.2567003769088,4929198667
1494336600,33.18,33.25,32.7701,32.97,31.745689655172413,37.747138461538455,32.9575,21.64,32.9575,21.64,25.1025,19.0675,22.245,14.68,27.309875624999986,30.282401249999978,31.8106025,31.964875000000024,31.532061369714434,32.2588198270707,32.5348076923077,33.53691597284288,31.53269941177253,27.309875624999986,30.282401249999978,31.8106025,31.964875000000024,32.9967,1749818,2251840.35,63.553164436836035,1.4948124273361234,1.5,2.75,NaN,NaN,0.5447893820968205,0.7770613045458573,706.8805108038559,0.10059098088825758,0.4448479682787436,0.34425698739048605,9.756546180417192,1.1892887286119718,30.04249044724325,36.73636454336061,33.221145009396146,4927448849
1494423000,32.92,33.11,32.82,33.11,31.80387931034483,37.84207884615384,32.9575,21.64,32.9575,21.64,25.1025,19.0675,22.245,14.68,27.353975624999986,30.33995124999998,31.839902499999997,32.05525000000002,31.59394131600014,32.33988460544492,32.69384615384617,33.25919701626095,32.128495291431385,27.353975624999986,30.33995124999998,31.839902499999997,32.05525000000002,33.013333333333335,699287,2141363.7,65.0412268921803,1.4260525058517706,1.5,2.75,NaN,NaN,0.5265901405184761,0.3265615271240471,709.7798108218016,0.09003241160941211,0.4567975019022512,0.3667650902928391,9.827312084865918,1.3778322106552445,66.41800522412706,9.056407036629546,24.52558773924339,4928148136
1494509400,32.91,32.98,32.4,32.93,31.862068965517242,37.937019230769224,32.9575,21.64,32.9575,21.64,25.1025,19.0675,22.245,14.68,27.397088124999986,30.39245124999998,31.8393525,32.15650000000002,31.646335774196213,32.396086071593025,32.7623076923077,33.19415284590606,32.33046253870934,27.397088124999986,30.39245124999998,31.8393525,32.15650000000002,32.77,1253249,2064883.75,61.561086524733525,0.723219125924646,1.5,2.75,NaN,NaN,0.5396908447671563,0.6069344097458271,707.3146692281151,0.06386395034474923,0.4465950282237756,0.3827310778790264,10.597287773673578,1.5104808877928546,37.43419340909488,29.394341639018872,33.171464951886236,4926894887
1494595800,32.78,32.8299,32.6,32.76,31.920258620689655,38.03195961538461,32.9575,21.64,32.9575,21.64,25.1025,19.0675,22.245,14.68,27.43968812499999,30.444776249999983,31.847102500000002,32.27937500000002,31.69000888109048,32.430744540965115,32.77403846153847,33.19661088801859,32.351466035058344,27.43968812499999,30.444776249999983,31.847102500000002,32.27937500000002,32.72996666666666,723039,1896016.3,58.383764522072646,0.22501960224811177,1.5,2.75,NaN,NaN,0.5247129272837879,0.3813464050915596,705.4491934174973,0.029775922955055822,0.41995098157284616,0.39017505861779034,10.21585686377627,0.3984063745019781,17.22622804326986,52.656284140084196,30.11748781664595,4926171848
1494855000,32.92,33.32,32.91,33.22,31.978448275862068,38.12689999999999,32.9575,21.64,32.9575,21.64,25.1025,19.0675,22.245,14.68,27.484188124999992,30.500201249999982,31.863052500000002,32.38700000000002,31.750008532812423,32.50591172753987,32.82307692307693,33.29089573187989,32.35525811427397,27.484188124999992,30.500201249999982,31.863052500000002,32.38700000000002,33.15,1409302,1837471,63.824559660381055,1.357899088494584,1.5,2.75,NaN,NaN,0.5272334324778033,0.7669791795353504,709.1443991566335,0.032648278522914964,0.43098540677143404,0.3983371282485191,12.436992161528678,1.5902140672782752,18.160323018337756,51.37370669244903,30.465970289213217,4927581150
1494941400,33.41,33.42,32.99,33.16,32.036637931034484,38.22184038461538,32.9575,21.64,32.9575,21.64,25.1025,19.0675,22.245,14.68,27.527725624999988,30.55180124999998,31.883852500000007,32.50537500000002,31.805302315839388,32.56820584872655,32.86153846153847,33.351112603254194,32.37196431982275,27.527725624999988,30.55180124999998,31.883852500000007,32.50537500000002,33.19,1256890,1734383.3,62.67359421578569,1.1844237697910776,1.5,2.75,NaN,NaN,0.5202881873008173,0.7246898652679601,707.5245226181282,0.025276515245737152,0.4299327723056905,0.40465625705995334,12.601345684640371,1.9053472649047247,21.753256560619317,46.51786031893427,31.7288831204464,4926324260
1495027800,32.33,32.57,31.3799,31.44,32.0948275862069,38.31678076923077,32.9575,21.64,32.9575,21.64,25.1025,19.0675,22.245,14.68,27.56316312499999,30.588301249999983,31.875702500000006,32.54600000000002,31.790976734826078,32.46075767265735,32.7846153846154,33.66955311852632,31.899677650704472,27.56316312499999,30.588301249999983,31.875702500000006,32.54600000000002,31.796633333333336,3034556,1757524.9,40.26004630635832,2.854843702229906,1.5,2.75,NaN,NaN,0.6102747453507587,1.7266076856151513,702.2238835817905,-0.09412455547817328,0.28700056271223673,0.38112511819041,33.90382760361585,-3.7059724349157652,4.488784222543417,76.97115532050583,18.540060456950744,4923289704
1495114200,31.33,32.17,31.26,31.76,31.26,38.41172115384615,32.9575,21.64,32.9575,21.64,25.1025,19.0675,22.245,14.68,27.60246312499999,30.629476249999986,31.877652500000007,32.56662500000002,31.78976196091133,32.39401884668998,32.71769230769232,33.75734177069278,31.678042844691852,27.60246312499999,30.629476249999986,31.877652500000007,32.56662500000002,31.730000000000004,2075482,1738579.6,44.25436822000948,2.37050987031189,1.5,2.75,NaN,NaN,0.6316836921114187,1.1937802560204893,702.9580923395699,-0.1470816612236765,0.19727304166081439,0.3443547028844909,34.612557997975856,-3.874092009685223,23.59911276222154,44.190547387764084,32.210339850014364,4925365186
1495200600,32.01,32.6929,31.98,32.36,31.294054054054055,38.506661538461536,32.9575,21.64,32.9575,21.64,25.1025,19.0675,22.245,14.68,27.64371312499999,30.675901249999985,31.88990250000001,32.63250000000002,31.812124236954023,32.39077895652903,32.69153846153848,33.74861268653867,31.634464236538285,27.64371312499999,30.675901249999985,31.88990250000001,32.63250000000002,32.3443,1548874,1706425.9,50.88531442834157,0.37398181567471656,1.5,2.75,NaN,NaN,0.6531991426748888,0.9076714084098232,705.2024883458121,-0.13741270323713745,0.17258882383806906,0.3100015270752065,35.867930890804814,-2.087745839636907,40.68344544303848,26.540989080342776,32.77556547661874,4926914060
1495459800,32.61,32.95,32.59,32.87,31.32810810810811,38.60160192307692,33.22,21.64,32.9575,21.64,25.1025,19.0675,22.245,14.68,27.687163124999987,30.725426249999984,31.906202500000003,32.67400000000002,31.853609560995043,32.43641905590722,32.71692307692309,33.774071188673524,31.65977496517265,27.687163124999987,30.725426249999984,31.906202500000003,32.67400000000002,32.803333333333335,1140886,1634046.8,55.70804622151672,1.0318409927145304,1.5,2.75,NaN,NaN,0.6486849181981112,0.6981966489576675,708.1954178669743,-0.094428202923858,0.19196627342038397,0.286394476344242,37.288378151464,-0.30330603579011656,37.218173128343444,29.594023416266804,33.18780345538974,4928054946
1495546200,33.04,33.169,32.88,33.08,31.362162162162164,38.696542307692305,33.22,21.64,32.9575,21.64,25.1025,19.0675,22.245,14.68,27.728650624999986,30.783501249999983,31.925602500000004,32.69762500000003,31.90170330370112,32.49771247915415,32.750000000000014,33.823484620648685,31.67651537935134,27.728650624999986,30.783501249999983,31.925602500000004,32.69762500000003,33.043,1872175,1611829.55,57.55616614905135,1.4206036773099011,1.5,2.75,NaN,NaN,0.6237074240411032,1.1615217006041365,710.3624434782673,-0.05174556281440357,0.22171252282623755,0.2734580856406411,37.466872283578155,-0.09060706735125683,61.05795716327564,11.940710434243725,27.00133240248064,4929927121
1495632600,33.21,33.37,33.06,33.3,31.396216216216217,38.79148269230769,33.22,21.64,32.9575,21.64,25.1025,19.0675,22.245,14.68,27.771463124999986,30.844251249999985,31.956852500000004,32.73350000000003,31.956538468261858,32.574120814472806,32.77000000000001,33.873616432810444,31.666383567189577,27.771463124999986,30.844251249999985,31.956852500000004,32.73350000000003,33.24333333333333,953684,1548431.15,59.46439324956002,1.6247218236373002,1.5,2.75,NaN,NaN,0.6012997508953097,0.6159033935735535,712.085305622565,-0.01073350211407853,0.260041207998043,0.2707747101121215,37.58270975016429,1.1235955056179698,100,0,0,4930880805
1495719000,33.59,33.94,33.47,33.77,31.43027027027027,38.88642307692307,33.22,21.64,32.9575,21.64,25.1025,19.0675,22.245,14.68,27.81643812499999,30.912576249999983,31.981602500000005,32.78900000000003,32.027654606761395,32.6880140702373,32.82538461538463,34.0457405630709,31.60502866769836,27.81643812499999,30.912576249999983,31.981602500000005,32.78900000000003,33.72666666666667,1614328,1515829.55,63.26422621477691,2.870356794377655,1.5,2.75,NaN,NaN,0.6040640544027875,1.0649798983005707,713.4254983343995,0.04306043156287831,0.3246002495657194,0.2815398180028411,38.096566137758394,3.0830280830280987,100,0,0,4932495133
1495805400,33.74,33.841,33.67,33.8,31.464324324324327,38.98136346153846,33.22,21.64,32.9575,21.64,25.1025,19.0675,22.245,14.68,27.862450624999994,30.975501249999983,32.0096025,32.85700000000003,32.09715834767271,32.79391749211946,32.889230769230785,34.21542744888885,31.563034089572714,27.862450624999994,30.975501249999983,32.0096025,32.85700000000003,33.77033333333333,885767,1458050.7,63.499425290527135,2.33687884531222,1.5,2.75,NaN,NaN,0.5731309076597313,0.6075008228451864,714.4818076989724,0.07386791318842245,0.3738747094883692,0.30000679629994675,37.80695664423653,1.7459361830222706,100,0,0,4933380900
1496151000,33.63,33.8,33.5401,33.7,31.49837837837838,39.07630384615384,33.22,21.64,32.9575,21.64,25.1025,19.0675,22.245,14.68,27.906250624999995,31.032551249999983,32.0393525,32.91050000000003,32.160014883058096,32.880211064298564,32.9346153846154,34.326672310609126,31.542558458621674,27.906250624999995,31.032551249999983,32.0393525,32.91050000000003,33.680033333333334,558975,1433892.5,62.07279593860232,1.9126803007582134,1.5,2.75,NaN,NaN,0.5507572713983215,0.3898304789236292,711.9951460334995,0.08018829668355909,0.40024216715439564,0.32005387047083655,37.27924017055029,1.6284680337756523,89.78335934303226,0.9567036556080218,9.259937001359704,4932821925
1496237400,33.85,33.85,33.32,33.65,31.532432432432433,39.171244230769226,33.22,21.64,32.9575,21.64,25.1025,19.0675,22.245,14.68,27.950200624999994,31.089751249999985,32.07085,32.95800000000003,32.21844567195778,32.95352429627013,32.99000000000001,34.43326552810473,31.546734471895295,27.950200624999994,31.089751249999985,32.07085,32.95800000000003,33.60666666666666,1158799,1436825.15,61.33084532430219,1.2943524827138793,1.5,2.75,NaN,NaN,0.5492746091555843,0.8064996635115972,711.3484762428167,0.07383743436004114,0.412350663420888,0.33851322906084685,37.269444891915136,7.029262086513985,58.093684982659134,13.70960866029791,28.196706357042945,4931663126
1496323800,33.86,34.44,33.74,34.43,31.56648648648649,39.26618461538461,33.22,21.64,32.9575,21.64,25.1025,19.0675,22.245,14.68,27.996838124999996,31.151601249999985,32.14185,33.05250000000002,32.305173292665316,33.09414102995869,33.118461538461546,34.742887518096694,31.494035558826397,27.996838124999996,31.151601249999985,32.14185,33.05250000000002,34.20333333333334,1564685,1377522.55,67.79741185850625,2.6577800212000025,1.5,2.75,NaN,NaN,0.5664692799301855,1.135868882872371,716.1832461442701,0.11267777385749345,0.4793604463827137,0.36668267252522024,15.867785665489288,8.40680100755667,63.518801610779214,10.580120316062278,25.901078073158516,4933227811
1496410200,34.49,34.85,34.3259,34.74,31.600540540540543,39.361124999999994,33.22,21.64,32.9575,21.64,25.1025,19.0675,22.245,14.68,28.047025624999993,31.219226249999984,32.215650000000004,33.157000000000025,32.40065669295295,33.25088950329596,33.23538461538463,35.0765650959813,31.394204134787962,28.047025624999993,31.219226249999984,32.215650000000004,33.157000000000025,34.63863333333333,1792832,1398828.1,69.94835576791284,3.4774917107782577,1.5,2.75,NaN,NaN,0.5634429027923155,1.2816671326519677,718.2453084227516,0.1475558909469002,0.5511275362088455,0.4035716452619453,15.853906354338593,7.354758961681096,65.12886688985844,9.725460971596563,25.145672138544985,4935020643
1496669400,34.7,34.827,34.618,34.66,31.634594594594596,39.45606538461538,33.22,21.64,32.9575,21.64,25.1025,19.0675,22.245,14.68,28.096250624999993,31.286301249999983,32.28965,33.23800000000003,32.48925839126852,33.38509050298206,33.350769230769245,35.34059661467758,31.360941846860914,28.096250624999993,31.286301249999983,32.28965,33.23800000000003,34.70166666666666,1483042,1410042.05,68.67355932907336,2.955140270889458,1.5,2.75,NaN,NaN,0.5381255525928641,1.0517714702196292,715.7337964662416,0.15289699664891948,0.5946928910730946,0.44179589442417516,15.714091717977736,5.445695162762395,37.10687712826524,29.773352659502685,33.119770212232076,4933537601
1496755800,34.39,34.6768,34.33,34.36,31.668648648648652,39.55100576923076,33.22,21.64,32.9575,21.64,25.1025,19.0675,22.245,14.68,28.14305062499999,31.348051249999983,32.3586,33.30350000000003,32.56262080729721,33.47793902650758,33.57538461538463,35.29224427784738,31.858524952921876,28.14305062499999,31.348051249999983,32.3586,33.30350000000003,34.4556,1006528,1389109.9,63.965670095435144,2.018865692838073,1.5,2.75,NaN,NaN,0.5244594416933739,0.7245848582606748,715.0622457293967,0.12505651703053178,0.5981165407123399,0.4730600236818081,16.90006167223668,3.869407496977029,32.5563625059033,34.19646143511649,33.24717605898021,4932531073
1496842200,34.53,34.6599,34.2,34.56,31.702702702702705,39.64594615384615,33.22,21.64,32.9575,21.64,25.1025,19.0675,22.245,14.68,28.191475624999995,31.413826249999985,32.434200000000004,33.383000000000024,32.64094940308947,33.580992452554476,33.79076923076924,35.22126051890902,32.360277942629466,28.191475624999995,31.413826249999985,32.434200000000004,33.383000000000024,34.4733,1038158,1353526.9,65.65603525547061,1.8097808362517298,1.5,2.75,NaN,NaN,0.5198480530009898,0.767002118687113,714.0622457293967,0.10950170932344094,0.6099371603361092,0.5004354510126683,16.87954831872291,3.7837837837837993,54.7343046194735,15.88473348899751,29.380961891528987,4933569231
1496928600,34.59,34.84,34.35,34.6,31.73675675675676,39.74088653846153,33.22,21.64,32.9575,21.64,25.1025,19.0675,22.245,14.68,28.240150625,31.478226249999985,32.497550000000004,33.457500000000024,32.717774916693806,33.67804079040643,33.96307692307694,35.187479687765716,32.738674158388164,28.240150625,31.478226249999985,32.497550000000004,33.457500000000024,34.596666666666664,1572547,1397189.9,65.99956412971025,1.7007177588905873,1.5,2.75,NaN,NaN,0.517716049215205,1.1255069908535698,715.9132534301361,0.09200232872414793,0.6154383619178532,0.5234360331937052,16.90444661120628,2.4578027835356773,54.85247893617043,15.8069553214427,29.340565742386886,4935141778
1497015000,34.74,35.1199,33.82,34.45,31.77081081081081,39.835826923076915,34.74,21.64,32.9575,21.64,25.1025,19.0675,22.245,14.68,28.287413124999993,31.54415124999998,32.5553,33.53350000000003,32.78570531211758,33.75156071512963,34.0846153846154,35.15484513377038,33.014385635460414,28.287413124999993,31.54415124999998,32.5553,33.53350000000003,34.4633,2365169,1452785.9,63.43701893384062,1.1377939321819848,1.5,2.75,NaN,NaN,0.573586331414119,1.6280230968651335,718.7157402872454,0.061866425913352896,0.6007690655853963,0.5389026396720434,16.12378534387339,1.92307692307694,17.002058479496725,53.06759758216365,29.930343938339625,4932776609
1497274200,34.3,34.4387,33.99,34.4,31.804864864864868,39.93076730769231,34.74,21.64,32.9575,21.64,25.1025,19.0675,22.245,14.68,28.336138124999994,31.607776249999983,32.60705,33.61550000000003,32.84901098615218,33.813316837498235,34.18615384615386,35.09401823662156,33.278289455686156,28.336138124999994,31.607776249999983,32.60705,33.61550000000003,34.27623333333333,1793192,1506293.55,62.56500113024999,0.45915838503053036,1.5,2.75,NaN,NaN,0.5654730220273962,1.1904664930683664,719.6252856282113,0.031630729895887666,0.578441052041903,0.5468103221460153,16.237758382768185,2.07715133531156,14.312017564702751,57.10806355208576,28.579918883211494,4930983417
1497360600,34.68,34.94,34.51,34.89,31.83891891891892,40.02570769230769,34.74,21.64,32.9575,21.64,25.1025,19.0675,22.245,14.68,28.387763124999996,31.67930124999998,32.673100000000005,33.69900000000003,32.929049771008955,33.91585809106983,34.30846153846155,35.130161320951714,33.486761755971386,28.387763124999996,31.67930124999998,32.673100000000005,33.69900000000003,34.779999999999994,1569970,1514326.95,67.30782655245699,1.8075425239652971,1.5,2.75,NaN,NaN,0.5636535204540107,1.0367444097854825,722.7215989139274,0.03730693620701697,0.5934439924047865,0.5561370561977695,17.344216473184236,3.684992570579501,33.29090174047189,33.38285490220465,33.32624335732346,4932553387
1497447000,35.05,35.05,34.37,34.78,31.872972972972974,40.120648076923075,34.74,21.64,32.9575,21.64,25.1025,19.0675,22.245,14.68,28.439525624999998,31.74700124999998,32.739450000000005,33.78000000000003,33.0016360544988,33.99815732049175,34.38615384615386,35.18003577736911,33.59227191493861,28.439525624999998,31.74700124999998,32.739450000000005,33.78000000000003,34.73333333333333,2799118,1591438.35,65.3074876543221,1.2249093880808253,1.5,2.75,NaN,NaN,0.5719639832787242,1.7588604673250459,721.3744482858183,0.026818842709599333,0.5896606095847687,0.5628417668751694,17.54402030038256,1.0165553296543752,12.150296702978908,60.70078963167848,27.14891366534262,4929754269
1497533400,34.1,34.629,33.98,34.57,31.90702702702703,40.21558846153846,34.74,21.64,32.9575,21.64,25.1025,19.0675,22.245,14.68,28.488450624999995,31.81460124999998,32.8006,33.93650000000003,33.06314052294983,34.05261852806397,34.44538461538463,35.16711822848854,33.723651002280725,28.488450624999995,31.81460124999998,32.8006,33.93650000000003,34.393,1533608,1516390.95,61.546901848088595,0.4565179753777009,1.5,2.75,NaN,NaN,0.588252270187387,1.0113539651499504,718.9369954205123,0.00030619048940028204,0.5632245049869198,0.5629183144975195,12.98978227629905,-0.4893494530800279,2.7776985608364124,82.12363841747194,15.09866302169165,4928220661
1497619800,34.66,34.66,34.16,34.55,31.941081081081084,40.310528846153844,34.74,21.64,32.9575,21.64,25.1025,19.0675,22.245,14.68,28.537913124999996,31.876826249999986,32.867999999999995,34.07600000000003,33.12144873773611,34.09998819205787,34.51076923076925,35.09060801677057,33.93093044476793,28.537913124999996,31.876826249999986,32.867999999999995,34.07600000000003,34.45666666666666,1435283,1484381,61.18554462515095,0.2735314239175806,1.5,2.75,NaN,NaN,0.5819485366025737,0.9669235863299247,720.798115544508,-0.022735849396181673,0.5344985027522924,0.557234352148474,11.79128345376628,-0.3173687247547589,3.4088705937413746,80.07474838040942,16.516381025849217,4926785378
1497879000,34.97,35.45,34.9348,35.4,31.975135135135137,35.45,34.74,21.64,32.9575,21.64,25.1025,19.0675,22.245,14.68,28.59265062499999,31.940526249999984,32.9471,34.22800000000002,33.21080368919744,34.22379884043331,34.64538461538463,35.17363952964276,34.117129701126494,28.59265062499999,31.940526249999984,32.9471,34.22800000000002,35.26160000000001,1888478,1501361.2,69.40666458469957,2.3119350418421067,1.5,2.75,NaN,NaN,0.6046664982738188,1.2578438819386035,723.1494069829672,0.013178512219732208,0.5737074924231393,0.5605289802034071,18.371368574703837,3.026775320139695,18.164741250862516,51.32436762918034,30.51089111995714,4928673856
1497965400,35.23,35.26,34.7132,34.75,32.00918918918919,35.47973684210527,34.74,21.64,32.9575,21.64,25.1025,19.0675,22.245,14.68,28.644100624999993,31.998401249999983,33.014900000000004,34.322000000000024,33.271164328836754,34.27391323658252,34.670000000000016,35.18548334301226,34.154516656987774,28.644100624999993,31.998401249999983,33.014900000000004,34.322000000000024,34.90773333333333,1043435,1496488.65,59.0982631970285,1.0195082625878484,1.5,2.75,NaN,NaN,0.6105331769685459,0.6972555388241669,719.8667461614741,-0.011593618281676155,0.546036957351312,0.5576305756329881,21.140499333204147,0.5497685185185119,5.661824452729629,73.8984795597423,20.43969598752807,4927630421
1498051800,34.86,34.95,34.4626,34.7,32.043243243243246,35.509473684210526,34.74,21.64,32.9575,21.64,25.1025,19.0675,22.245,14.68,28.69371312499999,32.05692624999998,33.08095,34.40300000000003,33.32719710025492,34.31449292833657,34.66692307692309,35.181174414179324,34.15267173966686,28.69371312499999,32.05692624999998,33.08095,34.40300000000003,34.7042,780966,1441928.2,58.379980470088846,0.3740941652925751,1.5,2.75,NaN,NaN,0.6017379500422214,0.5416122661308657,717.0447546016645,-0.03478724784278886,0.514146515829502,0.5489337636722909,20.96271808642773,0.2890173410404665,10.020709573519449,64.56263790922306,25.41665251725748,4926849455
1498138200,34.7,34.93,34.57,34.62,32.0772972972973,35.53921052631579,34.74,21.64,32.9575,21.64,25.1025,19.0675,22.245,14.68,28.74175062499999,32.11987624999998,33.1473,34.46900000000003,33.377895253186104,34.34358883992356,34.66384615384617,35.17870466833421,34.14898763935813,28.74175062499999,32.11987624999998,33.1473,34.46900000000003,34.70666666666667,501591,1419323.55,57.182445793720426,0.5914155151260447,1.5,2.75,NaN,NaN,0.5844709536106342,0.35340144958490965,718.9901908566527,-0.05761089794788976,0.47692014123742865,0.5345310391853184,21.01133169357131,0.4934687953555721,14.360159411510068,57.04082890892675,28.599011679563187,4926347864
1498224600,34.68,34.91,34.48,34.78,32.11135135135135,35.56894736842106,34.74,21.64,32.9575,21.64,25.1025,19.0675,22.245,14.68,28.79061312499999,32.184801249999985,33.2248,34.51950000000003,33.43287975306116,34.38515180754989,34.69615384615386,35.18261917966701,34.20968851264072,28.79061312499999,32.184801249999985,33.2248,34.51950000000003,34.72333333333333,1366805,1406947.4,58.99413944353239,0.3574935053993888,1.5,2.75,NaN,NaN,0.5734373140670174,0.9714684429567162,721.8186179813989,-0.06355865243869585,0.45508272363694857,0.5186413760756444,20.95331102270141,1.1046511627907052,44.61077392429295,23.224863701316547,32.164362374390514,4927714669
1498483800,35.09,35.2899,34.7,34.79,32.145405405405405,35.59868421052632,35.4,21.64,32.9575,21.64,25.1025,19.0675,22.245,14.68,28.84045062499999,32.249451249999986,33.31455,34.56900000000003,33.4861001549019,34.423708778259424,34.71384615384617,35.1959274404192,34.23176486727314,28.84045062499999,32.249451249999986,33.31455,34.56900000000003,34.926633333333335,1472185,1436268.3,59.11058916645791,0.837822765081484,1.5,2.75,NaN,NaN,0.5746132202050875,1.025006957265575,724.565799909668,-0.06804491792743927,0.4335852286663453,0.5016301465937846,20.90406743749103,-0.2866150759529992,40.553177244711236,26.604434039293935,32.842388715994836,4929186854
1498570200,34.66,34.84,33.9725,34.01,32.179459459459466,35.62842105263158,35.4,21.64,32.9575,21.64,25.1025,19.0675,22.245,14.68,28.895375624999993,32.30610124999999,33.3734,34.58450000000003,33.506645246866526,34.38430794223472,34.66846153846155,35.2788760837992,34.0580469931239,28.895375624999993,32.30610124999999,33.3734,34.58450000000003,34.274166666666666,3221459,1569392.5,47.72579916056267,0.8466073598297947,1.5,2.75,NaN,NaN,0.5955337044761533,2.0526789824725173,721.7530602443633,-0.12164083925723179,0.3495790975222448,0.4712199367794766,23.075026306666015,-2.2139160437032865,20.26874302677844,48.41070573059807,31.320551242623495,4925965395
1498656600,34.45,34.96,34.34,34.85,32.21351351351352,35.658157894736846,35.4,21.64,32.9575,21.64,25.1025,19.0675,22.245,14.68,28.949475624999994,32.365301249999995,33.45455,34.64450000000003,33.55932582542078,34.42865956678379,34.69923076923079,35.30278238774657,34.09567915071501,28.949475624999994,32.365301249999995,33.45455,34.64450000000003,34.71666666666667,1764438,1599674.45,57.270402869444084,0.8375158104751069,1.5,2.75,NaN,NaN,0.6208527255849996,1.1029981756600538,726.0113854237422,-0.09954629523419944,0.3467870677367273,0.44633336297092674,27.74471642101235,0.8099508244142353,41.653687698704985,25.65841785714344,32.68789444415159,4927729833
1498743000,34.94,34.97,33.37,33.96,33.37,35.68789473684211,35.4,21.64,32.9575,21.64,25.1025,19.0675,22.245,14.68,29.004350624999997,32.41695124999999,33.52119999999999,34.62100000000003,33.57503853814938,34.38402532232819,34.66538461538463,35.37269220312044,33.95807702764883,29.004350624999997,32.41695124999999,33.52119999999999,34.62100000000003,34.1,3030849,1672982.65,47.396061121405076,1.4622260035810324,1.5,2.75,NaN,NaN,0.6907918166146426,1.8116440119686836,722.3386975301639,-0.14134633866477309,0.2696504396399604,0.41099677830473347,31.45211293632022,-1.7076700434153296,24.75141530356447,42.73107872274901,32.51750597368651,4924698984
1498829400,34.34,34.52,34.04,34.13,33.44275862068965,35.71763157894737,35.4,21.64,32.9575,21.64,25.1025,19.0675,22.245,14.68,29.060288124999996,32.47030124999999,33.57684999999999,34.590500000000034,33.596801732731755,34.35983243448741,34.606923076923096,35.354776810684314,33.85906934316188,29.060288124999996,32.47030124999999,33.57684999999999,34.590500000000034,34.23,1723224,1669502.25,49.19784881564635,0.6347104032814124,1.5,2.75,NaN,NaN,0.6814495439993111,1.0321783034434364,724.8414233169085,-0.15303416377551426,0.2197040735853406,0.3727382373608549,31.691046159981646,-3.5875706214689154,26.77899315240274,40.3526262935539,32.86838055404337,4926422208
1499088600,34.6,34.8,34.28,34.28,33.51551724137931,35.747368421052634,35.4,21.64,32.9575,21.64,25.1025,19.0675,22.245,14.68,29.113500624999997,32.52420125,33.6416,34.57150000000003,33.623593821644235,34.35222934548861,34.568461538461555,35.328090846999956,33.808832229923155,29.113500624999997,32.52420125,33.6416,34.57150000000003,34.45333333333333,1307221,1660711.2,50.79919268700453,0.4221705072927632,1.5,2.75,NaN,NaN,0.6806317194279313,0.7871452905237226,728.531548149024,-0.14616309616995293,0.1900343671484137,0.33619746331836664,27.63097359050596,-1.3525179856115075,24.516755870568673,43.040631279403684,32.44261285002765,4927729429
1499261400,34.48,34.63,34.08,34.51,33.58827586206896,35.7771052631579,35.4,21.64,32.9575,21.64,25.1025,19.0675,22.245,14.68,29.169313125,32.575301249999995,33.690999999999995,34.57900000000003,33.658354848246425,34.367255122108745,34.56384615384617,35.324110822802915,33.80358148488943,29.169313125,32.575301249999995,33.690999999999995,34.57900000000003,34.406666666666666,943727,1657571.15,53.233410624071176,0.3224987997038521,1.5,2.75,NaN,NaN,0.6713008823259365,0.5693432827906061,725.8700949119121,-0.12258131850575998,0.18297081518616665,0.30555213369192663,26.27562657157087,-0.547550432276671,54.86208525765776,15.765661615155807,29.372253127186426,4928673156
1499347800,34.14,34.2,33.5,33.61,33.661034482758616,35.806842105263165,35.4,21.64,32.9575,21.64,25.1025,19.0675,22.245,14.68,29.220525624999997,32.61400125,33.71104999999999,34.53150000000003,33.656458579687744,34.295135586669815,34.491538461538475,35.406401920164406,33.576675002912545,29.220525624999997,32.61400125,33.71104999999999,34.53150000000003,33.77,1443867,1677856.6,44.04950138809126,1.6912383673992237,1.5,2.75,NaN,NaN,0.6954936764455123,0.8605425517293909,720.9203474436063,-0.16159635976270093,0.10355668398855045,0.26515304375125137,30.15139768916969,-2.9173887926054247,28.94833008471515,37.949323264973785,33.102346650311055,4927229289
1499434200,33.86,34.3,33.78,34.2,33.73379310344827,35.83657894736842,35.4,21.64,32.9575,21.64,25.1025,19.0675,22.245,14.68,29.274638124999996,32.653876249999996,33.743399999999994,34.51150000000003,33.677773929503914,34.28607505460602,34.39923076923078,35.157587759996865,33.6408737784647,29.274638124999996,32.653876249999996,33.743399999999994,34.51150000000003,34.093333333333334,1103317,1654395.1,50.12423261193233,0.6060764384917999,1.5,2.75,NaN,NaN,0.6951012709851183,0.6669005487262384,723.8245011115673,-0.14234401160570948,0.08722302924411451,0.229567040849824,32.39501966620761,-1.667625071880386,73.02331586992533,6.026138541144607,20.95054558893006,4928332606
1499693400,34.16,34.5099,34.07,34.3,33.806551724137925,35.86631578947369,35.4,21.64,32.9575,21.64,25.1025,19.0675,22.245,14.68,29.325413124999997,32.69082625,33.77619999999999,34.504000000000026,33.70217495187631,34.28740123988164,34.364615384615405,35.09638312349752,33.63284764573329,29.325413124999997,32.69082625,33.77619999999999,34.504000000000026,34.2933,820851,1577179.2,51.09345352017132,0.33311487363866704,1.5,2.75,NaN,NaN,0.6768726087718957,0.5204551264688249,724.848994536075,-0.11852625696934757,0.08140921963813952,0.1999354766074871,32.29825405729705,-1.4084507042253578,69.34580527513386,7.644231769927645,23.009962954938494,4929153457
1499779800,34.23,34.39,33.6711,34.25,33.87931034482758,35.896052631578954,35.4,21.64,32.9575,21.64,25.1025,19.0675,22.245,14.68,29.373663124999993,32.72277625,33.81239999999999,34.496500000000026,33.723658287096846,34.28383921703577,34.33000000000002,35.03719380435854,33.6228061956415,29.373663124999993,32.72277625,33.81239999999999,34.496500000000026,34.1037,1443520,1559695.6,50.5643600685864,0.5535952993124197,1.5,2.75,NaN,NaN,0.6798745652881887,0.9255139272047699,726.0620669640228,-0.10239806431096193,0.07193789621878466,0.1743359605297466,32.28065847745793,0.705674801528968,34.17600296540983,32.5109497497974,33.313047284792766,4927709937
1499866200,34.72,35.1,34.72,35.01,33.952068965517235,35.92578947368421,35.4,21.64,32.9575,21.64,25.1025,19.0675,22.245,14.68,29.427725624999994,32.762901250000006,33.859999999999985,34.502500000000026,33.77410306015187,34.352997386841885,34.36000000000002,35.14289403939684,33.5771059606032,29.427725624999994,32.762901250000006,33.859999999999985,34.502500000000026,34.94333333333333,1679874,1565190.8,57.7296143774888,1.7911674167106606,1.5,2.75,NaN,NaN,0.6920263820533181,1.0732710670162384,730.0481538783899,-0.040009313044664235,0.12432431922391629,0.16433363226858053,31.756259816836554,0.4591104734576659,42.326060138951284,25.099572807341662,32.57436705370705,4929389811
1499952600,35.03,35.2399,34.91,35.18,34.02482758620689,35.95552631578948,35.4,21.64,32.9575,21.64,25.1025,19.0675,22.245,14.68,29.485500624999997,32.80362625,33.90959999999998,34.52250000000002,33.82923627347925,34.431759540475994,34.39076923076925,35.263552983648474,33.51798547789003,29.485500624999997,32.80362625,33.90959999999998,34.52250000000002,35.10996666666667,993188,1474894.3,59.15569148729085,1.8907117526697579,1.5,2.75,NaN,NaN,0.6661602119066526,0.6733960528561267,731.1034435844122,0.010542906372278893,0.17751226523392916,0.16696935886165026,28.760293378392863,3.592461719670197,71.65731107994777,6.603255842771461,21.73943307728077,4930382999
1500039000,35.18,35.83,35.1,35.62,34.09758620689655,35.98526315789474,35.4,21.64,32.9575,21.64,25.1025,19.0675,22.245,14.68,29.543325624999994,32.84332625,33.97119999999998,34.575000000000024,33.89946230197026,34.5449252985259,34.4546153846154,35.53226568852423,33.376965080706576,29.543325624999994,32.84332625,33.97119999999998,34.575000000000024,35.51666666666667,1940094,1495218.6,62.66640247808278,2.810253110600551,1.5,2.75,NaN,NaN,0.670720196770463,1.2975320130447814,734.502498074792,0.06823292587689544,0.25226051620776957,0.18402759033087412,23.651230447617134,4.3656607090536035,75.87721939996501,4.88392708531041,19.238853514724568,4932323093
1500298200,35.63,35.805,35.572,35.62,34.170344827586206,36.015,35.4,21.64,32.9575,21.64,25.1025,19.0675,22.245,14.68,29.599350624999992,32.88350125,34.03059999999998,34.628500000000024,33.96693436855966,34.647313365332955,34.57846153846156,35.78553928508376,33.371383791839364,29.599350624999992,32.88350125,34.03059999999998,34.628500000000024,35.665666666666674,754041,1461156.5,62.66640247808279,2.4223490366847233,1.5,2.75,NaN,NaN,0.6394544684297154,0.5160576570682196,736.1826995279151,0.0991372853236813,0.30794919698547574,0.20881191166179444,23.806846043330548,3.908984830805123,72.79829183610917,6.134020329248037,21.067687834642804,4932323093
1500384600,35.45,35.719,35.27,35.68,34.24310344827586,36.044736842105266,35.4,21.64,32.9575,21.64,25.1025,19.0675,22.245,14.68,29.659113124999994,32.92372625,34.08339999999998,34.64250000000003,34.03411341292987,34.74566447339648,34.64230769230771,35.98073740015203,33.30387798446339,29.659113124999994,32.92372625,34.08339999999998,34.64250000000003,35.556333333333335,1209940,1427229.6,63.167090836395325,1.9970152926368427,1.5,2.75,NaN,NaN,0.6258505778275928,0.8477542786388398,735.2012540153585,0.11523596028385114,0.3528568620166084,0.23762090173275724,23.852531853355043,3.3903216458997445,100,0,0,4933533033
1500471000,35.84,36.27,35.84,36.26,34.315862068965515,36.07447368421053,35.4,21.64,32.9575,21.64,25.1025,19.0675,22.245,14.68,29.718938124999994,32.96845125,34.14759999999998,34.718000000000025,34.12140308301105,34.88988690450158,34.81923076923079,36.34505889824465,33.29340264021693,29.718938124999994,32.96845125,34.14759999999998,34.718000000000025,36.123333333333335,1065762,1428345.95,67.67948793898671,2.9820494889466422,1.5,2.75,NaN,NaN,0.6232898222684792,0.7461511687697228,739.1348424889497,0.15413333902023135,0.4302875755080464,0.27615423648781506,24.833386652915447,7.884558167212136,100,0,0,4934598795
1500557400,36.42,36.46,36.03,36.29,34.38862068965517,36.104210526315796,35.4,21.64,32.9575,21.64,25.1025,19.0675,22.245,14.68,29.780063124999998,33.01230125,34.213999999999984,34.79750000000002,34.20644609936356,35.02323100883476,34.98538461538464,36.63981671194532,33.330952518823956,29.780063124999998,33.01230125,34.213999999999984,34.79750000000002,36.26,987427,1438669,67.89855336393734,2.945085720108298,1.5,2.75,NaN,NaN,0.6094834063921591,0.6863475893343083,739.8149785297634,0.16983042257370828,0.48844226470495045,0.31861184213124216,15.380077398052936,6.1111111111111,100,0,0,4935586222
1500643800,36.04,36.22,35.9,36.22,34.461379310344824,36.133947368421055,35.4,21.64,32.9575,21.64,25.1025,19.0675,22.245,14.68,29.842425624999997,33.05805125,34.27619999999999,34.87750000000002,34.28540899742774,35.137209007993356,35.13461538461541,36.85623564801874,33.41299512121208,29.842425624999997,33.05805125,34.27619999999999,34.87750000000002,36.11333333333334,1027712,1464975.05,66.7614940462764,1.9668115221023814,1.5,2.75,NaN,NaN,0.5938060202212908,0.7015218450307396,738.4045717402774,0.1633942992449005,0.5228547161873678,0.3594604169424673,14.8998275790153,5.59766763848397,71.78014777125007,6.5697439911950894,21.65010823755484,4934558510
1500903000,36.19,36.25,35.945,36.17,34.53413793103448,36.16368421052632,35.4,21.64,32.9575,21.64,25.1025,19.0675,22.245,14.68,29.903163124999995,33.09017625,34.34099999999999,34.94700000000002,34.35931452694037,35.23557005485113,35.26230769230772,37.02541951905311,33.499195865562335,29.903163124999995,33.09017625,34.34099999999999,34.94700000000002,36.12166666666666,846537,1438961.65,65.91241818760795,1.8090873878693718,1.5,2.75,NaN,NaN,0.5731770187769128,0.5882971238323135,736.6987656445883,0.14432684747093938,0.5398689762811415,0.3955421288102021,15.392618839064353,5.605839416058399,54.927718911061575,15.822564350634615,29.2497167383038,4933711973
1500989400,36.56,36.6098,36.33,36.44,34.606896551724134,36.193421052631585,35.4,21.64,32.9575,21.64,25.1025,19.0675,22.245,14.68,29.964913124999995,33.13085125,34.414599999999986,35.02950000000002,34.44091003568781,35.350277668674835,35.480000000000025,37.06294759133812,33.89705240866193,29.964913124999995,33.13085125,34.414599999999986,35.02950000000002,36.45993333333333,1273415,1429023.15,68.25992488138968,2.256675933672161,1.5,2.75,NaN,NaN,0.5636500888642761,0.8911087269649901,738.985719673457,0.13843457340846343,0.5685853455707814,0.430150772162318,14.798058326843524,4.08454727220794,55.83056614733142,15.233984945189883,28.9354489074787,4934985388
1501075800,36.6,36.61,36.305,36.44,34.67965517241379,36.22315789473684,35.4,21.64,32.9575,21.64,25.1025,19.0675,22.245,14.68,30.027900624999994,33.17102625,34.478999999999985,35.151000000000025,34.5193057205628,35.45406074784866,35.65230769230772,37.12418046787483,34.180434916740616,30.027900624999994,33.17102625,34.478999999999985,35.151000000000025,36.45166666666666,1375845,1336742.45,68.25992488138967,1.8738177391952022,1.5,2.75,NaN,NaN,0.5451750825168278,1.029252119583694,739.8301808946497,0.12356283860681527,0.5846043204208371,0.4610414818140218,11.17543569549772,3.5815804434337637,42.52828835982641,25.07291800127577,32.398793638897814,4934985388
1501162200,36.67,36.68,35.6813,36.34,34.75241379310344,36.25289473684211,35.4,21.64,32.9575,21.64,25.1025,19.0675,22.245,14.68,30.088663124999993,33.213226250000005,34.542599999999986,35.225500000000025,34.590705496227,35.53843591472022,35.8092307692308,37.09404051961199,34.524421018849615,30.088663124999993,33.213226250000005,34.542599999999986,35.225500000000025,36.23376666666667,1551181,1326079.6,66.29872690003802,1.0548320511215934,1.5,2.75,NaN,NaN,0.5775697194799115,1.1697495384138328,738.1899137851593,0.09717916160244577,0.582515433817079,0.48533627221463327,11.796843969998122,2.0213363279056877,10.331651946561541,64.12950226585906,25.53884578757939,4933434207
1501248600,36.07,36.26,35.85,36.19,34.8251724137931,36.282631578947374,35.4,21.64,32.9575,21.64,25.1025,19.0675,22.245,14.68,30.15308812499999,33.256651250000004,34.637599999999985,35.337000000000025,34.65342292774751,35.600489637127815,35.95846153846157,36.88485557836023,35.03206749856291,30.15308812499999,33.256651250000004,34.637599999999985,35.337000000000025,36.1,1001870,1224630.65,63.35814016162049,0.6717470340859273,1.5,2.75,NaN,NaN,0.5713147395170608,0.8180997266400282,739.5539024641002,0.061550724036827376,0.5622746772606675,0.5007239532238401,10.873582660365004,1.6002245929253238,10.456319333112566,63.897691690294856,25.645988976592587,4932432337
1501507800,36.4,36.44,36.03,36.13,34.89793103448275,36.31236842105264,35.4,21.64,32.9575,21.64,25.1025,19.0675,22.245,14.68,30.21681312499999,33.30132625000001,34.72499999999999,35.437000000000026,34.711327910973104,35.65091919549659,36.04461538461541,36.79346539053178,35.295765378699045,30.21681312499999,33.30132625000001,34.72499999999999,35.437000000000026,36.199999999999996,1037556,1190347.25,62.17030419177781,0.8154649465660633,1.5,2.75,NaN,NaN,0.5597922581229848,0.8716414474851771,740.950145619677,0.02759885441565757,0.5352225212434121,0.5076236668277545,11.002827964985615,1.2612107623318465,9.228647473705626,66.14440138220398,24.62695114409038,4931394781
1501594200,36.45,36.45,36.16,36.35,34.97068965517241,36.3421052631579,35.4,21.64,32.9575,21.64,25.1025,19.0675,22.245,14.68,30.282788124999993,33.34735125,34.804799999999986,35.54050000000002,34.77558956152318,35.717498319735014,36.134615384615415,36.70650108511672,35.56272968411411,30.282788124999993,33.34735125,34.804799999999986,35.54050000000002,36.32,887419,1169357.15,64.77781691412503,0.9812030417806724,1.5,2.75,NaN,NaN,0.5426642396856288,0.758894748281139,743.0688059993771,0.014283680706955737,0.5254782677114491,0.5111945870044934,11.323583242823362,0.24820739106454334,5.083821141045999,75.40075238383558,19.515426475118414,4932282200
1501680600,36.44,36.48,35.95,36.4,35.04344827586206,36.37184210526316,36.44,21.64,32.9575,21.64,25.1025,19.0675,22.245,14.68,30.34896312499999,33.39080125000001,34.87539999999999,35.635000000000026,34.839291931659524,35.78249847976025,36.19461538461541,36.697445246320626,35.691785522910195,30.34896312499999,33.39080125000001,34.87539999999999,35.635000000000026,36.27666666666667,1110294,1177685.5,65.36217122850198,0.7541393581592609,1.5,2.75,NaN,NaN,0.5417596511366549,0.9427763184653288,740.9787291939388,0.0037196333584199603,0.5158441287025184,0.5121244953440984,6.7896607286044635,0.30311380545604694,17.77414694149115,51.93996651440581,30.285886544103032,4933392494
1501767000,36.38,36.38,36.0662,36.22,35.11620689655172,36.40157894736843,36.44,21.64,32.9575,21.64,25.1025,19.0675,22.245,14.68,30.41538812499999,33.43190125,34.938199999999995,35.765500000000024,34.89343734610425,35.824165291211656,36.24076923076926,36.61881778593006,35.86272067560846,30.41538812499999,33.43190125,34.938199999999995,35.765500000000024,36.22206666666667,743464,1142665.35,61.41213255721845,0.429218221855078,1.5,2.75,NaN,NaN,0.5269053903411793,0.6506401896233223,739.0964158703191,-0.019252816942362694,0.4880584741661451,0.5073112911085078,7.431399438045559,0,24.583549390957867,43.006172102635986,32.41027850640615,4932649030
1501853400,36.43,36.54,36.1873,36.39,35.18896551724137,36.431315789473686,36.44,21.64,32.9575,21.64,25.1025,19.0675,22.245,14.68,30.48067562499999,33.478426250000005,34.99999999999999,35.87500000000002,34.95212607762957,35.878054311096264,36.29538461538464,36.49807655816639,36.092692672602894,30.48067562499999,33.478426250000005,34.99999999999999,35.87500000000002,36.37243333333333,991115,1137055.25,63.64663383619902,0.6953534146105784,1.5,2.75,NaN,NaN,0.5144621481739521,0.8716506959534288,741.1224097406925,-0.026418296617521486,0.474288420336606,0.5007067169541275,7.8232922952730615,0.6082388719933615,53.08818901725736,16.982568746710708,29.929242236031918,4933640145
1502112600,36.41,36.575,36.35,36.55,35.261724137931026,36.46105263157895,36.44,21.64,32.9575,21.64,25.1025,19.0675,22.245,14.68,30.54580062499999,33.51860125,35.0556,35.987500000000026,35.014787800075474,35.942049138610905,36.31769230769233,36.5598815339221,36.075503081462564,30.54580062499999,33.51860125,35.0556,35.987500000000026,36.49166666666667,558441,1123934.75,65.66202896357927,0.9441944201812386,1.5,2.75,NaN,NaN,0.4937862804472413,0.49686247355551555,740.3171757209915,-0.02387861104779193,0.47085845314438757,0.4947370641921795,8.021607975334158,0.30186608122941666,79.86423000499262,3.475470602790298,16.66029939221707,4934198586
1502199000,36.42,37.04,36.11,36.33,35.33448275862068,37.04,36.44,21.64,32.9575,21.64,25.1025,19.0675,22.245,14.68,30.610450624999995,33.55790125000001,35.106199999999994,36.091500000000025,35.06636474909212,35.97899683969558,36.32076923076925,36.56248890801309,36.079049553525415,30.610450624999995,33.55790125000001,35.106199999999994,36.091500000000025,36.49333333333333,1060521,1104784.8,60.68061187461381,0.8013358952289859,1.5,2.75,NaN,NaN,0.5249444032724384,0.9599344596341296,737.7859547416975,-0.03958533850305357,0.44525539106336254,0.4848407295664161,7.817639682071892,-0.30186608122941666,46.88796008778655,21.420417518860322,31.691622393353114,4933138065
1502285400,35.96,36.32,35.77,36.28,35.407241379310335,37.08542857142857,36.44,21.64,32.9575,21.64,25.1025,19.0675,22.245,14.68,30.674700624999993,33.59857625000001,35.157799999999995,36.15500000000002,35.11395828834341,36.007663807343626,36.325384615384635,36.56145701426852,36.08931221650075,30.674700624999993,33.59857625000001,35.157799999999995,36.15500000000002,36.123333333333335,1500662,1095824.2,59.57442006600702,0.2491265778810653,1.5,2.75,NaN,NaN,0.5274483744672639,1.3694368129486463,734.3962945937819,-0.054965965700524866,0.41613327244076004,0.4710992381412849,7.838024115021529,-0.16510731975784884,13.096567358656069,59.085801532555315,27.817631108788614,4931637403
1502371800,35.87,35.94,34.7399,34.78,35.47999999999999,37.13085714285714,36.44,21.64,32.9575,21.64,25.1025,19.0675,22.245,14.68,30.730063124999987,33.62562500000001,35.18039999999999,36.135000000000026,35.10086188487897,35.89074344473947,36.218461538461554,37.07718496143298,35.35973811549013,30.730063124999987,33.62562500000001,35.18039999999999,36.135000000000026,35.1533,3793898,1235859.7,37.492692262599896,2.7228824626151136,1.5,2.75,NaN,NaN,0.5997806334338881,3.0698452259589013,728.1256145212994,-0.16174625566237055,0.2689164185633217,0.43066267422569227,25.295588146004906,-3.8961038961038867,4.79363838646326,76.10598706341455,19.100374550122186,4927843505
1502458200,34.89,35.1991,34.75,34.89,35.552758620689644,37.17628571428571,36.44,21.64,32.9575,21.64,25.1025,19.0675,22.245,14.68,30.78697562499999,33.66572500000001,35.18959999999999,36.09850000000002,35.0925927913543,35.795434545240475,36.099230769230786,37.19853016957522,34.99993136888635,30.78697562499999,33.66572500000001,35.18959999999999,36.09850000000002,34.94636666666667,2538164,1265763.2,39.27039759873375,2.6179395690962735,1.5,2.75,NaN,NaN,0.5890177310457533,2.005243950843254,729.7788940903177,-0.2171013931123399,0.15928593283526737,0.37638732594760727,25.66480874974845,-3.432050927207312,13.64235403443961,58.18383131812898,28.173814647431406,4930381669
1502717400,35.55,36.049,35.53,35.91,35.625517241379306,37.221714285714285,36.55,21.64,32.9575,21.64,25.1025,19.0675,22.245,14.68,30.849763124999992,33.714325,35.212999999999994,36.11300000000002,35.12464797600707,35.80634554093186,36.05846153846155,37.143403115161455,34.973519961761646,30.849763124999992,33.714325,35.212999999999994,36.11300000000002,35.82966666666667,2081067,1332114.5,52.70286960991274,0.2731152074956815,1.5,2.75,NaN,NaN,0.6297307502567708,1.562228321964816,734.2412365245108,-0.17875354139939886,0.1529453991983587,0.33169894059775756,31.75273136363684,-1.2104539202200957,23.58694425844557,44.14645262609498,32.26660311545945,4932462736
1502803800,36.1,36.13,35.7654,35.91,35.69827586206896,37.26714285714286,36.55,21.64,32.9575,21.64,25.1025,19.0675,22.245,14.68,30.91351312499999,33.763825000000004,35.23799999999999,36.124500000000026,35.15544609459503,35.81621739417644,36.025384615384624,37.100147283558115,34.95062194721113,30.91351312499999,33.763825000000004,35.23799999999999,36.124500000000026,35.93513333333333,948723,1319053.65,52.70286960991274,0.3127847824527298,1.5,2.75,NaN,NaN,0.6107928395241445,0.7192451952200731,731.7601606077121,-0.14837133077637382,0.14623477712729027,0.2946061079036641,31.475908521409508,-1.3461538461538516,29.248242677657966,37.59434388000515,33.157413442336875,4932462736
1502890200,36.16,36.37,35.885,36.09,35.771034482758616,37.312571428571424,36.55,21.64,32.9575,21.64,25.1025,19.0675,22.245,14.68,30.97925062499999,33.8156,35.27259999999999,36.11600000000003,35.19209526735601,35.8422919280644,36.01769230769232,37.08905818920573,34.94632642617891,30.97925062499999,33.8156,35.27259999999999,36.11600000000003,36.115,1277757,1329653.4,54.75121924157954,0.6036207181806577,1.5,2.75,NaN,NaN,0.6018076367009914,0.9609699790938,734.4100621194627,-0.11274916759101888,0.1536696484148905,0.2664188160059094,31.652986553537865,-0.358917725013792,49.56699648544278,19.414179724546152,31.01882379001107,4933740493
1502976600,35.77,35.9399,34.4,34.4,35.84379310344827,37.358,36.55,21.64,32.9575,21.64,25.1025,19.0675,22.245,14.68,31.03665062499999,33.851800000000004,35.2694,36.021500000000024,35.16103270785185,35.70493079205826,35.8846153846154,37.25513163512081,34.51409913410999,31.03665062499999,33.851800000000004,35.2694,36.021500000000024,34.9133,3538888,1457226.45,38.07738995681605,2.6880781694677185,1.5,2.75,NaN,NaN,0.6795356626509209,2.4285093095860293,729.6647410250417,-0.19479212949063335,0.022928654142617688,0.21772078363325104,41.6908987983587,-5.468535311898878,52.33574121029066,17.44796921705347,30.216289572655878,4930201605
1503063000,34.33,34.85,34.0113,34.23,35.916551724137925,37.40342857142857,36.55,21.64,32.9575,21.64,25.1025,19.0675,22.245,14.68,31.095550624999987,33.879775,35.262,35.922000000000025,35.12452162126942,35.56446119281462,35.72153846153847,37.31768470804494,34.125392215032,31.095550624999987,33.879775,35.262,35.922000000000025,34.36376666666666,2157713,1513726.5,36.86131788601259,3.2483113341586676,1.5,2.75,NaN,NaN,0.690904543890141,1.4254312123094892,730.8997227480301,-0.24883766494052995,-0.0933262975424114,0.15551136739811855,41.22413046511729,-6.347469220246239,19.261991219613527,49.775947866041555,30.96206091434492,4928043892
1503322200,34.21,34.4299,33.86,34.33,33.86,37.44885714285714,36.55,21.64,32.9575,21.64,25.1025,19.0675,22.245,14.68,31.157063124999986,33.907450000000004,35.2596,35.83000000000003,35.0933639106314,35.446893460165604,35.562307692307705,37.265375581937,33.85923980267841,31.157063124999986,33.907450000000004,35.2596,35.83000000000003,34.206633333333336,1750583,1558928.8,38.11337659208379,3.2198196016652227,1.5,2.75,NaN,NaN,0.6822613621837027,1.1229396749870808,731.4480416285834,-0.2647038790138813,-0.1753684813692331,0.08933539764464822,41.09579435082931,-5.505092210294523,15.473011512725346,55.304487605958975,29.222500881315682,4929794475
1503408600,34.59,35.45,34.5778,35.34,33.87361111111111,37.49428571428571,36.55,21.64,32.9575,21.64,25.1025,19.0675,22.245,14.68,31.225100624999985,33.942725,35.27839999999999,35.775000000000034,35.10303591413606,35.436713130626025,35.4946153846154,37.15721049022804,33.83202027900276,31.225100624999985,33.942725,35.27839999999999,35.775000000000034,35.122600000000006,1859509,1588233.5,49.09352608773859,0.5472489350432528,1.5,2.75,NaN,NaN,0.71352840774201,1.1708032855370447,734.8470961189632,-0.1971309131869434,-0.15707824383903102,0.04005266934791237,45.8027557945442,-2.5909592061741944,28.321994244070765,38.63379570574541,33.04421005018382,4931653984
1503495000,34.89,35.2,34.82,34.99,33.88722222222222,37.53971428571428,36.55,21.64,32.9575,21.64,25.1025,19.0675,22.245,14.68,31.291850624999984,33.97675,35.28039999999999,35.70250000000003,35.09860313318955,35.39416902294736,35.38692307692309,36.98363864073399,33.790207513112186,31.291850624999984,33.97675,35.28039999999999,35.70250000000003,35.00333333333334,1340583,1586470.4,46.04476705919716,0.7604839376688883,1.5,2.75,NaN,NaN,0.6997049500461524,0.8450097776800627,735.8170391449623,-0.16714489397710747,-0.16887844812347197,-0.0017335541463645021,45.97149090505077,0.6037952846463509,14.508902148461958,56.810861130109686,28.680236721428347,4930313401
1503581400,35.18,35.25,34.63,34.73,33.90083333333333,37.585142857142856,36.55,21.64,32.9575,21.64,25.1025,19.0675,22.245,14.68,31.350213124999982,34.009425,35.27939999999999,35.62200000000003,35.08414810835858,35.33091483028571,35.246923076923096,36.72599523130564,33.76785092254055,31.350213124999982,34.009425,35.27939999999999,35.62200000000003,34.87,3856265,1701724.6,43.86549287614405,1.0667737370077592,1.5,2.75,NaN,NaN,0.6940117393285699,2.2660922924896307,736.7848302992461,-0.15616501463633595,-0.19693982244178443,-0.04077480780544849,39.124154990876896,-0.45858412152480277,13.522200701609975,58.40433543353941,28.07346386485062,4926457136
1503667800,35.12,35.41,34.891,34.94,33.91444444444444,37.63057142857143,36.55,21.64,32.9575,21.64,25.1025,19.0675,22.245,14.68,31.40801312499998,34.0437,35.28679999999999,35.55950000000003,35.07849524136413,35.293684846448976,35.140000000000015,36.485350969364234,33.794649030635796,31.40801312499998,34.0437,35.28679999999999,35.55950000000003,35.08033333333333,1188972,1711079.7,46.08507505344808,0.21745888223072846,1.5,2.75,NaN,NaN,0.6930109008051006,0.6948665219977772,739.5111530646016,-0.12732316532221236,-0.19992876445821395,-0.07260559913600159,39.24698078805479,-2.7011974380395403,29.951864066448078,36.85702250311652,33.19111343043542,4927646108
1503927000,35.21,35.23,34.77,34.99,33.92805555555555,37.675999999999995,36.55,21.64,32.9575,21.64,25.1025,19.0675,22.245,14.68,31.462313124999977,34.0818,35.29559999999999,35.502500000000026,35.07502483974201,35.2647624801205,35.04076923076924,36.21449339017249,33.86704507136599,31.462313124999977,34.0818,35.29559999999999,35.502500000000026,34.99666666666667,913077,1704855.75,46.62620897497474,0.6538630381511678,1.5,2.75,NaN,NaN,0.6763672650333072,0.5355743440464098,737.8488781490906,-0.09871834763483414,-0.19600353367954426,-0.09728518604471012,34.83515815010163,-2.561960456697284,25.076942930077955,42.33887021241,32.58418685751204,4928559185
1504013400,34.32,35.2,34.27,35.06,33.94166666666666,37.72142857142857,36.55,21.64,32.9575,21.64,25.1025,19.0675,22.245,14.68,31.51618812499998,34.11795,35.288799999999995,35.43800000000003,35.07443563034036,35.245261291537595,35.062307692307705,36.22633660672928,33.898278777886134,31.51618812499998,34.11795,35.288799999999995,35.43800000000003,34.843333333333334,1381514,1729560.5,47.42184387462141,0.7953683755496392,1.5,2.75,NaN,NaN,0.6944838889594995,0.7987659292635325,737.0986022616434,-0.07026025623014046,-0.18511050633238568,-0.11485025010224523,34.908263734632435,-2.853976170684403,21.34782903244923,46.982427610648244,31.669743356902515,4929940699
1504099800,35.07,35.709,34.98,35.6,33.95527777777778,37.76685714285714,36.55,21.64,32.9575,21.64,25.1025,19.0675,22.245,14.68,31.573450624999982,34.16035,35.30579999999999,35.39800000000003,35.095045997777994,35.27904593043878,35.116923076923094,36.30975769994081,33.92408845390538,31.573450624999982,34.16035,35.30579999999999,35.39800000000003,35.42966666666666,1707206,1759406.1,53.21568345626062,1.1166005470584466,1.5,2.75,NaN,NaN,0.6969493254623929,0.9703308406171832,739.6181685508516,-0.013231510862640072,-0.13138963868054532,-0.11815812781790525,36.178152992561266,3.4883720930232642,44.03684404712225,23.674566604002553,32.2885893488752,4931647905
1504186200,35.9,36.34,35.84,36.2,33.96888888888889,37.812285714285714,36.55,21.64,32.9575,21.64,25.1025,19.0675,22.245,14.68,31.63352562499998,34.208375,35.33579999999999,35.397000000000034,35.138377527276894,35.36675584182556,35.139230769230785,36.39949842183995,33.87896311662162,31.63352562499998,34.208375,35.33579999999999,35.397000000000034,36.12666666666667,2357022,1840084,58.66587801134605,2.352773245852511,1.5,2.75,NaN,NaN,0.7000243736436506,1.2809317400727358,742.3853518427184,0.06257444295428512,-0.03994007412504885,-0.10251451707933397,21.980901388646153,5.755185509786755,99.99999999999999,0,0,4934004927
1504272600,36.4,36.567,36.27,36.39,33.9825,37.85771428571428,36.55,21.64,32.9575,21.64,25.1025,19.0675,22.245,14.68,31.69178812499998,34.259249999999994,35.371199999999995,35.397000000000034,35.18746076150133,35.4642076664136,35.17615384615386,36.54779045336749,33.80451723894023,31.69178812499998,34.259249999999994,35.371199999999995,35.397000000000034,36.409,2154154,1898235.95,60.245261701802654,2.7143084794428343,1.5,2.75,NaN,NaN,0.6762369183833895,1.1348188827632308,745.2617004472801,0.11986785191160629,0.047320297810173884,-0.0725475541014324,21.035194436972247,6.000582580833098,99.99999999999999,0,0,4936159081
1504618200,36.1,36.2,35.07,35.6,33.99611111111111,37.90314285714285,36.55,21.64,32.9575,21.64,25.1025,19.0675,22.245,14.68,31.74657562499998,34.3062,35.38759999999999,35.349500000000035,35.20363877085422,35.477140269612306,35.138461538461556,36.432301289657644,33.84462178726547,31.74657562499998,34.3062,35.38759999999999,35.349500000000035,35.623333333333335,2677316,2004179.7,51.44353447391346,0.35158652014689984,1.5,2.75,NaN,NaN,0.7222199956417189,1.3358662399384647,742.051473733237,0.09974002760551384,0.05212748040545989,-0.047612547200053944,26.5275583197314,0.7357102433503055,69.23220421421894,7.719637928725161,23.048157857055905,4933481765
1504704600,35.91,36.09,35.63,35.92,34.00972222222222,37.94857142857143,36.55,21.64,32.9575,21.64,25.1025,19.0675,22.245,14.68,31.801250624999984,34.362375,35.410199999999996,35.32900000000003,35.23173136807562,35.51931738679209,35.255384615384635,36.53580799211151,33.97496123865776,31.801250624999984,34.362375,35.410199999999996,35.32900000000003,35.88,2617899,2082048.6,54.35269522939834,1.155724575159465,1.5,2.75,NaN,NaN,0.7056328530958821,1.2573669029627839,744.3411564751957,0.10275148713758481,0.08082681172192707,-0.02192467541565774,21.553527389643655,2.6579022577879385,73.14667088845626,5.988059327618223,20.86526978392551,4936099664
1504791000,36.09,36.1,35.71,35.93,34.02333333333333,37.994,36.55,21.64,32.9575,21.64,25.1025,19.0675,22.245,14.68,31.85682562499999,34.410999999999994,35.4486,35.31150000000003,35.259114451680496,35.558430016621415,35.38615384615386,36.56411919660518,34.20818849570254,31.85682562499999,34.410999999999994,35.4486,35.31150000000003,35.913333333333334,2012382,2107634.6,54.44454872994716,0.8326051621325399,1.5,2.75,NaN,NaN,0.6830876493033191,0.9548059231899115,745.0616312974245,0.10009066860497726,0.10318866034056384,0.003097991735586579,20.308726087640597,3.4552260293694297,73.99001054837832,5.641354663126148,20.368634788495545,4938112046
1504877400,35.74,35.99,35.6476,35.76,34.036944444444444,38.039428571428566,36.55,21.64,32.9575,21.64,25.1025,19.0675,22.245,14.68,31.908813124999988,34.460674999999995,35.4668,35.36050000000003,35.27875702220283,35.57762715789556,35.49615384615386,36.51546095505113,34.47684673725659,31.908813124999988,34.460674999999995,35.4668,35.36050000000003,35.79919999999999,1071524,1971515.9,52.510100865960496,0.4591443786054933,1.5,2.75,NaN,NaN,0.6587528172102253,0.5435025910772519,743.8041749040666,0.08229875420879569,0.1059714344965812,0.023672680287785502,19.870201971091305,2.346880366342302,55.76872978561724,15.202229194549966,29.029041019832796,4937040522
1505136600,36.39,36.94,36.39,36.88,34.050555555555555,38.08485714285714,36.55,21.64,32.9575,21.64,25.1025,19.0675,22.245,14.68,31.96556312499999,34.523199999999996,35.5252,35.46000000000003,35.34155086446939,35.70166266666742,35.614615384615405,36.865451791175566,34.363778978055244,31.96556312499999,34.523199999999996,35.5252,35.46000000000003,36.73666666666667,1122081,1900711.75,62.071511098914165,2.8377375694070373,1.5,2.75,NaN,NaN,0.6959847588380663,0.5903477999754566,747.7307741729228,0.138092854432383,0.19628874832826426,0.05819589389588126,25.55969303891491,5.401543298085168,47.93449700117892,20.634080531128923,31.43142246769216,4938162603
1505223000,37.08,37.29,36.98,37.27,34.064166666666665,38.13028571428571,36.55,21.64,32.9575,21.64,25.1025,19.0675,22.245,14.68,32.02402562499999,34.582425,35.587999999999994,35.528000000000034,35.41717632076471,35.85102812698481,35.79000000000001,37.26128410685257,34.318715893147456,32.02402562499999,34.582425,35.587999999999994,35.528000000000034,37.18,1108053,1852061.05,64.7341161149387,3.1096653254199027,1.5,2.75,NaN,NaN,0.6755572760639185,0.5982810339864336,750.0231904557547,0.19018278795707322,0.2959243788422228,0.10574159088514956,25.5748078643415,6.303479749001713,84.64037589829383,2.0845106666773288,13.275113435028848,4939270656
1505309400,37.11,37.35,37.08,37.34,34.077777777777776,38.175714285714285,36.55,21.64,32.9575,21.64,25.1025,19.0675,22.245,14.68,32.08147562499999,34.6454,35.64919999999999,35.599500000000035,35.4925811709308,35.992834972033876,35.990769230769246,37.53897835078177,34.44256011075672,32.08147562499999,34.6454,35.64919999999999,35.599500000000035,37.25666666666667,653960,1837322.9,65.20624505495195,2.8254576760028436,1.5,2.75,NaN,NaN,0.6465888992022102,0.3559309035989265,750.8813783643659,0.21636526370120013,0.3761981705116497,0.1598329068104496,25.58242320617895,4.887640449438208,79.04188390467,3.7505011288773584,17.207614966452642,4939924616
1505395800,37.15,37.3819,37.061,37.3,34.091388888888886,38.22114285714285,36.55,21.64,32.9575,21.64,25.1025,19.0675,22.245,14.68,32.14051312499999,34.698,35.705,35.66000000000003,35.56346034069822,36.11732687945922,36.17230769230771,37.73845247088204,34.606162913733385,32.14051312499999,34.698,35.705,35.66000000000003,37.24763333333333,630411,1804955.6,64.67342769934149,2.4496680584511217,1.5,2.75,NaN,NaN,0.6233254064020525,0.3492667631270265,752.4726388998355,0.21742383495422998,0.4316127005032371,0.2141888655490071,25.200611422721842,3.0386740331491553,51.67499512096781,17.915775437853444,30.40922944117875,4939294205
1505482200,37.21,37.46,37.1493,37.42,34.105000000000004,38.266571428571424,36.55,21.64,32.9575,21.64,25.1025,19.0675,22.245,14.68,32.19951312499999,34.746125,35.7812,35.81100000000003,35.636265817533584,36.24139098617739,36.35923076923079,37.896089934761115,34.82237160370047,32.19951312499999,34.746125,35.7812,35.81100000000003,37.3431,721717,1664097.05,65.58204330758605,2.2998601709100677,1.5,2.75,NaN,NaN,0.6009950202304777,0.4336988638973911,754.8904040322034,0.21239501085950507,0.47968262912338844,0.26728761826388336,24.004166181016345,2.8304479252541936,82.59664674941376,2.6413833609969144,14.761969889589317,4940015922
1505741400,37.61,37.8299,37.45,37.64,34.118611111111115,38.312,36.55,21.64,32.9575,21.64,25.1025,19.0675,22.245,14.68,32.26065062499999,34.7967,35.85,35.981500000000025,35.7148436286107,36.37459184463669,36.55769230769233,38.03746679874787,35.077917816636784,32.26065062499999,34.7967,35.85,35.981500000000025,37.639966666666666,835100,1597966.4,67.24536982381237,2.559671187769726,1.5,2.75,NaN,NaN,0.5873453759283007,0.5226017267947561,756.8099572835316,0.20971201975096027,0.5294276429525837,0.31971562320162344,24.02515865137882,5.730337078651683,81.2812209775207,3.031202480999146,15.687576541480171,4940851022
1505827800,37.77,37.81,37.59,37.75,34.132222222222225,38.35742857142857,36.55,21.64,32.9575,21.64,25.1025,19.0675,22.245,14.68,32.32363812499999,34.8476,35.919000000000004,36.152500000000025,35.794653682390674,36.50558309752844,36.72307692307694,38.21824626497328,35.227907581180595,32.32363812499999,34.8476,35.919000000000004,36.152500000000025,37.71666666666667,386639,1529769.2,68.07610572376463,2.4701685581864643,1.5,2.75,NaN,NaN,0.5611064205048506,0.25274335501067746,757.9588698128392,0.2011420790058201,0.5711432219588986,0.37000114295307845,17.905524503131456,5.094654788418703,76.54547963579631,4.633150163634086,18.821370200569596,4941237661
1505914200,37.81,37.86,37.27,37.83,34.145833333333336,38.40285714285714,36.55,21.64,32.9575,21.64,25.1025,19.0675,22.245,14.68,32.386888124999984,34.9015,35.9906,36.27700000000003,35.87447118504202,36.63171804062097,36.84846153846156,38.41864224641249,35.278280830510624,32.386888124999984,34.9015,35.9906,36.27700000000003,37.65333333333333,933903,1483488.9,68.69789862178689,1.8276404801928219,1.5,2.75,NaN,NaN,0.5631702476116468,0.629531505089118,759.5889443071931,0.18695858933321047,0.6036993796195915,0.41674079028638106,17.904078547199404,5.2880601168939565,78.73512512579148,3.8543346707545294,17.410540203453987,4942171564
1506000600,37.73,37.75,37.4064,37.51,34.159444444444446,38.44828571428571,36.55,21.64,32.9575,21.64,25.1025,19.0675,22.245,14.68,32.44636312499999,34.9503,36.0406,36.40300000000003,35.93860956994233,36.715363941514205,36.93461538461541,38.51757493771384,35.351655831516986,32.44636312499999,34.9503,36.0406,36.40300000000003,37.55546666666666,767853,1454852.4,63.38014969346478,1.444922315111176,1.5,2.75,NaN,NaN,0.5532009442108149,0.5277875611299125,757.9460054403144,0.14404697594112725,0.5967995102127901,0.45275253427166284,19.422619852958857,4.893736017897092,74.38814307590313,5.463484153308019,20.14837277078885,4941403711
1506087000,37.32,37.59,37.31,37.51,34.17305555555556,38.49371428571428,36.55,21.64,32.9575,21.64,25.1025,19.0675,22.245,14.68,32.50453812499999,34.998400000000004,36.087199999999996,36.54200000000002,36.000232724062236,36.7910435661319,37.081538461538486,38.48625241881774,35.67682450425923,32.50453812499999,34.998400000000004,36.087199999999996,36.54200000000002,37.47,591401,1291609.2,63.38014969346478,0.9456733122275836,1.5,2.75,NaN,NaN,0.5336865910528996,0.457879209903429,760.6456884380547,0.10547196906578399,0.5845924956038928,0.4791205265381088,18.796490165730557,1.7082429501084475,67.06626498167675,8.738641706066408,24.195093312256834,4941403711
1506346200,37.35,37.55,36.8899,37.3,34.18666666666667,38.539142857142856,36.55,21.64,32.9575,21.64,25.1025,19.0675,22.245,14.68,32.556600624999994,35.04600000000001,36.1208,36.660000000000025,36.051203989785286,36.83951560745267,37.18769230769232,38.423694643915006,35.95168997146964,32.556600624999994,35.04600000000001,36.1208,36.660000000000025,37.24663333333333,1759726,1320146.9,59.853881202973064,0.28141160085512346,1.5,2.75,NaN,NaN,0.5427161202634068,1.332977413346954,762.2517115838491,0.05799512738969548,0.5516144357752282,0.4936193083855327,9.813751246681429,0.0804936946605689,15.565822155884934,55.13885506816777,29.29532277594731,4939643985
1506432600,37.48,37.61,37.221,37.35,34.20027777777778,38.58457142857142,36.55,21.64,32.9575,21.64,25.1025,19.0675,22.245,14.68,32.607838124999994,35.093,36.1554,36.77800000000003,36.10213716665645,36.888133168647656,37.29692307692309,38.2976115972894,36.29623455655679,32.607838124999994,35.093,36.1554,36.77800000000003,37.39366666666666,1117105,1330348.3,60.4185441274514,0.6729524904312832,1.5,2.75,NaN,NaN,0.5317363973874494,0.8397086687749366,764.0830624933818,0.02388801257617973,0.5234793241057574,0.49959131152957764,7.815874848426665,0.02678093197642745,26.979453692850992,40.12121895289604,32.89932735425297,4940761090
1506519000,37.69,37.96,37.2484,37.74,34.21388888888889,38.629999999999995,37.83,21.64,32.9575,21.64,25.1025,19.0675,22.245,14.68,32.65860062499999,35.14000000000001,36.1966,36.91200000000002,36.16636708168953,36.96926334306217,37.44923076923078,37.9413509258193,36.95711061264226,32.65860062499999,35.14000000000001,36.1966,36.91200000000002,37.64946666666666,1751657,1348855.45,64.60086753480151,1.4298660066264604,1.5,2.75,NaN,NaN,0.5445837975740605,1.2986246969606714,766.0370793352186,0.02159229494863002,0.5265816802153651,0.5049893852667351,9.757610676739672,1.1796246648793696,38.012662187580915,28.86440269625653,33.12293511616255,4942512747
1506605400,37.61,37.922,37.579,37.88,34.2275,38.67542857142857,37.83,21.64,32.9575,21.64,25.1025,19.0675,22.245,14.68,32.71056312499999,35.188300000000005,36.229,37.026000000000025,36.23356837260366,37.05600016753244,37.52615384615386,37.94557017770474,37.10673751460298,32.71056312499999,35.188300000000005,36.229,37.026000000000025,37.79366666666667,931123,1310051.3,65.99011349624703,1.3023354598512342,1.5,2.75,NaN,NaN,0.5301849548901988,0.710753082722791,767.9924640574062,0.023352060937325114,0.5341794614383915,0.5108274005010663,9.759609232496349,1.229289150187068,60.073787249739,12.511593988221387,27.414618762039623,4943443870
1506691800,37.85,38.3,37.79,38.23,34.24111111111111,38.72085714285714,37.83,21.64,32.9575,21.64,25.1025,19.0675,22.245,14.68,32.761650624999994,35.2409,36.2678,37.12750000000002,36.311859808972144,37.16780967538649,37.600000000000016,38.13510602831446,37.06489397168557,32.761650624999994,35.2409,36.2678,37.12750000000002,38.10666666666666,987387,1241569.55,69.24019866879074,1.8900709027405673,1.5,2.75,NaN,NaN,0.5287431723980416,0.795273208818628,770.221478175129,0.04090996097909683,0.5619648517249374,0.5210548907458405,10.69160089911264,1.5674814027630082,67.04660931234385,8.742994516928537,24.21039617072762,4944431257
1506951000,38.39,38.76,38.35,38.76,34.25472222222222,38.76628571428571,37.83,21.64,32.9575,21.64,25.1025,19.0675,22.245,14.68,32.818675625,35.29740000000001,36.3186,37.24600000000002,36.40786530665951,37.319446849159206,37.70923076923078,38.50411679060884,36.91434474785272,32.818675625,35.29740000000001,36.3186,37.24600000000002,38.623333333333335,1159839,1191853.8,73.38751777711477,2.6355154575743565,1.5,2.75,NaN,NaN,0.5288329457981815,0.9731386517373187,772.8911734250167,0.07884334866224985,0.6196090765736528,0.540765727911403,12.502694226414135,2.6754966887417164,100,0,0,4945591096
1507037400,38.84,39.02,38.73,39.02,34.26833333333333,38.81171428571428,37.83,21.64,32.9575,21.64,25.1025,19.0675,22.245,14.68,32.875375625,35.35830000000001,36.3756,37.417000000000016,36.510301961300314,37.48140429209643,37.84153846153847,38.860824671931915,36.822252251145024,32.875375625,35.35830000000001,36.3756,37.417000000000016,38.92333333333334,616498,1088812.9,75.15709099569273,2.809386453457111,1.5,2.75,NaN,NaN,0.5117734496697405,0.5662111461023286,774.3335800641971,0.11014869722518739,0.6784515994428872,0.5683029022176999,12.686266838228406,3.1456515992598595,100,0,0,4946207594
1507123800,38.95,39.284,38.89,39.13,34.28194444444445,38.857142857142854,37.83,21.64,32.9575,21.64,25.1025,19.0675,22.245,14.68,32.93338812499999,35.422000000000004,36.4294,37.57750000000002,36.61303521771991,37.63841340713486,37.97307692307693,39.16717483467598,36.77897901147788,32.93338812499999,35.422000000000004,36.4294,37.57750000000002,39.101333333333336,1407404,1028288.15,75.88760332918827,2.824932748296371,1.5,2.75,NaN,NaN,0.5033610604076161,1.3686863939840208,773.7581447265487,0.12583494043831456,0.725596577765593,0.5997616373272785,12.668623585228332,4.318848307118114,100,0,0,4947614998
1507210200,39.32,39.84,39.2572,39.82,34.29555555555556,38.90257142857142,37.83,21.64,32.9575,21.64,25.1025,19.0675,22.245,14.68,32.994100624999994,35.488000000000014,36.497,37.77200000000003,36.73879854251521,37.8461835588363,38.140769230769244,39.66681916519697,36.61471929634152,32.994100624999994,35.488000000000014,36.497,37.77200000000003,39.63906666666667,1349100,995124.05,79.88353350815233,3.7334172745767695,1.5,2.75,NaN,NaN,0.518120984664215,1.3557103760078957,776.0094069987377,0.16763657395220366,0.8093073547675331,0.6416707808153295,12.52945418980094,6.158357771261003,100,0,0,4948964098
1507296600,39.6,39.7328,39.4601,39.69,34.30916666666667,38.94799999999999,37.83,21.64,32.9575,21.64,25.1025,19.0675,22.245,14.68,33.052550624999995,35.553300000000014,36.564,37.96850000000003,36.854531933004814,38.02178512466141,38.29000000000001,40.00209273652498,36.57790726347505,33.052550624999995,35.553300000000014,36.564,37.96850000000003,39.62763333333333,1158923,999494,77.28486485113795,2.8722934607665698,1.5,2.75,NaN,NaN,0.5068194857596284,1.1595097119142286,773.5448433306468,0.17090295547278822,0.8552994751563148,0.6843965196835265,13.21990056370982,6.407506702412871,75.08306892144391,5.187980610356302,19.728950468199795,4947805175
1507555800,39.8,39.85,39.36,39.52,34.32277777777778,38.993428571428566,37.83,21.64,32.9575,21.64,25.1025,19.0675,22.245,14.68,33.111200624999995,35.63410000000001,36.6306,38.100500000000025,36.95906009249482,38.16447225564604,38.420000000000016,40.22667139747703,36.613328602523005,33.111200624999995,35.63410000000001,36.6306,38.100500000000025,39.576666666666675,961078,991443.85,73.89935157171558,2.3824993905929173,1.5,2.75,NaN,NaN,0.5056180939196551,0.9693720930338112,772.0448433306468,0.14690272952077332,0.8680249315844932,0.7211222020637199,12.824631437820173,5.809906291834007,50.405310906619405,18.834886049539968,30.759803043840634,4946844097
1507642200,39.79,40.005,39.52,39.8,34.33638888888889,39.03885714285714,37.83,21.64,32.9575,21.64,25.1025,19.0675,22.245,14.68,33.171988125,35.714500000000015,36.70399999999999,38.227000000000025,37.07046950063228,38.32023680272737,38.59615384615386,40.45924537884129,36.733062313466434,33.171988125,35.714500000000015,36.70399999999999,38.227000000000025,39.775,1020021,987042.25,75.78116720457254,2.4459377440681482,1.5,2.75,NaN,NaN,0.504145372925394,1.0334116903303785,774.5815306603538,0.13545358143179975,0.8904391788534696,0.7549855974216698,12.516882469567346,5.458399576046622,54.40160301400984,16.075747177359112,29.522649808631048,4947864118
1507728600,39.75,40,39.68,39.99,34.35,39.084285714285706,37.83,21.64,32.9575,21.64,25.1025,19.0675,22.245,14.68,33.233350625,35.79080000000001,36.7768,38.359500000000025,37.184960892764344,38.47926186913429,38.786923076923095,40.67380711176645,36.90003904207974,33.233350625,35.79080000000001,36.7768,38.359500000000025,39.89000000000001,1247893,1016738.9,76.99332692745229,2.34774824193986,1.5,2.75,NaN,NaN,0.4909921320021516,1.2273485355974871,776.4655871547753,0.12641907319912993,0.9130094389205823,0.7865903657214524,12.267877998113738,5.5702217529039055,53.21445694271617,16.87221366039574,29.913329396888088,4949112011
1507815000,39.81,40,39.67,39.8,34.36361111111111,39.12971428571428,37.83,21.64,32.9575,21.64,25.1025,19.0675,22.245,14.68,33.292763125,35.86010000000001,36.84479999999999,38.484500000000025,37.287511445989274,38.60504645302626,38.97923076923078,40.72505588230591,37.233405656155654,33.292763125,35.86010000000001,36.84479999999999,38.484500000000025,39.82333333333333,1105931,1040514.9,73.0556065359868,1.8822517591904158,1.5,2.75,NaN,NaN,0.4794926940019978,1.0628689699686185,777.7595804332166,0.09483277140892543,0.9051313299826091,0.8102985585736837,13.672793183091962,4.106722469264977,23.60840707262569,44.15836833772407,32.23322458965023,4948006080
1507901400,40.02,40.09,39.84,39.93,34.37722222222222,39.17514285714285,37.83,21.64,32.9575,21.64,25.1025,19.0675,22.245,14.68,33.356050625,35.92860000000001,36.919,38.61000000000003,37.39113844810734,38.731232505118996,39.17769230769232,40.71123830100633,37.644146314378304,33.356050625,35.92860000000001,36.919,38.61000000000003,39.95333333333334,1724191,1090638.6,74.03412534815146,1.9119470356793924,1.5,2.75,NaN,NaN,0.46595750157328414,1.580900400921075,779.9366971959039,0.07097275780435619,0.899014505829129,0.8280417480247728,13.41981649372257,3.0185758513931935,57.3270980357388,14.194882492367935,28.478019471893262,4949730271
1508160600,40.06,40.19,39.875,40.08,34.39083333333333,39.220571428571425,37.83,21.64,32.9575,21.64,25.1025,19.0675,22.245,14.68,33.420325625000004,35.99640000000001,36.992799999999995,38.73200000000003,37.496583999161956,38.85968655225052,39.357692307692325,40.71293634126434,38.00244827412031,33.420325625000004,35.99640000000001,36.992799999999995,38.73200000000003,40.04833333333333,1329931,1115380.15,75.15528479486795,1.7821318932580779,1.5,2.75,NaN,NaN,0.45517482288947797,1.192356704572876,779.2961845806835,0.05432080529641947,0.8959427546452972,0.8416219493488777,12.007835974310762,2.7165556125063945,80.7479166217478,3.2037549801472176,16.04832839810497,4951060202
1508247000,40.06,40.19,39.95,40.16,34.404444444444444,39.26599999999999,37.83,21.64,32.9575,21.64,25.1025,19.0675,22.245,14.68,33.486438125,36.060300000000005,37.065,38.85250000000003,37.60103168546933,38.98352592822666,39.53307692307693,40.646557526075675,38.41959632007819,33.486438125,36.060300000000005,37.065,38.85250000000003,40.1,999877,1146042.05,75.75651782943538,1.6134287055019427,1.5,2.75,NaN,NaN,0.4398051926830863,0.8724610061210232,777.6743230629796,0.03846860413654485,0.8897077045195587,0.8512391003830139,11.831780779136702,2.632251469460756,80.71017465050264,3.21560429769827,16.0742210517991,4952060079
1508333400,40.37,40.39,40.18,40.26,34.418055555555554,39.311428571428564,37.83,21.64,32.9575,21.64,25.1025,19.0675,22.245,14.68,33.550200625,36.124900000000004,37.1436,38.974000000000025,37.70530495270582,39.10509488744317,39.68923076923078,40.57378059957776,38.804680938883806,33.550200625,36.124900000000004,37.1436,38.974000000000025,40.276666666666664,894661,1144079.95,76.52136787938738,1.8851456943763623,1.5,2.75,NaN,NaN,0.42481910749143753,0.7819916781165512,778.5300586907099,0.02513734575332882,0.8826607825746748,0.857523436821346,11.833929597562635,1.104972375690602,79.44594684403167,3.6239282689770977,16.930124886991237,4952954740
1508419800,39.87,40.32,39.63,40.32,34.43166666666667,39.35685714285714,37.83,21.64,32.9575,21.64,25.1025,19.0675,22.245,14.68,33.611825625,36.19110000000001,37.224399999999996,39.11450000000003,37.807842013384025,39.220800136258106,39.80923076923079,40.57183608255172,39.046625455909854,33.611825625,36.19110000000001,37.224399999999996,39.11450000000003,40.09,1729748,1192174.7,76.99042510358879,1.297869858941365,1.5,2.75,NaN,NaN,0.44376059981347754,1.4509182253238557,779.0627722946133,0.011475012408601382,0.8718672023320977,0.8603921899234963,7.295648516742974,1.5873015873015939,100.00000000000001,0,0,4954684488
1508506200,40.73,40.91,40.59,40.88,34.44527777777778,39.40228571428571,37.83,21.64,32.9575,21.64,25.1025,19.0675,22.245,14.68,33.676575625,36.26340000000001,37.346399999999996,39.28300000000003,37.928318797172885,39.378819170900194,39.95230769230771,40.76520957289086,39.139405811724565,33.676575625,36.26340000000001,37.346399999999996,39.28300000000003,40.79333333333333,1931995,1259204.4,80.8382084417129,2.393207378751287,1.5,2.75,NaN,NaN,0.4542062712553717,1.5342981647776963,781.4892616243425,0.030204047816259738,0.898147249693821,0.8679432018775612,9.622695344183771,3.441295546558703,100.00000000000001,0,0,4956616483
1508765400,41.07,41.07,40.39,40.46,34.45888888888889,39.44771428571428,37.83,21.64,32.9575,21.64,25.1025,19.0675,22.245,14.68,33.737650625,36.32370000000001,37.4578,39.44100000000003,38.027600412970024,39.4817887736716,40.0546153846154,40.75475231120643,39.354478458024374,33.737650625,36.32370000000001,37.4578,39.44100000000003,40.64000000000001,1741068,1258271.5,71.21891224751299,1.7432667253448761,1.5,2.75,NaN,NaN,0.47033439473713085,1.3836981923217684,778.7571771244989,0.00564340697254484,0.8749974605932422,0.8693540536206974,11.682599856421474,1.6582914572864416,72.20736841779869,6.392908310548687,21.39972327165261,4954875415
1508851800,40.66,40.77,40.46,40.65,34.472500000000004,39.49314285714285,37.83,21.64,32.9575,21.64,25.1025,19.0675,22.245,14.68,33.801013125,36.38280000000002,37.5526,39.60600000000003,38.130439612461394,39.59304698570288,40.11846153846155,40.870805410487606,39.3661176664355,33.801013125,36.38280000000002,37.5526,39.60600000000003,40.626666666666665,1370468,1270939.65,72.79597432120296,1.4615500510170716,1.5,2.75,NaN,NaN,0.45888193797019305,1.0783108387561913,780.2014546255352,-0.005846942444828196,0.8620453755646622,0.8678923180094904,11.409259151133794,1.650412603150779,73.82008454550277,5.7174726621236855,20.46244279237355,4956245883
1508938200,40.47,40.52,39.42,40.07,34.486111111111114,39.53857142857142,37.83,21.64,32.9575,21.64,25.1025,19.0675,22.245,14.68,33.861600624999994,36.436900000000016,37.635799999999996,39.72250000000003,38.206500804129575,39.6384710823026,40.14769230769233,40.85961943646774,39.435765178916924,33.861600624999994,36.436900000000016,37.635799999999996,39.72250000000003,40.00333333333333,3105345,1338624.05,61.68439112687466,0.1370787299627571,1.5,2.75,NaN,NaN,0.5139617995437505,2.3198036819971968,776.3532718546293,-0.057669018081488055,0.7958060454076303,0.8534750634891184,14.609139817281445,0.6783919597990029,36.738621675008275,30.12558687284363,33.13579145214809,4953140538
1509024600,40.36,40.515,40.16,40.2,34.499722222222225,39.583999999999996,37.83,21.64,32.9575,21.64,25.1025,19.0675,22.245,14.68,33.92167562499999,36.495300000000015,37.717999999999996,39.83850000000003,38.28467724318332,39.69195002684521,40.20000000000003,40.81278682452198,39.587213175478084,33.92167562499999,36.495300000000015,37.717999999999996,39.83850000000003,40.291666666666664,1952964,1389716.1,63.04593257928414,0.5657718807911176,1.5,2.75,NaN,NaN,0.509035956719197,1.4052970962918252,777.8024095292482,-0.08661165885223243,0.7452104899238279,0.8318221487760603,14.334342108229546,0.6761833208114278,38.18535063033789,28.790040144409797,33.02460922525232,4955093502
1509111000,40.61,41.24,40.44,41.15,34.513333333333335,39.62942857142856,37.83,21.64,32.9575,21.64,25.1025,19.0675,22.245,14.68,33.98751312499999,36.561200000000014,37.852999999999994,39.98450000000003,38.397042841489856,39.830811929050434,40.30384615384618,41.052734086780525,39.554958220911836,33.98751312499999,36.561200000000014,37.852999999999994,39.98450000000003,40.943333333333335,1782666,1429480.05,71.12181471028921,2.2090190829714635,1.5,2.75,NaN,NaN,0.5469619598106829,1.2470730179130516,780.2264776377572,-0.047168802221936534,0.7728611459986396,0.8200299482205762,19.26929528158978,2.6696606786427153,37.26286241602385,29.637313565333052,33.09982401864309,4956876168
1509370200,40.85,41.1,40.54,40.73,34.526944444444446,39.674857142857135,37.83,21.64,32.9575,21.64,25.1025,19.0675,22.245,14.68,34.05036312499999,36.62250000000002,37.983,40.083000000000034,38.48853135750986,39.91644888818849,40.360769230769264,41.11802994345826,39.60350851808027,34.05036312499999,36.62250000000002,37.983,40.083000000000034,40.79,1209826,1431979.4,64.41907187987881,1.221977014325754,1.5,2.75,NaN,NaN,0.5514646769670626,0.8448627124105278,777.5376330796855,-0.054253592577365284,0.7522129574988696,0.8064665500762349,20.69308038987799,1.4193227091633474,40.5139393708532,26.665385543392247,32.82067508575455,4955666342
1509456600,40.92,41.02,40.7284,40.87,34.54055555555556,39.72028571428571,37.83,21.64,32.9575,21.64,25.1025,19.0675,22.245,14.68,34.115425624999986,36.686700000000016,38.1138,40.175500000000035,38.58192228466634,40.00726327978958,40.44307692307696,41.1706602618038,39.715493584350114,34.115425624999986,36.686700000000016,38.1138,40.175500000000035,40.872800000000005,1028606,1452584.8,65.58341486981871,1.3710695467929799,1.5,2.75,NaN,NaN,0.5329029143265583,0.708121136886466,780.6260730642832,-0.054268067605895864,0.738631465568865,0.7928995331747609,20.719230451846634,1.5151515151515138,38.14647209372007,28.77209698074257,33.08143092553736,4956694948
1509543000,41.32,41.4953,40.85,41.07,34.55416666666667,39.76571428571428,37.83,21.64,32.9575,21.64,25.1025,19.0675,22.245,14.68,34.180588124999986,36.75340000000002,38.22839999999999,40.272500000000036,38.67949395977747,40.10847630076201,40.53076923076927,41.264629898260004,39.79690856327854,34.180588124999986,36.75340000000002,38.22839999999999,40.272500000000036,41.13843333333333,1333464,1448887.8,67.23304430633505,1.6174891995740874,1.5,2.75,NaN,NaN,0.5409312775889469,0.9203362744858504,781.8762831306657,-0.04589749942495547,0.7355276588935666,0.7814251583185221,20.795533874059682,1.8601190476190477,81.3845902925083,3.0034978302415447,15.611911877250158,4958028412
1509629400,41.02,41.152,40.42,41.1,34.56777777777778,39.81114285714285,37.83,21.64,32.9575,21.64,25.1025,19.0675,22.245,14.68,34.24740062499998,36.81550000000002,38.35059999999999,40.336500000000036,38.77441576527639,40.202907129260865,40.60923076923081,41.35159545416928,39.86686608429235,34.24740062499998,36.81550000000002,38.35059999999999,40.336500000000036,40.89066666666667,1400912,1451478.4,67.48480097319612,1.0132565454801639,1.5,2.75,NaN,NaN,0.5545790434754506,0.9651621408902813,782.2963671558741,-0.0434545407850484,0.7271069823372116,0.77056152312226,20.806778644044446,0.5381604696673161,79.77912643171848,3.510337134650893,16.710536433630626,4959429324
1509715800,41.18,41.4999,40.93,41.46,34.58138888888889,39.85657142857142,37.83,21.64,32.9575,21.64,25.1025,19.0675,22.245,14.68,34.314650624999985,36.882300000000015,38.48519999999999,40.42500000000003,38.87973279408908,40.32263025980745,40.709230769230814,41.52881646338315,39.88964507507848,34.314650624999985,36.882300000000015,38.48519999999999,40.42500000000003,41.29663333333334,1464625,1466763.5,70.42166930185682,1.7665341416037112,1.5,2.75,NaN,NaN,0.5556733975129182,0.9985420280774644,781.390447923728,-0.023696086149055162,0.740941415435941,0.7646375015849962,19.93475984381142,2.4715768660405337,78.67308799547084,3.8802259577123674,17.446686046816794,4960893949
1509978600,41.4,41.73,41.36,41.63,34.595,39.901999999999994,37.83,21.64,32.9575,21.64,25.1025,19.0675,22.245,14.68,34.38375062499998,36.95290000000002,38.619,40.53050000000003,38.987586410007154,40.44714166363531,40.81461538461543,41.723498566907445,39.905732202323414,34.38375062499998,36.95290000000002,38.619,40.53050000000003,41.57333333333333,1080148,1472717,71.7206382419512,2.0422368936077717,1.5,2.75,NaN,NaN,0.542411011976281,0.7334389431234921,783.5083984155276,-0.006191732872733224,0.7568978354940796,0.7630895683668129,18.497607127238187,2.4108241082410924,99.99999999999999,0,0,4961974097
1510065000,41.74,41.9,41.3,41.6,34.60861111111112,39.94742857142857,37.83,21.64,32.9575,21.64,25.1025,19.0675,22.245,14.68,34.45011312499999,37.02340000000002,38.7512,40.620500000000035,39.09003400177158,40.55693769567004,40.913076923076964,41.86271279225192,39.96344105390201,34.45011312499999,37.02340000000002,38.7512,40.620500000000035,41.599999999999994,1336708,1488551.35,71.12700712452383,1.5954758907421767,1.5,2.75,NaN,NaN,0.5465245111208324,0.8979925348225306,781.4413407789999,-0.003767234334626446,0.7583805254485299,0.7621477597831563,18.5613262384108,3.818317943598705,76.12149982008805,4.790416410806888,19.088083769105065,4960637389
1510151400,41.45,41.8311,41.339,41.81,34.62222222222223,39.99285714285713,37.83,21.64,32.9575,21.64,25.1025,19.0675,22.245,14.68,34.51401312499999,37.08750000000001,38.886199999999995,40.711500000000036,39.19669933503544,40.67627696274908,40.984615384615424,42.046938394586874,39.92229237464397,34.51401312499999,37.08750000000001,38.886199999999995,40.711500000000036,41.66003333333333,942856,1473299.5,72.8227527346928,1.6434208764934504,1.5,2.75,NaN,NaN,0.542637046040773,0.6399622072769318,782.0399502788689,0.0044032327845611174,0.7676518007638578,0.7632485679792966,15.229042297884623,4.004975124378108,74.48444921616752,5.42398025868383,20.09157052514865,4961580245
1510237800,41.14,41.43,40.4541,41.34,34.63583333333334,40.038285714285706,37.83,21.64,32.9575,21.64,25.1025,19.0675,22.245,14.68,34.57590062499999,37.15340000000001,39.001,40.78850000000004,39.280750341504636,40.7394886805825,41.052307692307735,42.08399499872613,40.02062038588934,34.57590062499999,37.15340000000001,39.001,40.78850000000004,41.0747,2350069,1535506.4,63.79246609690814,0.25865325904416864,1.5,2.75,NaN,NaN,0.6007272570378611,1.5304846661661586,779.662810474231,-0.027659194949194665,0.7286745742928034,0.756333769241998,17.667839177924154,0.4617253948967311,32.18328957006955,34.505965806145475,33.31074462378496,4959230176
1510324200,41.11,41.32,40.92,41.26,34.64944444444445,40.08371428571428,37.83,21.64,32.9575,21.64,25.1025,19.0675,22.245,14.68,34.63796312499999,37.21900000000002,39.102199999999996,40.85500000000004,39.35836797517112,40.78906118719369,41.09923076923081,42.10870775608204,40.089753782379574,34.63796312499999,37.21900000000002,39.102199999999996,40.85500000000004,41.166666666666664,1739185,1536256.1,62.374651673319754,0.2814094008306041,1.5,2.75,NaN,NaN,0.5878181672494426,1.132093145146828,777.9283950910799,-0.058306126504567346,0.6834511111112889,0.7417572376158562,11.944837133060402,1.3012521482936439,9.556210205762628,65.44576704585292,24.998022748384443,4957490991
1510583400,40.88,41.5,40.869,41.37,34.66305555555556,40.12914285714285,37.83,21.64,32.9575,21.64,25.1025,19.0675,22.245,14.68,34.70318812499999,37.28650000000002,39.20179999999999,40.91950000000004,39.437255505556564,40.84438869317524,41.19923076923081,42.02121566665754,40.37724587180408,34.70318812499999,37.28650000000002,39.20179999999999,40.91950000000004,41.24633333333333,1050891,1522304.1,63.57347483423872,0.5377004316203513,1.5,2.75,NaN,NaN,0.5909025838744825,0.6903292187152357,776.3142375438882,-0.07420104210248624,0.6490059349877484,0.7232069770902346,9.911557346570197,1.223391240518718,8.488882469086384,67.6145585381162,23.896558992797416,4958541882
1510669800,40.93,41.15,40.5,41.1,34.67666666666667,40.17457142857142,37.83,21.64,32.9575,21.64,25.1025,19.0675,22.245,14.68,34.767250624999996,37.34970000000001,39.31179999999999,40.96650000000004,39.502461172005326,40.86873262715855,41.26846153846157,41.86200869316124,40.6749143837619,34.767250624999996,37.34970000000001,39.31179999999999,40.96650000000004,40.916666666666664,1422435,1543432,58.635058287009095,0.5688095135812355,1.5,2.75,NaN,NaN,0.6108381135977334,0.921605227829927,774.0661798398112,-0.10409803521799776,0.5930844330677374,0.6971824682857352,10.831135374540937,0.0730460189919677,8.319626543847845,67.96246087675759,23.717912579394575,4957119447
1510756200,40.55,40.82,40.08,40.46,40.08,40.21999999999999,41.81,21.64,32.9575,21.64,25.1025,19.0675,22.245,14.68,34.82792562499999,37.40640000000002,39.402599999999985,40.976500000000044,39.54001171427963,40.82980571028631,41.21538461538466,41.94874843042267,40.482020800346646,34.82792562499999,37.40640000000002,39.402599999999985,40.976500000000044,40.45333333333334,1777720,1587584.95,48.93205613590371,1.4791861193270057,1.5,2.75,NaN,NaN,0.640063962626467,1.1197637014636603,771.4878082606939,-0.16457928460806948,0.49145836252564834,0.6560376471337178,13.838175154052683,-1.5571776155717776,1.6773780149248618,86.32038603479072,12.002235950284424,4955341727
1510842600,40.97,41.68,40.95,41.46,40.18196721311475,40.265428571428565,41.81,21.64,32.9575,21.64,25.1025,19.0675,22.245,14.68,34.893500624999994,37.48090000000001,39.51319999999999,41.033500000000046,39.615305372543176,40.88982421406857,41.271538461538505,41.95792683125556,40.58515009182145,34.893500624999994,37.48090000000001,39.51319999999999,41.033500000000046,41.36333333333334,2046270,1603411.05,60.05492299139499,0.9987336292001013,1.5,2.75,NaN,NaN,0.681487965296005,1.2761980154745722,775.2636714543415,-0.13602354814041973,0.4860082119581932,0.6220317600986129,20.353777331020865,0,18.75340274162608,50.539134143157824,30.707463115216086,4957387997
1510929000,41.28,41.39,41.07,41.13,40.28393442622951,40.31085714285713,41.81,21.64,32.9575,21.64,25.1025,19.0675,22.245,14.68,34.954500624999994,37.543700000000015,39.62059999999999,41.04600000000004,39.67470516185521,40.91269809844299,41.2915384615385,41.944288674282,40.638788248795,34.954500624999994,37.543700000000015,39.62059999999999,41.04600000000004,41.196666666666665,1323696,1572996.1,55.74036050836212,0.23725696781736594,1.5,2.75,NaN,NaN,0.6606673963462903,0.8415125759053057,777.9774155063224,-0.13772556045851003,0.4498748095254754,0.5876003699839855,20.25513314226425,-1.2010569300984866,21.051712241483784,47.43012754575131,31.518160212764915,4956064301
1511188200,41.22,41.41,41.1,41.28,40.38590163934426,40.356285714285704,41.81,21.64,32.9575,21.64,25.1025,19.0675,22.245,14.68,35.01692562499999,37.616900000000015,39.70859999999999,41.08700000000004,39.73765790060598,40.94767923192461,41.30769230769234,41.947988097327766,40.66739651805692,35.01692562499999,37.616900000000015,39.70859999999999,41.08700000000004,41.26333333333333,910216,1531453.5,57.24401169221251,0.44042660905581715,1.5,2.75,NaN,NaN,0.6356197251786978,0.5943477879021466,780.0304318318925,-0.12735693818355898,0.4284041972545367,0.5557611354380957,20.216946579404503,-0.7692307692307699,22.51945871716684,45.60417139247782,31.87636989035533,4956974517
1511274600,41.74,42.21,41.69,42.1,40.487868852459016,40.40171428571428,41.81,21.64,32.9575,21.64,25.1025,19.0675,22.245,14.68,35.08345062499999,37.69660000000002,39.805199999999985,41.159500000000044,39.830298767248884,41.05742406697941,41.38461538461542,42.1370725036437,40.632158265587144,35.08345062499999,37.69660000000002,39.805199999999985,41.159500000000044,42,1278145,1526837.35,64.37023548847834,1.9455611670722965,1.5,2.75,NaN,NaN,0.6566468876659337,0.8371192910626661,783.2308565609874,-0.06691810932411424,0.47211349878295295,0.5390316081070672,23.391092139302955,0.6936139679502491,46.96933197447238,21.4547276209448,31.575940404582823,4958252662
1511361000,42.14,42.1867,41.91,42.01,40.58983606557377,40.44714285714285,41.81,21.64,32.9575,21.64,25.1025,19.0675,22.245,14.68,35.149050624999994,37.77390000000002,39.89859999999999,41.25650000000004,39.915777246964616,41.14814558440994,41.42692307692311,42.25010207850117,40.60374407534505,35.149050624999994,37.77390000000002,39.89859999999999,41.25650000000004,42.035566666666654,847641,1413952.15,63.12661364772909,1.5675111549418637,1.5,2.75,NaN,NaN,0.6295078242612245,0.5994835115176989,785.163547461687,-0.03618610244462894,0.493798980051281,0.5299850824959099,23.322504020662663,1.6207063376874566,58.44440269199686,13.556854568068607,27.99874273993454,4957405021
1511533800,42.27,42.3299,42.18,42.25,40.691803278688525,40.492571428571424,41.81,21.64,32.9575,21.64,25.1025,19.0675,22.245,14.68,35.213300624999995,37.851300000000016,39.99759999999999,41.35900000000004,40.00731539414247,41.25308410018042,41.47461538461542,42.40428415555948,40.54494661367136,35.213300624999995,37.851300000000016,39.99759999999999,41.35900000000004,42.2533,607366,1346672.25,65.06490300734978,1.7738191201033426,1.5,2.75,NaN,NaN,0.6073929796711374,0.4510124865200126,787.6188075063243,-0.0045424741412640746,0.5243069898193298,0.5288494639605938,22.196008461963753,2.399418322830834,44.50194880265262,23.399720408154685,32.09833078919269,4958012387
1511793000,42.27,42.4557,42.09,42.21,40.79377049180328,40.53799999999999,41.81,21.64,32.9575,21.64,25.1025,19.0675,22.245,14.68,35.275650625,37.937300000000015,40.09339999999999,41.41200000000004,40.093695182607476,41.34421894778229,41.5215384615385,42.53002082945106,40.513056093625934,35.275650625,37.937300000000015,40.09339999999999,41.41200000000004,42.251900000000006,1201032,1317590.55,64.45675753806759,1.5538889457898044,1.5,2.75,NaN,NaN,0.5901291954089131,0.9115365923047946,785.1938658822141,0.008155136873736368,0.5390433850527643,0.5308882481790279,22.13620575584002,2.0304568527918865,45.13369189367039,22.829663380487357,32.03664472584226,4956811355
1511879400,42.46,43.5,42.4175,43.47,40.895737704918034,40.58342857142856,41.81,21.64,32.9575,21.64,25.1025,19.0675,22.245,14.68,35.341938125,38.030000000000015,40.20999999999999,41.54900000000004,40.226099293093455,41.54667428608874,41.64923076923081,43.09642352208211,40.20203801637951,35.341938125,38.030000000000015,40.20999999999999,41.54900000000004,43.12916666666666,1407337,1327466.1,73.01341065836613,3.1774378661233458,1.5,2.75,NaN,NaN,0.6401199671654192,1.060167939505197,788.2066591172243,0.0912564973029395,0.6449588698077022,0.5537023725047627,27.067301747136025,5.766423357664227,51.520013406145715,18.047275280204328,30.432711313649957,4958218692
1511965800,43.58,43.86,43.15,43.39,40.99770491803279,40.628857142857136,41.81,21.64,32.9575,21.64,25.1025,19.0675,22.245,14.68,35.405863125,38.12090000000001,40.32279999999999,41.67500000000004,40.350173830619205,41.72222911598505,41.80692307692311,43.50923615696603,40.10460999688019,35.405863125,38.12090000000001,40.32279999999999,41.67500000000004,43.46666666666666,2649436,1408507.6,71.83101450621484,3.176979820069074,1.5,2.75,NaN,NaN,0.645111398082175,1.8810235741716976,788.6374340123949,0.12840559175318433,0.7142093621962431,0.5858037704430588,26.465264509961223,7.241720217498764,12.152914952016047,60.73277115332825,27.114313894655695,4955569256
1512052200,43.92,45.04,43.88,44.48,41.09967213114754,40.6742857142857,41.81,21.64,32.9575,21.64,25.1025,19.0675,22.245,14.68,35.472988125,38.22320000000001,40.45579999999999,41.84550000000004,40.5121277980459,41.984873962081714,42.054615384615424,44.23612672219227,39.87310404703858,35.472988125,38.22320000000001,40.45579999999999,41.84550000000004,44.46666666666667,3116017,1497635.25,77.23937618504837,4.588629171653145,1.5,2.75,NaN,NaN,0.7168891553620195,2.0806247716191244,790.9916151173014,0.209179283563377,0.84727787489728,0.638098591333903,24.798829609069145,7.284129281234915,45.255470928535296,22.7328121811776,32.01171689028709,4958685273
1512138600,44.43,44.67,42.41,44.25,41.20163934426229,40.719714285714275,41.81,21.64,32.9575,21.64,25.1025,19.0675,22.245,14.68,35.539250624999994,38.31560000000001,40.59059999999999,42.003000000000036,40.658711021651946,42.200600251407266,42.27615384615388,44.705443561422534,39.84686413088523,35.539250624999994,38.31560000000001,40.59059999999999,42.003000000000036,43.776666666666664,4092740,1632226.65,74.0103397880595,3.1262708338115517,1.5,2.75,NaN,NaN,0.8271113585504469,2.5074581400812197,791.8891425851572,0.2283456593138261,0.9235306654761857,0.6951850061623596,24.081423951603178,7.585703865791388,18.269254273747755,51.20515408711319,30.52559163913904,4954592533
1512397800,45.19,45.43,44.08,44.09,41.303606557377044,40.76514285714285,41.81,21.64,32.9575,21.64,25.1025,19.0675,22.245,14.68,35.60416312499999,38.40470000000001,40.72219999999999,42.13450000000004,40.79327137374403,42.38054308460657,42.506153846153886,45.011453318030846,40.000854374276926,35.60416312499999,38.40470000000001,40.72219999999999,42.13450000000004,44.53333333333333,2755040,1696747.4,71.76278494901558,3.7274505885574274,1.5,2.75,NaN,NaN,0.8644605472254151,1.6237184155991635,792.7844932944114,0.21183982032238924,0.9599847815653462,0.7481449612429569,23.236336603176863,6.807170542635665,14.681488659249814,56.64775692380829,28.670754416941907,4951837493
1512484200,44.19,44.587,43.5238,43.6,41.4055737704918,40.81057142857142,41.81,21.64,32.9575,21.64,25.1025,19.0675,22.245,14.68,35.663913125,38.48450000000001,40.84819999999999,42.23300000000004,40.903339163008965,42.49668183845357,42.74769230769235,45.01111590713911,40.48426870824559,35.663913125,38.48450000000001,40.84819999999999,42.23300000000004,43.903600000000004,2137351,1749607.55,65.22962130095156,2.0923321713531604,1.5,2.75,NaN,NaN,0.8786562224235999,1.2216173849958523,789.9085876399552,0.15229793670977776,0.9385173821301791,0.7862194454204013,25.45252415734284,3.5629453681710213,6.083825898881655,72.96921686291329,20.946957238205066,4949700142
1512570600,43.4,43.86,43.36,43.59,41.50754098360655,40.85599999999999,41.81,21.64,32.9575,21.64,25.1025,19.0675,22.245,14.68,35.723850625,38.564200000000014,40.97299999999999,42.33250000000004,41.00869841151842,42.600807377648465,42.9115384615385,45.08497029096397,40.73810663211302,35.723850625,38.564200000000014,40.97299999999999,42.33250000000004,43.60333333333333,1445564,1755050.35,65.09936773360107,1.3956403256020202,1.5,2.75,NaN,NaN,0.8516093493933428,0.8236595605362547,788.015979066289,0.09918853883063339,0.910205118958693,0.8110165801280597,23.908350780752617,3.761009283503941,7.261624084336659,70.27923638422456,22.45913953143879,4948254578
1512657000,43.54,44.2,43.48,44.01,41.60950819672131,40.90142857142856,44.48,21.64,32.9575,21.64,25.1025,19.0675,22.245,14.68,35.785613125,38.647500000000015,41.0984,42.44250000000004,41.1263965130275,42.7350161988248,43.133076923076956,45.113525739581156,41.152628106572756,35.785613125,38.647500000000015,41.0984,42.44250000000004,43.89666666666667,1269668,1771390.95,67.99043694655,1.7489039691176662,1.5,2.75,NaN,NaN,0.842208681579533,0.7167632870654556,790.347724557769,0.08011050548503396,0.9111547119843522,0.8310442064993182,23.847403282635064,4.165680473372777,1.4659376398370367,87.28806697732401,11.245995382838943,4949524246
1512743400,44.5,44.75,44.34,44.73,41.71147540983606,40.946857142857134,44.48,21.64,32.9575,21.64,25.1025,19.0675,22.245,14.68,35.850325624999996,38.73220000000001,41.2354,42.61200000000004,41.26771429683034,42.92501465607958,43.398461538461575,45.2338210069849,41.56310206993825,35.850325624999996,38.73220000000001,41.2354,42.61200000000004,44.60666666666666,1424938,1725134.4,72.23633768599989,2.636659224775417,1.5,2.75,NaN,NaN,0.8349080614667094,0.8259866593582507,792.6273847064974,0.10232548526351137,0.9589510630787075,0.8566255778151961,24.762234456680268,5.970149253731334,12.611849016104609,60.03258942172931,27.355561562166088,4950949184
1513002600,44.76,45.17,44.73,45.14,41.81344262295082,40.99228571428571,44.48,21.64,32.9575,21.64,25.1025,19.0675,22.245,14.68,35.916500625,38.820700000000016,41.373599999999996,42.80600000000004,41.41956863813111,43.13596564121486,43.63230769230773,45.52023131928573,41.744384065329726,35.916500625,38.820700000000016,41.373599999999996,42.80600000000004,45.01333333333334,1095247,1692937.5,74.32485926857963,3.017366027499996,1.5,2.75,NaN,NaN,0.8067003427905162,0.6469506405286669,794.2844609387041,0.12924088347834706,1.01817668216313,0.8889357986847829,24.44563053004148,3.8417299286864544,36.55239549877115,30.222989542076682,33.22461495915216,4952044431
1513089000,45.3,45.6499,45.15,45.39,41.91540983606557,45.6499,44.48,21.64,32.9575,21.64,25.1025,19.0675,22.245,14.68,35.985225625,38.91240000000002,41.50619999999999,43.00700000000004,41.57527182879264,43.35063558014678,43.89230769230773,45.74559008344562,42.03902530116984,35.985225625,38.91240000000002,41.50619999999999,43.00700000000004,45.396633333333334,1530131,1716899.5,75.53344078303277,3.498903573993003,1.5,2.75,NaN,NaN,0.7855003183054795,0.8912175698111625,792.8236637004029,0.14718607092983782,1.0729183873470802,0.9257323164172424,19.726756284939437,4.609356994699239,75.32931841908844,5.092368724354861,19.578312856556696,4953574562
1513175400,43.92,44.15,43.695,43.74,42.017377049180325,45.74773977272727,44.48,21.64,32.9575,21.64,25.1025,19.0675,22.245,14.68,36.039138124999994,38.98810000000001,41.600599999999986,43.13900000000004,41.6601631296243,43.38771790584708,44.006923076923115,45.606718921886504,42.40712723195973,36.039138124999994,38.98810000000001,41.600599999999986,43.13900000000004,43.86166666666667,6500926,1970824.05,56.597431559291884,0.161619998735757,1.5,2.75,NaN,NaN,0.8504645812836596,3.298582641103857,794.8014818684563,0.036979159595600386,0.9719562659117429,0.9349771063161425,30.890079605203713,-1.66366906474819,28.17321719675214,38.78393441713218,33.04284838611568,4947073636
1513261800,43.93,43.96,43.16,43.21,42.11934426229508,45.84557954545455,44.48,21.64,32.9575,21.64,25.1025,19.0675,22.245,14.68,36.09332562499999,39.05580000000001,41.68219999999999,43.27650000000004,41.72094104610962,43.37079239100451,44.08384615384619,45.40201594474307,42.76567636294931,36.09332562499999,39.05580000000001,41.68219999999999,43.27650000000004,43.443333333333335,1298239,1946850,52.08090738803813,0.9890870868360506,1.5,2.75,NaN,NaN,0.8468599683348271,0.6668407941032951,792.3242349819405,-0.07638227564742905,0.8394992617568562,0.9158815374042852,27.48616691424902,-2.350282485875704,16.130263604031335,54.28894667568423,29.580789720284454,4945775397
1513348200,43.76,44.52,43.72,44.27,42.221311475409834,45.94341931818182,44.48,21.64,32.9575,21.64,25.1025,19.0675,22.245,14.68,36.152563125,39.13410000000001,41.77119999999998,43.41700000000004,41.820904142340616,43.45643121090884,44.14538461538465,45.4170549980429,42.8737142327264,36.152563125,39.13410000000001,41.77119999999998,43.41700000000004,44.17000000000001,2130231,1951048.05,59.10917331707295,1.1391285158764728,1.5,2.75,NaN,NaN,0.8799413991680539,1.0918393321989173,796.1397479926487,-0.08413413548003912,0.8107138680542363,0.8948480035342754,31.475111982145258,0.408255840326604,19.838690403529046,48.99607123944806,31.1652383570229,4947905628
1513607400,45.05,45.295,44.99,45.14,42.32327868852459,46.041259090909094,44.48,21.64,32.9575,21.64,25.1025,19.0675,22.245,14.68,36.217663125,39.22210000000001,41.880199999999974,43.617500000000035,41.95106476420961,43.61677109558419,44.28000000000004,45.57362936078191,42.986370639218165,36.217663125,39.22210000000001,41.880199999999974,43.617500000000035,45.141666666666666,1631037,1966415.1,63.80188264436991,2.4294231035244325,1.5,2.75,NaN,NaN,0.8903027277989072,0.8294469463746489,799.7743767654107,-0.037219191553126585,0.8483240140928672,0.8855432056459938,33.225386465712674,3.5321100917431174,22.51328751810167,45.48888803503545,31.99782444686288,4949536665
1513693800,45.17,45.17,44.46,44.52,42.42524590163934,46.13909886363636,45.39,21.64,32.9575,21.64,25.1025,19.0675,22.245,14.68,36.281025625000005,39.305400000000006,41.980199999999975,43.779500000000034,42.0518073224759,43.702792896004745,44.283076923076955,45.57878307721447,42.98737076893944,36.281025625000005,39.305400000000006,41.980199999999975,43.779500000000034,44.71666666666667,3154956,2078652.1,58.63736976088085,1.356217494625939,1.5,2.75,NaN,NaN,0.8774239615275568,1.5177893405058018,797.2439418669804,-0.05350300200773783,0.8186644531363214,0.8721674551440592,33.6519976925023,2.1335168616655187,8.407493901098468,67.73205085692999,23.860455241971554,4946381709
1513780200,45,45.05,44.24,44.42,42.5272131147541,46.23693863636364,45.39,21.64,32.9575,21.64,25.1025,19.0675,22.245,14.68,36.344813125,39.38830000000001,42.07259999999997,43.895500000000034,42.14467762355528,43.771098334480484,44.29615384615387,45.59369088487912,42.99861680742862,36.344813125,39.38830000000001,42.07259999999997,43.895500000000034,44.56999999999999,1791965,2104343.1,57.82435272626768,0.9303171581799469,1.5,2.75,NaN,NaN,0.8726079642755881,0.8515555281835933,797.79976835918,-0.07523781374429228,0.7781201879636939,0.8533580017079861,33.722584961248096,0.9316064530788541,18.91718192513204,50.25372864820695,30.829089426661,4944589744
1513866600,44.72,45.059,44.52,44.65,42.62918032786885,46.33477840909091,45.39,21.64,32.9575,21.64,25.1025,19.0675,22.245,14.68,36.409325624999994,39.471300000000014,42.16579999999998,44.02750000000003,42.242925559886444,43.85480325500615,44.339230769230795,45.64369556460354,43.03476597385805,36.409325624999994,39.471300000000014,42.16579999999998,44.02750000000003,44.743,2038443,2163883.2,59.22469718813093,1.3295491507146693,1.5,2.75,NaN,NaN,0.8559216811130457,0.9420300504204663,800.229482081397,-0.07801852147823451,0.755834849860193,0.8338533713384275,33.44792468019379,-0.1788508830762314,39.1906749004975,27.80355511716776,33.00576998233475,4946628187
1513953000,44.65,44.66,44.301,44.6,42.731147540983606,46.432618181818185,45.39,21.64,32.9575,21.64,25.1025,19.0675,22.245,14.68,36.472050624999994,39.55330000000001,42.26179999999997,44.14500000000003,42.3353598516556,43.925774373577,44.41615384615387,45.653384959730616,43.17892273257712,36.472050624999994,39.55330000000001,42.26179999999997,44.14500000000003,44.52033333333333,1343638,2200696.8,58.767882545328874,0.5961605353064255,1.5,2.75,NaN,NaN,0.8204272753192564,0.6105511672484825,800.9312921079945,-0.08646452060801235,0.7257727205784121,0.8122372411864245,32.09990954401254,-1.1962782454585714,18.095702648240465,51.4077672177269,30.496530134032636,4945284549
1514298600,44.41,44.54,44.3,44.44,42.83311475409836,46.530457954545454,45.39,21.64,32.9575,21.64,25.1025,19.0675,22.245,14.68,36.533700624999994,39.63550000000001,42.35199999999998,44.25650000000003,42.417894759433814,43.97474824276014,44.481538461538484,45.623381671948636,43.33969525112833,36.533700624999994,39.63550000000001,42.35199999999998,44.25650000000003,44.42666666666667,805751,2180932.75,57.24621899804084,0.2776895313102278,1.5,2.75,NaN,NaN,0.7832538985107383,0.36945247394721364,802.7323188926348,-0.10484153428652776,0.6811853233282648,0.7860268576147925,31.561442294710293,-2.092972020268788,6.188847970188799,72.61695989270454,21.194192137106647,4944478798
1514385000,44.53,44.71,44.36,44.52,42.935081967213115,46.62829772727273,45.39,21.64,32.9575,21.64,25.1025,19.0675,22.245,14.68,36.597613124999995,39.71680000000001,42.44079999999998,44.309000000000026,42.50033025906386,44.02667698154489,44.520769230769254,45.62968308712979,43.41185537440872,36.597613124999995,39.71680000000001,42.44079999999998,44.309000000000026,44.53,1119496,2166540.7,57.83410698267877,0.43974822432472704,1.5,2.75,NaN,NaN,0.7523071914742571,0.516720502873544,804.2810444088699,-0.11292456768472858,0.6448711480088818,0.7577957156936104,31.32755635022512,1.7832647462277118,26.746336128264385,40.39290323009005,32.860760641645555,4945598294
1514471400,44.74,44.79,44.55,44.74,43.03704918032787,46.7261375,45.39,21.64,32.9575,21.64,25.1025,19.0675,22.245,14.68,36.65865062499999,39.79870000000001,42.53239999999998,44.37650000000003,42.588160444982925,44.09461250711204,44.52153846153848,45.63104552197558,43.41203140110139,36.65865062499999,39.79870000000001,42.53239999999998,44.37650000000003,44.693333333333335,2214127,2144775.25,59.4840299731173,0.6730917651668545,1.5,2.75,NaN,NaN,0.7178566777975242,1.0323352062179942,806.9384897053673,-0.1049399568369378,0.6266207696474382,0.731560726484376,22.019127501753562,3.5408470261513565,64.55585964718408,10.018752496474923,25.425387856341022,4947812421
1514557800,45.04,45.04,44.12,44.33,43.139016393442624,46.82397727272728,45.39,21.64,32.9575,21.64,25.1025,19.0675,22.245,14.68,36.718300625,39.87870000000001,42.613799999999976,44.36900000000003,42.656467878513006,44.11703036357756,44.4592307692308,45.51235685674977,43.40610468171183,36.718300625,39.87870000000001,42.613799999999976,44.36900000000003,44.49666666666667,2493348,2113641.8,55.15275790217534,0.276402682996672,1.5,2.75,NaN,NaN,0.7322954865262725,1.1796454820301152,804.8485980673096,-0.12726897316866914,0.5724745100235396,0.6997434831922087,21.36072079325431,0.13553196295458586,23.598096721672157,44.13686645270176,32.26503682562609,4945319073
1514903400,44.73,45.19,44.5,45.19,43.24098360655738,46.921817045454546,45.39,21.64,32.9575,21.64,25.1025,19.0675,22.245,14.68,36.783188124999995,39.967800000000004,42.71119999999997,44.41600000000003,42.75582207935563,44.21921794799875,44.44384615384618,45.446781490715324,43.44091081697704,36.783188124999995,39.967800000000004,42.71119999999997,44.41600000000003,44.96,1826281,2000318.85,61.487338817842264,1.1157255152941972,1.5,2.75,NaN,NaN,0.7414172374886816,0.9129949457807689,807.879549513088,-0.08608895502875458,0.5921322894062655,0.6782212444350201,19.62420957940922,0.11076650420912086,48.32743310926196,20.34646445921459,31.326102431523452,4947145354
1514989800,45.27,46.0899,45.25,45.99,43.342950819672126,47.01965681818182,45.39,21.64,32.9575,21.64,25.1025,19.0675,22.245,14.68,36.8527625,40.0799,42.813399999999966,44.51100000000003,42.88265258604757,44.38786385771316,44.6169230769231,45.82902575384791,43.40482039999829,36.8527625,40.0799,42.813399999999966,44.51100000000003,45.776633333333336,2150754,1970104.55,66.26137537645198,2.6536820758008406,1.5,2.75,NaN,NaN,0.7527374348109188,1.0916953620557852,810.4369368292874,-0.010894274740671284,0.664603401009181,0.6754976757498523,19.026353581266118,3.3018867924528275,68.45184584754847,8.069330013608036,23.47882413884349,4949296108
1515076200,46.38,46.8695,46.32,46.57,43.44491803278688,47.11749659090909,45.39,21.64,32.9575,21.64,25.1025,19.0675,22.245,14.68,36.931212499999994,40.19670000000001,42.935599999999965,44.65950000000003,43.02725444541825,44.59568634745476,44.87538461538464,46.2045281310394,43.546241099729876,36.931212499999994,40.19670000000001,42.935599999999965,44.65950000000003,46.5865,2632004,1994837.2,69.23859622615242,3.625472529424679,1.5,2.75,NaN,NaN,0.761791903752996,1.319407919603665,812.8583326859654,0.06766325163029041,0.7600767402877153,0.6924134886574249,16.97781700546204,4.840162089149029,73.51401732417601,5.820762439922708,20.665220235901288,4951928112
1515162600,47.03,47.56,46.7398,47.45,43.546885245901635,47.21533636363637,45.39,21.64,32.9575,21.64,25.1025,19.0675,22.245,14.68,37.01321249999999,40.31210000000001,43.07159999999996,44.852500000000035,43.200695447558715,44.86752574293526,45.12000000000003,46.97851884781738,43.26148115218269,37.01321249999999,40.31210000000001,43.07159999999996,44.852500000000035,47.24993333333333,1928921,2019005.05,73.11503176934437,4.125469197613056,1.5,2.75,NaN,NaN,0.7780924820563536,0.9553819590495823,815.0784979632066,0.16320151034228514,0.8964153765852814,0.7332138662429962,18.148056161952294,6.270996640537525,73.06295366388888,6.00748752217021,20.929558813940897,4953857033
1515421800,47.42,47.82,47.251,47.74,43.64885245901639,47.31317613636364,45.39,21.64,32.9575,21.64,25.1025,19.0675,22.245,14.68,37.09711249999999,40.430400000000006,43.22499999999995,45.03900000000003,43.3787073907917,45.141094719798566,45.320000000000036,47.64510049410611,42.99489950589396,37.09711249999999,40.430400000000006,43.22499999999995,45.03900000000003,47.60366666666667,1992540,2055148.65,74.26592487957481,4.290496081398404,1.5,2.75,NaN,NaN,0.7631573047666143,0.9695357073075955,817.1774644654067,0.226350298816256,1.0161517397633162,0.7898014409470602,18.129065171370044,7.04035874439462,100.00000000000001,0,0,4955849573
1515508200,48,48.42,47.83,48.07,43.75081967213114,47.411015909090914,45.39,21.64,32.9575,21.64,25.1025,19.0675,22.245,14.68,37.18289999999999,40.550200000000004,43.38239999999996,45.20600000000003,43.562679649976346,45.42003807981775,45.593076923076964,48.28339442925048,42.90275941690345,37.18289999999999,40.550200000000004,43.38239999999996,45.20600000000003,48.10666666666666,1604803,2064141.9,75.54863689513981,4.563792306906155,1.5,2.75,NaN,NaN,0.7572174972832847,0.7774673824507898,815.0991026997688,0.2679244394288608,1.1247069902331361,0.8567825508042753,17.437344996518057,8.168316831683175,100.00000000000001,0,0,4957454376
1515594600,47.61,47.98,47.21,47.79,43.8527868852459,47.50885568181818,45.39,21.64,32.9575,21.64,25.1025,19.0675,22.245,14.68,37.267949999999985,40.6841,43.51519999999996,45.33850000000003,43.72845691860473,45.64574873888272,45.85230769230773,48.68614883487409,43.018466549741376,37.267949999999985,40.6841,43.51519999999996,45.33850000000003,47.66,2428273,2130793.2,72.25759887745934,3.080609337402031,1.5,2.75,NaN,NaN,0.7645591046201928,1.1396098879985161,812.7867213648639,0.2542571946616424,1.1746040441313284,0.9203468494696859,17.99760983154126,7.34501347708894,72.46466554764719,6.257080017169953,21.278254435182877,4955026103
1515681000,48.17,48.87,48.06,48.87,43.95475409836065,47.60669545454546,45.39,21.64,32.9575,21.64,25.1025,19.0675,22.245,14.68,37.355137499999984,40.83050000000001,43.677999999999955,45.51250000000003,43.930086059051604,45.952820287560556,46.17692307692312,49.33387764266801,43.01996851117823,37.355137499999984,40.83050000000001,43.677999999999955,45.51250000000003,48.6,1926405,2150606.9,76.50838744045102,4.1368869731755495,1.5,2.75,NaN,NaN,0.7870905971473218,0.8957494742530585,817.1679771550284,0.292894698511033,1.2864652226084772,0.9935705240974442,19.508558926189348,9.23111309789896,70.54347201056014,7.0971962429218705,22.359331746518,4956952508
1515767400,49.04,49.9184,48.95,49.82,44.05672131147541,47.70453522727273,45.39,21.64,32.9575,21.64,25.1025,19.0675,22.245,14.68,37.446424999999984,40.985400000000006,43.856999999999964,45.81650000000003,44.161063076343694,46.321123117316695,46.57846153846158,50.1337379739226,43.023185103000564,37.446424999999984,40.985400000000006,43.856999999999964,45.81650000000003,49.5628,2582104,1954665.8,79.48595302078249,5.297984371572833,1.5,2.75,NaN,NaN,0.8057555544939418,1.3209951286813326,818.6945010589873,0.3533265011239952,1.435228650502438,1.0819021493784429,20.05103916446743,12.384389803744648,73.0047622411961,6.029621754469079,20.96561600433482,4959534612
1516113000,50.59,50.99,48.85,49.29,44.15868852459016,47.802375000000005,45.39,21.64,32.9575,21.64,25.1025,19.0675,22.245,14.68,37.53381249999998,41.124900000000004,44.02139999999996,46.120500000000035,44.36219785766355,46.60387329661987,46.951538461538505,50.548544448606904,43.354532474470105,37.53381249999998,41.124900000000004,44.02139999999996,46.120500000000035,49.71,5166539,2148080.8,73.86121979427494,4.668123896018754,1.5,2.75,NaN,NaN,0.9010587291729459,2.40518838956151,815.6415099491114,0.32899516800764017,1.4931461093879932,1.164150941380353,20.60265512010736,9.072803717636647,28.959536089161826,38.10364312186309,32.93682078897508,4954368073
1516199400,49.84,50.91,49.4,50.66,44.260655737704916,47.900214772727274,45.39,21.64,32.9575,21.64,25.1025,19.0675,22.245,14.68,37.62917499999999,41.281600000000005,44.21259999999996,46.44000000000003,44.60917049069636,46.99017107789417,47.4238461538462,51.2262869769252,43.621405330767196,37.62917499999999,41.281600000000005,44.21259999999996,46.44000000000003,50.32333333333333,2519328,2167535.65,78.16288151663365,5.519221313035935,1.5,2.75,NaN,NaN,0.9524116770891639,1.1623006062207097,818.3865213733678,0.37331514695534596,1.6307948750745354,1.2574797281191894,22.31817887019649,10.154381387258086,34.04366615369829,32.81565875213768,33.140675094164024,4956887401
1516285800,50.6,50.88,50.13,50.46,44.36262295081967,47.99805454545455,45.39,21.64,32.9575,21.64,25.1025,19.0675,22.245,14.68,37.72416249999999,41.43890000000001,44.39259999999996,46.70600000000003,44.838614785178855,47.32063097523758,47.8638461538462,51.64593787027499,44.0817544374174,37.72416249999999,41.43890000000001,44.39259999999996,46.70600000000003,50.49,2063861,2189176.85,76.19158454121639,4.602602596823299,1.5,2.75,NaN,NaN,0.9379537001542236,0.9427566347597728,814.7080366309773,0.35729651884861124,1.7041003766799534,1.3468038578313422,23.53511256939342,8.353016963710544,35.14659896423889,31.737797652847444,33.11560338291367,4954823540
1516372200,50.78,51.09,50.42,51.09,44.464590163934425,48.09589431818182,45.39,21.64,32.9575,21.64,25.1025,19.0675,22.245,14.68,37.82204999999999,41.600400000000015,44.58179999999996,47.03450000000004,45.08376714654439,47.67961850140543,48.3838461538462,51.9310447318059,44.8366475758865,37.82204999999999,41.600400000000015,44.58179999999996,47.03450000000004,50.866666666666674,2115715,2137214.8,78.0679839452927,4.402871972285831,1.5,2.75,NaN,NaN,0.9188141501432078,0.9899402717967329,817.7002383334094,0.35645285367665824,1.792369924927165,1.4359170712505067,23.528919945846727,7.671232876712329,36.478497271440496,30.46673778835535,33.05476494020416,4956939255
1516631400,50.93,52.35,50.93,52.35,44.56655737704918,48.193734090909096,45.39,21.64,32.9575,21.64,25.1025,19.0675,22.245,14.68,37.927899999999994,41.77400000000002,44.796799999999955,47.43100000000004,45.36871745452304,48.124416739366815,48.93461538461543,52.54995548254102,45.31927528668983,37.927899999999994,41.77400000000002,44.796799999999955,47.43100000000004,51.876666666666665,2418751,2168554.1,81.25067892597801,5.331523900563847,1.5,2.75,NaN,NaN,0.954613139418693,1.1153749864944573,820.114170326895,0.4045574876553424,1.9416139308196847,1.5370564431643423,24.556641506131935,9.656472559698365,34.730057313515665,31.988126307520712,33.28181637896361,4959358006
1516717800,52.4,52.88,52.2,52.7,44.66852459016393,48.291573863636366,45.39,21.64,32.9575,21.64,25.1025,19.0675,22.245,14.68,38.03417499999999,41.950400000000016,45.01459999999995,47.83350000000004,45.656218730816256,48.56018657371283,49.450769230769275,53.15206598098211,45.74947248055644,38.03417499999999,41.950400000000016,45.01459999999995,47.83350000000004,52.59333333333334,2437687,2188516.3,82.03074040053446,5.715867709708386,1.5,2.75,NaN,NaN,0.9349979151745006,1.1138537099312444,822.5397286818585,0.4218241004311978,2.0643365687033395,1.6425124682721417,24.527137537175904,9.63178697732474,80.1516465312247,3.389673205097895,16.45868026367739,4961795693
1516804200,53.1,53.48,51.89,52.62,44.77049180327869,48.38941363636364,45.39,21.64,32.9575,21.64,25.1025,19.0675,22.245,14.68,38.140474999999995,42.12060000000001,45.24019999999995,48.23450000000004,45.92930819235287,48.94683547145447,49.91615384615389,53.57268888915704,46.25961880315074,38.140474999999995,42.12060000000001,45.24019999999995,48.23450000000004,52.663333333333334,3647966,2303732.7,81.1991653051524,4.918269512724868,1.5,2.75,NaN,NaN,0.9817837783763217,1.58350228739645,820.8132382443613,0.39045387668271814,2.1305798141255394,1.7401259374428213,25.36120804230583,10.1067168863779,41.43564106778529,25.871278366089502,32.69308056612521,4958147727
1516890600,53.19,53.237,52.2151,52.69,44.87245901639344,48.48725340909091,45.39,21.64,32.9575,21.64,25.1025,19.0675,22.245,14.68,38.24693749999999,42.28550000000001,45.468799999999945,48.647000000000034,46.19443336128021,49.30332733131595,50.31923076923081,53.95467560743117,46.68378593103046,38.24693749999999,42.28550000000001,45.468799999999945,48.647000000000034,52.71403333333333,3116818,2419286.05,81.37706114681592,4.256953120171765,1.5,2.75,NaN,NaN,0.9846492227780131,1.2883214037463657,819.2320994142771,0.33892623122560916,2.1637837264748327,1.8248574952492236,24.12794546513712,7.816656435440966,67.72039286116456,8.426539629378997,23.85306750945644,4961264545
1516977000,53.19,54.4899,53.041,54.48,44.9744262295082,54.4899,45.39,21.64,32.9575,21.64,25.1025,19.0675,22.245,14.68,38.36282499999999,42.4664,45.73099999999995,49.14500000000004,46.51935754319079,49.79634377595252,50.83769230769235,54.76466533532614,46.91071928005856,38.36282499999999,42.4664,45.73099999999995,49.14500000000004,54.00363333333333,2219794,2474300.95,85.22660062888369,5.579510864181,1.5,2.75,NaN,NaN,1.0428814211510122,0.8971398568149116,820.8650925761325,0.3864593690036393,2.3079317065037728,1.9214723375001335,26.906729139237118,9.353673223604972,68.378802263574,8.108756054592178,23.512441681833803,4963484339
1517236200,54.14,54.3982,53.301,53.41,45.07639344262295,54.78456666666666,45.39,21.64,32.9575,21.64,25.1025,19.0675,22.245,14.68,38.47534999999999,42.6445,45.97719999999995,49.57850000000004,46.78957881600684,50.14050151157609,51.24846153846158,55.046508373785436,47.45041470313772,38.47534999999999,42.6445,45.97719999999995,49.57850000000004,53.703066666666665,3100241,2518606.65,75.21750345435194,4.397411421344082,1.5,2.75,NaN,NaN,1.0526041767830825,1.2309349695396063,815.2503420270151,0.31019078336688666,2.3092108167087417,1.999020033341855,31.41026148870351,8.358693446946639,40.38507067895989,26.85313475499959,32.76179456604052,4960384098
1517322600,52.17,52.6,51.41,51.71,45.178360655737706,55.079233333333335,45.39,21.64,32.9575,21.64,25.1025,19.0675,22.245,14.68,38.58238749999999,42.8024,46.20219999999995,49.94750000000004,46.98253650949677,50.28997755809265,51.55000000000004,54.782136706933656,48.317863293066424,38.58238749999999,42.8024,46.20219999999995,49.94750000000004,51.906666666666666,5671022,2677490.35,62.632114541566104,0.9243691074560004,1.5,2.75,NaN,NaN,1.1202753070128624,2.118036391802495,809.4178023984726,0.1194116854730698,2.148284640183192,2.0288729547101223,37.67790864487748,2.072641136991718,12.858838006844326,59.59992292266564,27.54123907049002,4954713076
1517409000,52.31,52.6,51.14,51.84,45.28032786885245,55.3739,45.39,21.64,32.9575,21.64,25.1025,19.0675,22.245,14.68,38.686249999999994,42.961499999999994,46.40979999999995,50.280000000000044,47.17302527383023,50.43759874303621,51.778461538461585,54.616389776876105,48.940533300047065,38.686249999999994,42.961499999999994,46.40979999999995,50.280000000000044,51.86000000000001,4048124,2788582.5,63.14001891022229,0.7186804433402373,1.5,2.75,NaN,NaN,1.1445413565119438,1.4516780478970948,810.9162292464929,-0.016625266106466086,2.0080913720770397,2.024716638183506,34.81507610255136,2.7348394768133226,37.95850004555745,29.02163839502322,33.01986155941933,4958761200
1517495400,51.29,52.4562,51.16,51.63,45.382295081967214,55.66856666666666,45.39,21.64,32.9575,21.64,25.1025,19.0675,22.245,14.68,38.790437499999996,43.1202,46.61979999999995,50.56200000000005,47.34780859642512,50.551160767508954,51.91769230769235,54.525929600414756,49.30945501496994,38.790437499999996,43.1202,46.61979999999995,50.56200000000005,51.74873333333333,4293008,2895695.2,61.68154293384323,0.46664923059647884,1.5,2.75,NaN,NaN,1.1553741167610911,1.482548301354369,808.8163153067761,-0.13287973246921747,1.8586169725969839,1.9914967050662014,34.821913516719306,1.056958308866704,14.933151762492976,56.236777067263134,28.83007117024388,4954468192
1517581800,50.75,50.861,48.22,48.27,45.48426229508196,55.963233333333335,54.48,21.64,32.9575,21.64,25.1025,19.0675,22.245,14.68,38.87865,43.2341,46.75959999999995,50.64700000000004,47.38397296519276,50.33390736107953,51.83923076923081,54.796895768604585,48.88156576985703,38.87865,43.2341,46.75959999999995,50.64700000000004,49.117,7028211,3115505.55,44.1208077694875,4.539514172372005,1.5,2.75,NaN,NaN,1.316418822706728,2.2558813929893335,801.2601762069952,-0.4313634503569266,1.452292392120043,1.8836558424769696,52.06448808889442,-7.79369627507163,3.763261403785207,79.0749902207841,17.16174837543069,4947439981
1517841000,47.1,48.4,41.82,42.34,45.586229508196716,56.2579,54.48,21.64,32.9575,21.64,25.1025,19.0675,22.245,14.68,38.9336125,43.2848,46.76439999999995,50.39150000000004,47.18617010381265,49.57258285050053,51.199230769230816,57.06832301479846,45.33013852366317,38.9336125,43.2848,46.76439999999995,50.39150000000004,44.18666666666666,13353248,3686721.9,28.62919343368152,13.261653351107308,1.5,2.75,NaN,NaN,1.6923889067991045,3.6219840720831153,793.9935161883836,-0.9914461544727491,0.6443481493860332,1.6357943038587823,85.0828803102792,-19.658444022770396,1.962984276060083,85.12437457805605,12.912641145883867,4934086733
1517927400,40.26,44.95,39.75,44.69,45.68819672131147,56.552566666666664,54.48,21.64,32.9575,21.64,25.1025,19.0675,22.245,14.68,39.00185,43.35829999999999,46.81799999999995,50.23900000000005,47.088281080133726,49.107574959976674,50.75538461538466,57.5764588163033,43.934310414466026,39.00185,43.35829999999999,46.81799999999995,50.23900000000005,43.129999999999995,13332266,4253708.2,37.930227361255156,13.29473010042291,1.5,2.75,NaN,NaN,1.9429325563134543,3.1342690596407152,797.9840112244551,-1.1554636115540304,0.19146478941624423,1.3469284009702747,94.54988865515847,-15.070315469403269,23.744389206076818,43.97655579236294,32.27905500156026,4947418999
1518013800,44.37,46.25,43.91,43.92,45.790163934426225,56.84723333333333,54.48,21.64,32.9575,21.64,25.1025,19.0675,22.245,14.68,39.06125,43.42449999999999,46.85139999999995,50.031500000000044,46.96403476326574,48.61352020188366,50.20384615384619,57.92731503755597,42.480377270136415,39.06125,43.42449999999999,46.85139999999995,50.031500000000044,44.69333333333333,9536606,4650298.35,36.26268040330819,8.292725721422284,1.5,2.75,NaN,NaN,1.9712945165767792,2.050751431894687,798.8863189835015,-1.259114554540904,-0.2269647922058553,1.0321497623350486,94.06924239953366,-16.644524577718723,10.105602493911546,64.40935878891766,25.485038717170784,4937882393
1518100200,44.07,44.17,38.97,39.04,45.89213114754098,57.1419,54.48,21.64,32.9575,21.64,25.1025,19.0675,22.245,14.68,39.0934125,43.440699999999985,46.78799999999995,49.59400000000005,46.6532883019612,47.70175637313284,49.180000000000035,58.79196369915361,39.56803630084646,39.0934125,43.440699999999985,46.78799999999995,49.59400000000005,40.72666666666667,13277091,5192739.25,27.893107342162196,16.08837974034884,1.5,2.75,NaN,NaN,2.2019163368212955,2.5568568650929278,793.4295510949548,-1.578916203808805,-0.9414954924259575,0.6374207113828474,108.73204219903877,-28.34067547723935,7.655544892368727,69.33101526175007,23.013439845881223,4924605302
1518186600,40.46,41.68,36.82,40.83,36.82,57.436566666666664,54.48,21.64,32.9575,21.64,25.1025,19.0675,22.245,14.68,39.13464999999999,43.472599999999986,46.73519999999995,49.19200000000005,46.42492405482546,47.04730338521542,48.26692307692311,58.59628193591672,37.937564217929506,39.13464999999999,43.472599999999986,46.73519999999995,49.19200000000005,39.77666666666667,15481912,5870514.6,33.91793846203552,15.8417076142634,1.5,2.75,NaN,NaN,2.391779455619774,2.6372325179124845,796.1245757506374,-1.5881699102625952,-1.3477916764453965,0.24037823381719858,111.32878649567758,-23.553641640142292,27.70859399773257,39.31966640953511,32.97173959273232,4940087214
1518445800,41.8,43.25,40.881,42.43,36.76379310344828,57.73123333333333,54.48,21.64,32.9575,21.64,25.1025,19.0675,22.245,14.68,39.1835,43.51939999999999,46.71599999999995,48.82250000000004,46.26826036640093,46.6075602056711,47.48307692307696,57.918134357927954,37.04801948822596,39.1835,43.51939999999999,46.71599999999995,48.82250000000004,42.187000000000005,9384548,6210636.8,38.83727525615301,8.037224538988987,1.5,2.75,NaN,NaN,2.3937952087897902,1.5110444069117035,800.2179970044269,-1.4107986835367188,-1.5231201206037,-0.11232143706698117,117.86756660098122,-17.94623863856121,50.199889430016235,19.07068066810817,30.72942990187558,4949471762
1518532200,41.79,43.1,41.52,42.81,36.70758620689655,58.0259,54.48,21.64,32.9575,21.64,25.1025,19.0675,22.245,14.68,39.235350000000004,43.569199999999995,46.68259999999995,48.49850000000005,46.13264231281658,46.245887805131,46.723076923076945,56.96793570009026,36.47821814606363,39.235350000000004,43.569199999999995,46.68259999999995,48.49850000000005,42.47666666666667,6607503,6282685,39.98006618207862,6.359161599323104,1.5,2.75,NaN,NaN,2.3356669795905196,1.051700507028444,802.2754249396747,-1.2003947112991626,-1.6128148261909345,-0.4124201148917719,119.04184362899935,-17.41898148148148,42.724721507033415,24.888895009765474,32.386383483201115,4956079265
1518618600,42.03,44.7,42,44.52,36.65137931034483,58.320566666666664,54.48,21.64,32.9575,21.64,25.1025,19.0675,22.245,14.68,39.2948,43.63929999999999,46.687999999999946,48.19150000000005,46.06940143780417,46.081517537975664,45.9569230769231,55.2083425426147,36.70550361123149,39.2948,43.63929999999999,46.687999999999946,48.19150000000005,43.74,7033212,6508379.2,44.963492301524454,3.059344912084872,1.5,2.75,NaN,NaN,2.3616907667626257,1.08063955462214,806.1363402024934,-0.8927027427868508,-1.5282985433753353,-0.6355958005884845,123.22726769493038,-13.771063335270192,68.74210374942854,7.986778243543939,23.27111800702753,4963112477
1518705000,45.49,46.19,44.1,46.19,36.5951724137931,58.61523333333333,54.48,39.04,32.9575,21.64,25.1025,19.0675,22.245,14.68,39.36225,43.72609999999999,46.72999999999995,47.978000000000044,46.074130793184395,46.0918492010256,45.40153846153849,53.603969043727005,37.19910787934998,39.36225,43.72609999999999,46.72999999999995,47.978000000000044,45.49333333333333,7578610,6784116.65,49.383562168097654,1.2095542824760592,1.5,2.75,NaN,NaN,2.3422842834224378,1.1171108032170998,809.4113196216774,-0.5406803208441987,-1.311446201643733,-0.7707658807995342,126.75651968079896,-4.30909467578207,100,0,0,4970691087
1518791400,45.83,47.38,45.82,46.2,36.53896551724138,58.90989999999999,54.48,39.04,32.9575,21.64,25.1025,19.0675,22.245,14.68,39.430550000000004,43.81509999999999,46.78199999999995,47.73350000000004,46.0790668405105,46.1021492771184,44.97769230769234,52.36093801400358,37.594446601381094,39.430550000000004,43.81509999999999,46.78199999999995,47.73350000000004,46.46666666666667,7867648,7071713.3,49.40976288611148,2.4504501186250196,1.5,2.75,NaN,NaN,2.286406834606549,1.112551890360148,811.6134907145138,-0.28403102868045615,-1.1258046666501045,-0.8417736379696483,121.64191084263012,9.116674539442606,100,0,0,4978558735
1519137000,45.69,46.5,44.91,45.37,36.48275862068966,59.204566666666665,54.48,39.04,32.9575,21.64,25.1025,19.0675,22.245,14.68,39.494150000000005,43.89529999999998,46.81759999999994,47.384500000000045,46.05126029774538,46.032420774535694,44.480000000000025,50.73134077926183,38.22865922073822,39.494150000000005,43.89529999999998,46.81759999999994,47.384500000000045,45.593333333333334,6606186,7281085.05,47.22474973249026,0.4505034194615771,1.5,2.75,NaN,NaN,2.23666348927751,0.9073079018627862,810.8589479148479,-0.15357322000453755,-1.0337401629753202,-0.8801669429707827,92.41878476301954,1.5215931975833514,78.482192564408,3.9415181500049203,17.57628928558708,4971952549
1519223400,45.6,47.02,44.62,44.62,36.42655172413793,59.49923333333333,54.48,39.04,32.9575,21.64,25.1025,19.0675,22.245,14.68,39.55205,43.96409999999998,46.829799999999935,46.98050000000004,45.99513244293183,45.8979045102942,43.940769230769256,48.65163040657899,39.22990805495952,39.55205,43.96409999999998,46.829799999999935,46.98050000000004,45.419999999999995,8045423,7561471.85,45.276339300186955,1.1287593731786683,1.5,2.75,NaN,NaN,2.2483303829005457,1.0640022418386708,809.5613834773776,-0.10359316480712455,-1.0096583989796883,-0.9060652341725638,88.04489709690958,1.5938069216757644,49.44498380543133,19.513673459994415,31.041342734574236,4963907126
1519309800,45.22,46.14,44.47,44.84,36.37034482758621,59.793899999999994,54.48,39.04,32.9575,21.64,25.1025,19.0675,22.245,14.68,39.611000000000004,44.03369999999998,46.83199999999994,46.59150000000004,45.94983313144431,45.797151699789985,43.67692307692311,47.7260854565186,39.62776069732762,39.611000000000004,44.03369999999998,46.83199999999994,46.59150000000004,45.15,7927837,7775465.4,45.98039702830719,0.48587855019564435,1.5,2.75,NaN,NaN,2.207021069836221,1.0195964604253784,811.3263034553754,-0.04453579977797095,-0.9617349838950275,-0.9171991841170566,87.37782146986596,14.856557377049192,50.841175834202026,18.505867157526897,30.652957008271084,4971834963
1519396200,45.57,46.98,45.27,46.98,36.31413793103448,60.088566666666665,54.48,39.04,32.9575,21.64,25.1025,19.0675,22.245,14.68,39.68105,44.12119999999998,46.868799999999936,46.30600000000004,45.99023183217198,45.909803918857605,44.033846153846184,48.35740977276795,39.71028253492442,39.68105,44.12119999999998,46.868799999999936,46.30600000000004,46.41,5206598,7879954.4,52.39619359289728,2.1067772293165774,1.5,2.75,NaN,NaN,2.2022338505622048,0.6607396103713493,816.0142103004647,0.1397465831607837,-0.7425159551660769,-0.8822625383268606,46.144229314035925,15.062454077883906,47.23848701141062,21.163840537239988,31.597672451349407,4977041561
1519655400,47.6,48.689,47.3,48.62,36.25793103448276,60.38323333333333,54.48,39.04,32.9575,21.64,25.1025,19.0675,22.245,14.68,39.7586,44.21979999999998,46.933399999999935,46.01300000000004,46.09335999561622,46.16791783134736,44.33615384615387,49.302722316120224,39.369585376187516,39.7586,44.21979999999998,46.933399999999935,46.01300000000004,48.203,5547913,8046360.35,56.64576812715872,5.181181163260005,1.5,2.75,NaN,NaN,2.167002861236333,0.6894934801173801,819.1540488088256,0.3606298516480062,-0.4314752237668529,-0.7921050754148591,44.312244409111685,14.588734386047603,42.860660946262605,24.641161517679834,32.498177536057575,4982589474
1519741800,48.72,49.169,46.78,46.78,36.20172413793104,60.677899999999994,54.48,39.04,32.9575,21.64,25.1025,19.0675,22.245,14.68,39.82785,44.29739999999997,46.99419999999995,45.68150000000004,46.12028705461166,46.22621137121904,44.556153846153876,49.68036808812631,39.431939604181444,39.82785,44.29739999999997,46.99419999999995,45.68150000000004,47.57633333333333,6994441,8241070.35,51.13077696322145,3.280710418620901,1.5,2.75,NaN,NaN,2.1828597997194517,0.8487296798770806,815.0456280807208,0.3699673617283278,-0.3296458732544494,-0.6996132349827772,52.275941536354125,9.273534220976405,41.429577959778904,25.846972332454758,32.723449707766356,4975595033
1519828200,47.45,47.7171,45.21,45.23,36.14551724137931,60.972566666666665,54.48,39.04,32.9575,21.64,25.1025,19.0675,22.245,14.68,39.89019999999999,44.35839999999997,47.03459999999995,45.35750000000004,46.08537383678375,46.1313340977696,45.032307692307725,49.048269336670636,41.016346047944815,39.89019999999999,44.35839999999997,47.03459999999995,45.35750000000004,46.052366666666664,7746463,8344842.4,46.981233443615935,0.9786846519910016,1.5,2.75,NaN,NaN,2.206019814025205,0.9282935049797945,811.6081396762877,0.26388649310671297,-0.3697551185993859,-0.6336416117060989,57.926586048014,1.5947888589397883,41.87161064337061,25.470983759584414,32.65740559704496,4967848570
1519914600,45.28,46.11,42.521,43.38,36.08931034482759,61.26723333333333,54.48,39.04,32.9575,21.64,25.1025,19.0675,22.245,14.68,39.940999999999995,44.39399999999997,47.01679999999995,44.934500000000035,45.979280745145175,45.869302278934406,45.228461538461566,48.60194954077833,41.854973536144804,39.940999999999995,44.39399999999997,47.01679999999995,44.934500000000035,44.00366666666667,10796400,8682256.2,42.54336445274591,4.812825403268321,1.5,2.75,NaN,NaN,2.3048041130234043,1.2435016603172804,809.2291075591373,0.0712778053219345,-0.5445443550536808,-0.6158221603756153,59.31238249083797,-6.08356787183372,12.185147942301406,60.63351770038924,27.181334357309346,4957052170
1520001000,42.43,44.33,41.94,44.06,36.03310344827586,61.561899999999994,54.48,39.04,32.9575,21.64,25.1025,19.0675,22.245,14.68,39.9955,44.43769999999998,46.99519999999995,44.55600000000003,45.904014833570855,45.69698777617875,45.35384615384619,48.4080189710969,42.29967333659548,39.9955,44.43769999999998,46.99519999999995,44.55600000000003,43.44333333333333,8644002,8899805.9,44.61431377495173,4.321604508027107,1.5,2.75,NaN,NaN,2.310889533521732,0.9712573619161738,811.3452977371613,-0.004171744585112824,-0.6210368411070064,-0.6168650965218936,55.26755344082344,-4.632034632034633,17.025286378075652,52.94998338011509,30.024730241809245,4965696172
1520260200,43.36,45.86,43.29,45.53,35.97689655172414,61.85656666666666,54.48,39.04,54.48,21.64,32.9575,19.0675,25.1025,14.68,40.06595,44.49779999999997,47.01539999999996,44.41900000000003,45.88934758519553,45.68108417844744,45.563076923076956,48.24100246481642,42.885151381337494,40.06595,44.49779999999997,47.01539999999996,44.41900000000003,44.89333333333334,8260327,8961411.7,48.90202997807497,1.3362863350077943,1.5,2.75,NaN,NaN,2.329397423984465,0.9217662659109838,815.4297013583987,0.0481924361262388,-0.556624551364095,-0.6048169874903339,59.33961055415751,0.3526559400484984,19.865400147838315,48.99889452309271,31.135705329068987,4973956499
1520346600,46.1,46.11,45.04,45.89,35.92068965517242,62.15123333333333,54.48,39.04,54.48,21.64,32.9575,19.0675,25.1025,14.68,40.1366,44.55869999999997,47.04479999999995,44.596500000000034,45.889373170089826,45.70098092335721,45.66846153846157,48.2809268775482,43.055996199374945,40.1366,44.55869999999997,47.04479999999995,44.596500000000034,45.68000000000001,5180906,8552794.6,49.92443782598984,0.7674825774529059,1.5,2.75,NaN,NaN,2.239440465128432,0.6057559245021504,817.927634388223,0.10697532299730839,-0.4710978337436984,-0.5780731567410068,58.53991166134709,2.8462572837292766,38.74060157066993,28.2465597635532,33.01283866577687,4979137405
1520433000,44.63,46.05,44.53,45.86,35.86448275862069,62.445899999999995,54.48,39.04,54.48,21.64,32.9575,19.0675,25.1025,14.68,40.2041,44.61739999999997,47.06899999999995,44.65500000000003,45.8882212810667,45.716125597323185,45.64307692307695,48.241151767920385,43.04500207823351,40.2041,44.61739999999997,47.06899999999995,44.65500000000003,45.48,7490097,8260686.15,49.83495122711372,0.24307673557010506,1.5,2.75,NaN,NaN,2.1880518604764005,0.906716084353356,818.9402664679112,0.1415671271854998,-0.40111424775913207,-0.5426813749446319,57.471528871181704,2.2747546833184566,39.033270742712055,27.983871603996825,32.98285765329112,4971647308
1520519400,46.22,46.5694,45.65,46.51,35.80827586206897,62.74056666666666,54.48,39.04,54.48,21.64,32.9575,19.0675,25.1025,14.68,40.2723,44.68449999999997,47.107199999999956,44.78450000000003,45.912604760240555,45.7917326832924,45.6669230769231,48.290571559656016,43.04327459419018,40.2723,44.68449999999997,47.107199999999956,44.78450000000003,46.24313333333333,4788618,8023286.75,51.84880829818836,1.2760404685270246,1.5,2.75,NaN,NaN,2.097433870442372,0.5968399421845417,820.8027987625769,0.20225642114849912,-0.28986084850900795,-0.4921172696575071,57.836543430922525,-1.0004257130693888,72.5797580931842,6.218573230367926,21.201668676447877,4976435926
1520605800,47.31,48.92,47.11,48.89,35.75206896551724,63.03523333333332,54.48,39.04,54.48,21.64,32.9575,19.0675,25.1025,14.68,40.351350000000004,44.77409999999997,47.196199999999955,45.27700000000003,46.02936535787818,46.086805761074075,45.93769230769233,49.06171490040246,42.813669714982204,40.351350000000004,44.77409999999997,47.196199999999955,45.27700000000003,48.30666666666667,5875141,7653189.25,58.429361233813864,4.986418598706853,1.5,2.75,NaN,NaN,2.1197600225536317,0.7676722485335117,824.6644160289677,0.3860652581445959,-0.009535696976762154,-0.39560095512135807,58.7504363565707,0.5553270259152676,70.57166363988235,7.095905501301722,22.33243085881592,4982311067
1520861400,49.1,49.46,48.5,48.72,35.69586206896552,63.329899999999995,54.48,39.04,54.48,21.64,32.9575,19.0675,25.1025,14.68,40.428450000000005,44.86049999999997,47.28019999999995,45.67150000000003,46.134880441882956,46.33758616478131,46.25307692307695,49.60110858008549,42.905045266068406,40.428450000000005,44.86049999999997,47.28019999999995,45.67150000000003,48.89333333333334,4652596,7111723.45,57.82150429186123,4.943117042079802,1.5,2.75,NaN,NaN,2.036920020942658,0.654214977946028,826.2655069269158,0.4737925129755681,0.19663968609810212,-0.277152826877466,55.53475956455411,4.147071398033343,44.52967464074142,23.352807403142545,32.11751795611603,4977658471
1520947800,49.41,49.72,47.4048,47.75,35.639655172413796,49.72,54.48,39.04,54.48,21.64,32.9575,19.0675,25.1025,14.68,40.49835,44.93639999999998,47.34039999999995,45.937500000000036,46.1982184637699,46.47210176813547,46.4769230769231,49.80618157247095,43.14766458137525,40.49835,44.93639999999998,47.34039999999995,45.937500000000036,48.291599999999995,7375271,7011259.6,54.34729729947963,3.404912412089034,1.5,2.75,NaN,NaN,2.0567971623038965,1.051918117537682,823.9022239597325,0.4445648858247728,0.2785532804035,-0.1660116054212728,51.703563698598046,5.571523325226627,17.66477196184989,52.11579203211298,30.219436006037128,4970283200
1521034200,48.32,48.42,46.69,47.02,35.58344827586207,49.56613225806451,54.48,39.04,54.48,21.64,32.9575,19.0675,25.1025,14.68,40.56445,45.00399999999998,47.394199999999955,46.14800000000004,46.23044519068088,46.524282552122564,46.48000000000002,49.81118597499451,43.14881402500553,40.56445,45.00399999999998,47.394199999999955,46.14800000000004,47.376666666666665,4263717,6894070.3,51.82364195359283,1.4043084180901062,1.5,2.75,NaN,NaN,2.0334545078536186,0.6184614914646287,821.9873697442198,0.35786735096721534,0.2813225832877464,-0.07654476767946895,48.019491599353884,8.39096357768557,21.969649040220258,46.27415496090605,31.756195998873697,4966019483
1521120600,47.34,47.699,46.57,46.85,35.52724137931035,49.41226451612903,54.48,39.04,54.48,21.64,32.9575,19.0675,25.1025,14.68,40.6302,45.069299999999984,47.42739999999995,46.26450000000004,46.254741457713,46.55530326144422,46.34384615384617,49.451202571337646,43.2364897363547,40.6302,45.069299999999984,47.42739999999995,46.26450000000004,47.03966666666667,4193746,6752097,51.22707065061844,0.6493372696394263,1.5,2.75,NaN,NaN,1.968850614435503,0.6211027477833924,819.2670756424727,0.2746158590302204,0.26672505610830655,-0.007890802921913853,38.896225194397125,6.3322741715842,6.839142406187928,71.18513581026434,21.97572178354773,4961825737
1521207000,47.11,47.599,46.96,46.96,35.471034482758625,49.25839677419355,54.48,39.04,54.48,39.04,32.9575,21.64,25.1025,19.0675,40.69675000000001,45.130099999999985,47.44679999999996,46.30300000000004,46.28239865544975,46.593845807973345,46.35769230769233,49.47428960253568,43.24109501284899,40.69675000000001,45.130099999999985,47.44679999999996,46.30300000000004,47.173,4315378,6588935.4,51.615195869848165,0.8634360747616221,1.5,2.75,NaN,NaN,1.8817184276901096,0.6549431339090075,822.2247480528246,0.2151315015859327,0.26102357406050203,0.04589207247456933,38.65817270871628,3.140786294750713,3.7785455526802467,79.01237801780509,17.209076429514674,4966141115
1521466200,46.5,46.53,44.1,45.05,35.4148275862069,49.104529032258064,54.48,39.04,54.48,39.04,32.9575,21.64,25.1025,19.0675,40.74985000000001,45.17599999999999,47.41639999999996,46.245500000000035,46.2340692964125,46.446812873880646,46.34384615384617,49.4818860953632,43.20580621232914,40.74985000000001,45.17599999999999,47.41639999999996,46.245500000000035,45.22666666666667,6423875,6516746.75,44.929455021154894,3.971302870545823,1.5,2.75,NaN,NaN,1.9515956828551018,0.9857487556962375,817.7311113202506,0.044260182785810856,0.1012173009568329,0.056957118171022045,43.29952344011077,-1.8304641534103365,3.1604294045002517,80.85788026535452,15.981690330145227,4959717240
1521552600,45.25,45.63,44.9,45.27,35.358620689655176,48.95066129032258,54.48,39.04,54.48,39.04,32.9575,21.64,25.1025,19.0675,40.80250000000001,45.222199999999994,47.37279999999996,46.24050000000004,46.1962626573375,46.33473545732058,46.48923076923079,49.21222077218948,43.76624076627209,40.80250000000001,45.222199999999994,47.37279999999996,46.24050000000004,45.26666666666667,3142559,6343565.4,45.80030392000113,2.3782217546351387,1.5,2.75,NaN,NaN,1.864338848365452,0.4953931743180262,815.8982929165426,-0.05163822256299827,-0.007590660032725793,0.04404756253027248,43.107042230770006,-1.286524204099425,14.660351931812478,56.553136732049175,28.78651133613835,4962859799
1521639000,45.25,46.44,44.89,45.04,35.30241379310345,48.79679354838709,54.48,39.04,54.48,39.04,32.9575,21.64,25.1025,19.0675,40.85440000000001,45.271899999999995,47.31879999999997,46.261500000000034,46.15091902371642,46.211427318528145,46.564615384615394,49.059096867774265,44.07013390145652,40.85440000000001,45.271899999999995,47.31879999999997,46.261500000000034,45.45666666666667,4552810,6168934.75,44.999147064435554,1.5551443996680068,1.5,2.75,NaN,NaN,1.8418860734822053,0.7380220709904575,818.4182135502134,-0.1241181601176311,-0.1111001376167664,0.013018022500864701,43.15556511516312,-3.1606106213717458,14.522523134720938,56.771374378504454,28.706102486774615,4958306989
1521725400,43.73,44.25,41.49,41.69,35.246206896551726,48.642925806451615,54.48,39.04,54.48,39.04,32.9575,21.64,25.1025,19.0675,40.89105000000002,45.28679999999999,47.19119999999996,46.104000000000035,45.975981022786364,45.78081519295404,46.26923076923079,49.85467537454147,42.683786163920104,40.89105000000002,45.28679999999999,47.19119999999996,46.104000000000035,42.47666666666667,10022279,6273656.85,35.31064740963069,7.2973839423624,1.5,2.75,NaN,NaN,1.963894211090619,1.5975178814569688,813.6585579967459,-0.3769485583736346,-0.45816767546617854,-0.08121911709254395,59.544027670874954,-14.72693802413582,9.592241449671473,65.37279002661194,25.03496852371659,4948284710
1521811800,41.92,42.2799,38.86,38.93,35.19,48.48905806451613,54.48,39.04,54.48,39.04,32.9575,21.64,25.1025,19.0675,40.912900000000015,45.2646,47.01399999999996,45.70150000000003,45.69966804150062,45.12835660314889,45.733846153846166,51.047813459043866,40.419878848648466,40.912900000000015,45.2646,47.01399999999996,45.70150000000003,40.0233,10342166,6530435.25,29.64715603312834,11.69886469980012,1.5,2.75,NaN,NaN,2.067894624584146,1.583687090381916,809.0906423168612,-0.69105378050341,-0.9450363427218065,-0.25398256221839643,53.77350897358613,-20.094417077175695,1.071324482426261,89.15790249290419,9.770773024669541,4937942544
1522071000,40.83,42.319,39.581,42.19,35.133793103448276,48.335190322580644,54.48,39.04,54.48,39.04,32.9575,21.64,25.1025,19.0675,40.95085000000001,45.2792,46.880399999999966,45.38000000000004,45.56203400065746,44.84851311713471,45.451538461538476,51.088809193175834,39.81426772990112,40.95085000000001,45.2792,46.880399999999966,45.38000000000004,41.36333333333334,9041728,6705126,41.5683536582904,6.810237643469934,1.5,2.75,NaN,NaN,2.162259294256707,1.3484799539934074,813.9102451457852,-0.6413415728344323,-1.0556595282614367,-0.4143179554270045,79.91230852780676,-11.643979057591627,12.73469782310943,60.065416582468586,27.199885594421986,4946984272
1522157400,42.66,42.94,39.15,39.92,35.077586206896555,48.18132258064516,54.48,39.04,54.48,39.04,32.9575,21.64,25.1025,19.0675,40.97820000000001,45.2697,46.68239999999996,45.037000000000035,45.34077776533756,44.379130915502834,44.9446153846154,51.255000550890564,38.63423021834024,40.97820000000001,45.2697,46.68239999999996,45.037000000000035,40.67,7820225,6746415.2,36.88189876487186,7.389577573246421,1.5,2.75,NaN,NaN,2.2785264875240854,1.1591674642260381,810.5000818823701,-0.7176515782911375,-1.3113824282909263,-0.5937308499997889,83.30576288949811,-15.09995746490855,5.01185241502154,75.81720249460102,19.170945090377455,4939164047
1522243800,40.06,40.92,39.02,39.64,35.02137931034483,48.02745483870967,54.48,39.04,54.48,39.04,32.9575,21.64,25.1025,19.0675,41.004400000000004,45.25540000000001,46.48939999999996,44.757500000000036,45.117217852971386,43.92778511402637,44.233076923076936,50.68787303909859,37.77828080705528,41.004400000000004,45.25540000000001,46.48939999999996,44.757500000000036,39.86,9961362,6857160.15,36.33770202730482,8.05085635124688,1.5,2.75,NaN,NaN,2.251488881272365,1.4526949614848939,811.7556998882048,-0.7403167447866379,-1.5191267809830862,-0.7788100361964483,83.53528859312351,-15.389541088580579,3.9851668864557492,78.60809480177069,17.406738311773573,4929202685
1522330200,40.23,42.09,39.8193,41.29,34.965172413793105,47.873587096774195,54.48,39.04,54.48,39.04,32.9575,21.64,25.1025,19.0675,41.036400000000015,45.25730000000001,46.301999999999964,44.653000000000034,44.96713087834506,43.6765674841191,43.66153846153847,49.73017078067365,37.59290614240329,41.036400000000015,45.25730000000001,46.301999999999964,44.653000000000034,41.06643333333333,7703209,6702500.6,41.78852253193427,4.197876833710095,1.5,2.75,NaN,NaN,2.2656682468957676,1.1493037389657228,815.9002243884743,-0.603314797234235,-1.532953532739242,-0.9296387355050071,89.78789362338664,-12.074105621805797,17.164483927791448,53.13488077940157,29.700635292806997,4936905894
1522675800,40.85,41.12,37.12,38.42,37.12,47.71971935483871,54.48,39.04,54.48,39.04,32.9575,21.64,25.1025,19.0675,41.05460000000001,45.22690000000001,46.061199999999964,44.37100000000002,44.71038064782172,43.17594200944109,42.94384615384616,49.11459869970704,36.77309360798528,41.05460000000001,45.22690000000001,46.061199999999964,44.37100000000002,38.88666666666666,12061530,6873377,36.01265360017958,10.982579838070487,1.5,2.75,NaN,NaN,2.40169194354607,1.7548186284558522,810.7352974201392,-0.6604992283332207,-1.755262770921533,-1.0947635425883122,95.21687757832062,-14.716981132075462,18.586733008410437,50.71777737355403,30.695489618035545,4924844364
1522762200,39.1,40.16,38.11,39.93,37.12882352941176,47.565851612903224,54.48,39.04,54.48,39.04,32.9575,21.64,25.1025,19.0675,41.08140000000001,45.209900000000005,45.83799999999996,44.09100000000002,44.52291474006401,42.866804675208606,42.39846153846155,48.27816768577012,36.51875539115297,41.08140000000001,45.209900000000005,45.83799999999996,44.09100000000002,39.4,9172481,6918984.7,40.659826775541006,6.144452813188387,1.5,2.75,NaN,NaN,2.3765710904356365,1.3256975405654532,812.6442688130996,-0.5553714383165969,-1.7889778404840584,-1.2336064021674615,99.59210034479759,-11.795891318754148,18.051943736259283,51.47299250793992,30.475063755800814,4934016845
1522848600,38.07,41.5196,37.99,41.22,37.137647058823525,47.41198387096774,54.48,39.04,54.48,39.04,32.9575,21.64,25.1025,19.0675,41.114750000000015,45.206100000000006,45.61539999999995,43.85750000000003,44.39338867182621,42.709966134712545,41.96538461538462,47.27111223392387,36.65965699684537,41.114750000000015,45.206100000000006,45.61539999999995,43.85750000000003,40.2432,10015061,7160692.45,44.37646900754906,3.687003552310502,1.5,2.75,NaN,NaN,2.458930298261662,1.3986162748827453,815.6139431247442,-0.3667945472749512,-1.6920995862611505,-1.3253050389861993,102.41869748237546,-8.481349911190053,42.21904889001291,25.182517911252283,32.59843319873481,4944031906
1522935000,42.08,42.589,41.4934,42.1,37.14647058823529,47.25811612903226,54.48,39.04,54.48,39.04,32.9575,21.64,25.1025,19.0675,41.14825000000002,45.209,45.403399999999955,43.66950000000003,44.30345186116636,42.65187412188278,41.59153846153846,46.05489246879386,37.128184454283065,41.14825000000002,45.209,45.403399999999955,43.66950000000003,42.0608,6809892,7126682.2,46.82328385667015,0.9046613700425867,1.5,2.75,NaN,NaN,2.3810781341001146,0.9555487124148737,818.6271416046596,-0.1611281318225921,-1.5267152037644394,-1.3655870719418473,103.90994688156495,0.9834492684096995,69.45308716109773,7.591133945745654,22.95577889315661,4950841798
1523021400,41.06,41.85,38.5,39.34,37.15529411764705,47.104248387096774,54.48,39.04,54.48,39.04,32.9575,21.64,25.1025,19.0675,41.17120000000002,45.18900000000001,45.13779999999996,43.31100000000003,44.10880669014023,42.336457538846325,41.1523076923077,45.278972606449564,37.02564277816584,41.17120000000002,45.18900000000001,45.13779999999996,43.31100000000003,39.89666666666667,10687371,7421619.85,40.76631789553585,5.420928069093921,1.5,2.75,NaN,NaN,2.4681439816643924,1.4400321245233276,816.2596381804238,-0.18746075958535924,-1.5999130214235464,-1.4124522618381872,101.67825954365651,1.0531723606473251,40.17894033785691,26.93317483698584,32.88788482515725,4940154427
1523280600,40.1,41.6067,39.6446,39.79,37.16411764705882,46.95038064516129,54.48,38.42,54.48,39.04,32.9575,21.64,25.1025,19.0675,41.19665000000002,45.1743,44.87979999999996,42.85600000000003,43.939441721899435,42.09393777324191,40.73076923076924,44.14728532886108,37.3142531326774,41.19665000000002,45.1743,44.87979999999996,42.85600000000003,40.34709999999999,6741656,7464945.6,42.08183403425184,2.1932858782711318,1.5,2.75,NaN,NaN,2.453755125831221,0.9031085236575602,815.9503613240103,-0.15254353136187104,-1.603131676040526,-1.450588144678655,93.69445155299483,-5.688551789523581,70.51991688890833,7.10215400688655,22.377929104205133,4946896083
1523367000,41.38,42.192,40.79,41.79,37.17294117647059,46.7965129032258,54.48,38.42,54.48,39.04,32.9575,21.64,25.1025,19.0675,41.232500000000016,45.17850000000001,44.625999999999955,42.509500000000024,43.855149889668084,42.064991318647444,40.48076923076924,42.9412815168713,38.02025694466718,41.232500000000016,45.17850000000001,44.625999999999955,42.509500000000024,41.59066666666666,7481720,7606401.8,47.646919708658345,1.2552277679988975,1.5,2.75,NaN,NaN,2.4500583311289907,0.9836083074128427,820.1679714641391,0.018198557667176818,-1.4278399475946841,-1.446038505261861,85.49932298522273,4.684368737474943,69.44785047327623,7.5919632411343185,22.960186285589433,4954377803
1523453400,40.99,42.02,40.94,41.07,37.18176470588235,46.64264516129032,54.48,38.42,54.48,39.04,32.9575,21.64,25.1025,19.0675,41.263950000000015,45.1782,44.37919999999996,42.17550000000003,43.74592832536737,41.97023024068102,40.43307692307693,42.82094864512289,38.045205201030974,41.263950000000015,45.1782,44.37919999999996,42.17550000000003,41.343333333333334,6605680,7567922.25,45.93574253333148,0.18287488750547728,1.5,2.75,NaN,NaN,2.3521970217626347,0.8728525190649257,820.99605013535,0.091496931861349,-1.3316673404351747,-1.4231642722965236,79.23264989782767,3.6074672048435916,40.86190832051972,26.335923381661527,32.80216829781877,4947772123
1523539800,41.8,42.6,41.7,42.11,37.190588235294115,46.48877741935484,54.48,38.42,54.48,39.04,32.9575,21.64,25.1025,19.0675,41.300550000000015,45.19469999999999,44.18719999999997,41.93000000000003,43.68177427339218,41.983541646330444,40.67769230769232,43.051020433032875,38.30436418235176,41.300550000000015,45.19469999999999,44.18719999999997,41.93000000000003,42.13666666666667,6026975,7656085.15,48.796277187147,2.101343184904947,1.5,2.75,NaN,NaN,2.293468663065304,0.7872136845290963,822.5256326409734,0.21198759980384718,-1.1581797725417147,-1.3701673723455619,79.90034499994763,1.9859530152579323,39.514492213812815,27.514701846835827,32.97080593935136,4953799098
1523626200,42.78,42.865,41.16,41.73,37.19941176470588,46.334909677419354,54.48,38.42,54.48,39.04,32.9575,21.64,25.1025,19.0675,41.33915000000001,45.19739999999999,43.984999999999964,41.67400000000003,43.60523410580817,41.9593948228704,40.6423076923077,42.936798134766015,38.34781724984939,41.33915000000001,45.19739999999999,43.984999999999964,41.67400000000003,41.91833333333333,6007903,7746793,47.80107892119404,1.1528032551376994,1.5,2.75,NaN,NaN,2.2514351871320684,0.7755342113826973,820.851838358038,0.2646369180444872,-1.039371224789953,-1.30400814283444,77.04721771955302,8.61530452889119,49.35366337055046,19.57022943524442,31.07610719420511,4947791195
1523885400,42.58,43.15,42.14,42.73,37.20823529411764,46.18104193548387,54.48,38.42,54.48,39.04,32.9575,21.64,25.1025,19.0675,41.378550000000004,45.213399999999986,43.80699999999996,41.46250000000003,43.570911199698045,42.03278579212084,40.858461538461555,43.36012678267046,38.356796294252646,41.378550000000004,45.213399999999986,43.80699999999996,41.46250000000003,42.673333333333325,3744483,7718248.25,50.65329340437898,2.884004094400048,1.5,2.75,NaN,NaN,2.192046959479778,0.48514674298018334,824.5343951450809,0.3594698433379102,-0.8546708386620523,-1.2141406819999625,61.95213221357354,7.012271475081385,44.868744416015936,23.00435210923391,32.12690347475015,4951535678
1523971800,43.69,44.41,43.38,44.09,37.217058823529406,46.02717419354838,54.48,38.42,54.48,39.04,32.9575,21.64,25.1025,19.0675,41.42920000000001,45.24149999999999,43.72339999999996,41.41450000000003,43.5912676232393,42.228710954776,41.20076923076925,44.12412306380693,38.277415397731566,41.42920000000001,45.24149999999999,43.72339999999996,41.41450000000003,43.96,4018935,7598001.25,54.30980735947791,4.947352976278135,1.5,2.75,NaN,NaN,2.1554721766597935,0.5289463462512591,828.1656861702954,0.4979263921400088,-0.5917326918249515,-1.0896590839649603,60.89400778377755,6.962639495390598,37.66723167783528,29.180165341293783,33.15260298087095,4955554613
1524058200,44.39,44.6374,43.94,44.17,37.22588235294117,44.6374,54.48,38.42,54.48,39.04,32.9575,21.64,25.1025,19.0675,41.47940000000001,45.262199999999986,43.75999999999996,41.35950000000003,43.613963010563246,42.413595625749714,41.42230769230771,44.74795769328407,38.09665769133135,41.47940000000001,45.262199999999986,43.75999999999996,41.35950000000003,44.249133333333326,3329995,7607373.05,54.523275956839385,4.720331157903393,1.5,2.75,NaN,NaN,2.051324164041237,0.43773257576739977,829.8072270587747,0.5736457772960589,-0.37260186234488657,-0.9462476396409455,59.3665011115284,4.91686460807601,68.82080200097246,7.884894814087786,23.294303184939768,4958884608
1524144600,43.8,43.94,42.89,43.45,37.23470588235294,44.434096,54.48,38.42,54.48,39.04,32.9575,21.64,25.1025,19.0675,41.525250000000014,45.27659999999998,43.735199999999956,41.28000000000004,43.607533088580375,42.51230080424974,41.809230769230794,44.80133794068101,38.81712359778058,41.525250000000014,45.27659999999998,43.735199999999956,41.28000000000004,43.42666666666667,4214623,7590463.7,52.1612420671411,2.2382663201349806,1.5,2.75,NaN,NaN,1.9962295808954347,0.5552523754247056,826.3122229438356,0.553711802592171,-0.2541078864007318,-0.8078196889929028,59.984392581425524,10.447381799694964,37.18110818501145,29.628719210147615,33.19017260484092,4954669985
1524231000,43.43,43.521,41.85,42.32,37.243529411764705,44.230792,54.48,38.42,54.48,39.04,32.9575,21.64,25.1025,19.0675,41.56430000000001,45.277299999999975,43.70319999999996,41.31150000000004,43.55704159491056,42.493986441940244,41.993076923076956,44.78792255927541,39.1982312868785,41.56430000000001,45.277299999999975,43.70319999999996,41.31150000000004,42.56366666666667,5689915,7373845.5,48.6025235943586,0.7927286026258938,1.5,2.75,NaN,NaN,1.9729988965457608,0.7716346918307415,823.2689217357738,0.4474418635671744,-0.24851735953393472,-0.6959592231011091,44.89090812162596,6.358381502890176,37.97743571202051,28.89613602969717,33.126428258282324,4948980070
1524490200,42.63,42.94,41.721,42.29,37.25235294117647,44.027488,54.48,38.42,54.48,39.04,32.9575,21.64,25.1025,19.0675,41.607700000000015,45.278099999999974,43.76819999999996,41.47950000000004,43.50735368922779,42.47455916175546,42.07538461538464,44.83714119558574,39.31362803518355,41.607700000000015,45.278099999999974,43.76819999999996,41.47950000000004,42.317,3243318,7018903.1,48.50790299310361,0.5854891679584656,1.5,2.75,NaN,NaN,1.919141832506778,0.4620833132744061,821.9921535554445,0.3618086802019006,-0.2436983728487334,-0.605507053050634,45.02484248044795,1.1964584828906437,17.59593557535206,52.121302984102314,30.28276144054563,4945736752
1524576600,42.86,42.97,39.78,40.64,37.26117647058823,43.824184,54.48,38.42,54.48,39.04,32.9575,21.64,25.1025,19.0675,41.639900000000004,45.24979999999998,43.76439999999996,41.40200000000003,43.39490844651298,42.29983924158827,41.96307692307695,44.828492823783805,39.09766102237009,41.639900000000004,45.24979999999998,43.76439999999996,41.40200000000003,41.13,8778813,7005757.35,43.492678156090165,4.176848995530244,1.5,2.75,NaN,NaN,2.009917415899151,1.2530855068795668,819.4734733454933,0.18938999790470679,-0.36876955566975056,-0.5581595535744573,42.83231045345032,-1.04699293888483,2.186425685746305,84.24248795136292,13.57108636289079,4936957939
1524663000,40.59,41.1399,39.61,40.87,37.269999999999996,43.62088,54.48,38.42,54.48,39.04,32.9575,21.64,25.1025,19.0675,41.672750000000015,45.224599999999974,43.73319999999996,41.449500000000036,43.29589242900266,42.16366407572272,42.080769230769256,44.611727839535895,39.54981062200262,41.672750000000015,45.224599999999974,43.73319999999996,41.449500000000036,40.539966666666665,4855985,6857545.35,44.35629777608685,3.5146388715874193,1.5,2.75,NaN,NaN,1.97563045762064,0.7081229145644659,817.6000765950383,0.09115986828820877,-0.4442097182141964,-0.5353695865024052,41.99452194660451,-2.9446687247684684,3.7365042649006748,79.07513806700675,17.188357668092564,4941813924
1524749400,41.44,42.54,41.1998,42.1,37.27882352941176,43.417576,54.48,38.42,54.48,39.04,32.9575,21.64,25.1025,19.0675,41.71200000000002,45.20079999999998,43.71899999999996,41.57250000000003,43.24899468668883,42.157600830415795,42.25846153846157,44.41830264592004,40.09862043100309,41.71200000000002,45.20079999999998,43.71899999999996,41.57250000000003,41.9466,5523046,6635629.55,48.857815926401926,0.6057315725516291,1.5,2.75,NaN,NaN,1.9537997106477374,0.8323318772368781,820.8883132045298,0.1081889639710426,-0.4001333815386019,-0.5083223455096445,43.093619784190736,0.8866522885214584,17.94934956620657,51.61438310552478,30.436267328268656,4947336970
1524835800,42.42,42.6,41.7201,42.2,37.287647058823524,43.214272,54.48,38.42,54.48,39.04,32.9575,21.64,25.1025,19.0675,41.74795000000002,45.18029999999998,43.67259999999996,41.61800000000004,43.207857640152014,42.161638846566674,42.290000000000035,44.43346950957127,40.1465304904288,41.74795000000002,45.18029999999998,43.67259999999996,41.61800000000004,42.173366666666666,4741136,6487525.9,49.217512688443044,0.5202258790611206,1.5,2.75,NaN,NaN,1.8770925884586132,0.7308080265236397,822.9145829868563,0.12420707114707519,-0.35306350657580055,-0.47727057772287573,42.714691172145024,-1.240346360870569,41.93437011271093,25.418652172866977,32.64697771442209,4952078106
1525095000,42.52,42.849,41.21,41.22,37.29647058823529,43.010968,54.48,38.42,54.48,39.04,32.9575,21.64,25.1025,19.0675,41.77815000000001,45.15159999999998,43.57319999999995,41.758000000000045,43.129902438577425,42.07195895641747,42.30153846153849,44.42008435115017,40.18299257192681,41.77815000000001,45.15159999999998,43.57319999999995,41.758000000000045,41.75966666666667,5237125,6146305.65,45.81663359496694,0.6852284603811176,1.5,2.75,NaN,NaN,1.8600859749972833,0.8520768894726216,820.3011561177819,0.06954564470358315,-0.3903385218433968,-0.45988416654697994,42.17468694712606,-6.50941256520754,37.69237675326184,29.18672344371992,33.120899803018254,4946840981
1525181400,40.99,41.5,40.13,41.44,37.30529411764705,42.807664,54.48,38.42,54.48,39.04,32.9575,21.64,25.1025,19.0675,41.80725000000001,45.129999999999974,43.47799999999996,41.83350000000004,43.06363175471164,42.011772389139615,42.25000000000003,44.41672741532197,40.083272584678085,41.80725000000001,45.129999999999974,43.47799999999996,41.83350000000004,41.02333333333333,5157491,5945556.15,46.706907696252415,1.9749156499931129,1.5,2.75,NaN,NaN,1.8250798339260486,0.8674530809031212,821.3889673759206,0.049871786164654375,-0.397544433841162,-0.4474162200058164,36.57505373632072,-6.18066561014264,76.40260038778882,4.691568202802466,18.905831409408712,4951998472
1525267800,41.34,41.77,40.39,40.56,37.31411764705882,42.60436,54.48,38.42,54.48,39.04,32.9575,21.64,25.1025,19.0675,41.831950000000006,45.09969999999998,43.381799999999956,41.80050000000004,42.96545011727197,41.8735083520787,42.16000000000003,44.496216533694565,39.8237834663055,41.831950000000006,45.09969999999998,43.381799999999956,41.80050000000004,40.906666666666666,5284635,5709034.85,43.61957216120561,1.8539601315427707,1.5,2.75,NaN,NaN,1.7932884172170453,0.9256617167085607,820.7213955266692,-0.01715430454752631,-0.4688591006902243,-0.451704796142698,37.14283379292536,-6.65132336018412,48.51455759338677,20.214123900270145,31.27131850634308,4946713837
1525354200,40.11,40.66,38.7,40.3,38.7,42.401056,54.48,38.42,54.48,39.04,32.9575,21.64,25.1025,19.0675,41.85505,45.062599999999975,43.295399999999965,41.71050000000004,42.860922661692676,41.72365041378549,41.973076923076945,44.47960237127914,39.46655147487475,41.85505,45.062599999999975,43.295399999999965,41.71050000000004,39.88666666666666,9825213,5859800.9,42.721067829355405,3.9153246045571857,1.5,2.75,NaN,NaN,1.8051963874158274,1.6767144767666082,818.6808964789761,-0.07074018889324651,-0.5401300322592562,-0.46938984336600964,36.806390504941454,-4.773156899810972,14.965832282969469,56.09981109077567,28.934356626254864,4936888624
1525440600,39.8,42.2112,39.64,41.85,38.76869565217392,42.197752,54.48,38.42,54.48,39.04,32.9575,21.64,25.1025,19.0675,41.883,45.033799999999985,43.235599999999955,41.83600000000004,42.821278635743944,41.735683707710685,41.800769230769255,43.98930525762109,39.61223320391742,41.883,45.033799999999985,43.235599999999955,41.83600000000004,41.23373333333333,5889120,5619888.35,49.411220235069756,1.6222926628326158,1.5,2.75,NaN,NaN,1.8599109311718396,1.0479069392899951,822.6501935387761,0.0025782510450654827,-0.4661670295596778,-0.4687452806047433,42.700423408016974,-1.040435091038065,17.332687232647128,52.53459315809268,30.132719609260185,4942777744
1525699800,42.29,42.8,41.91,42.25,38.83739130434783,41.994448,54.48,38.42,54.48,38.42,32.9575,39.04,25.1025,21.64,41.9128,45.00489999999998,43.140999999999956,41.959000000000046,42.798875551989276,41.78466621173824,41.65307692307695,43.39588428902217,39.910269557131734,41.9128,45.00489999999998,43.140999999999956,41.959000000000046,42.32,4272227,5496416.9,51.00172461407919,1.712697867876516,1.5,2.75,NaN,NaN,1.7949172932309936,0.7772749188657796,825.3390759266048,0.07819819937878386,-0.37099753138126346,-0.4491957307600473,43.13572465123769,3.961614173228345,35.32189980549671,31.387127862948102,33.29097233155519,4947049971
1525786200,42.1,42.4755,41.4601,42.26,38.90608695652174,41.791144,54.48,38.42,54.48,38.42,32.9575,39.04,25.1025,21.64,41.943000000000005,44.973599999999976,43.01379999999997,41.982500000000044,42.77774317740146,41.8299360963346,41.56153846153848,43.01882458314834,40.10425233992863,41.943000000000005,44.973599999999976,43.01379999999997,41.982500000000044,42.0652,3465279,5295594.85,51.04316451371216,0.8291199131194437,1.5,2.75,NaN,NaN,1.739237486571637,0.6543701129250853,826.3341131168148,0.12622944753628196,-0.29140892133969487,-0.41763836887597683,35.02661659814968,3.4010276486420374,31.620825648968296,35.07939714908829,33.29977720194342,4950515250
1525872600,42.65,43.66,42.35,43.47,38.974782608695655,41.58784,54.48,38.42,54.48,38.42,32.9575,39.04,25.1025,21.64,41.9795,44.970899999999986,42.94759999999996,42.10250000000004,42.80489050377788,41.986132658588446,41.65000000000002,43.392429780066216,39.907570219933824,41.9795,44.970899999999986,42.94759999999996,42.10250000000004,43.16,4047652,5167693.45,55.90295394805787,3.339451427849463,1.5,2.75,NaN,NaN,1.7150062375308057,0.7832608569302809,829.0540502948444,0.23074424964564155,-0.1292080568189249,-0.35995230646456644,37.723339015010914,3.2541567695961935,55.67214614822127,15.221891708552365,29.105962143226368,4954562902
1525959000,43.91,44.89,43.841,44.72,39.04347826086957,41.384536,54.48,38.42,54.48,38.42,32.9575,39.04,25.1025,21.64,42.02089999999999,44.98599999999998,42.937399999999954,42.23300000000005,42.879992836963055,42.24650097681812,41.8369230769231,44.21814945281734,39.455696701028856,42.02089999999999,44.98599999999998,42.937399999999954,42.23300000000005,44.483666666666664,4701863,5101437.85,60.28855507898091,5.065167517289913,1.5,2.75,NaN,NaN,1.6939343634214625,0.9216740727322593,832.4058012155177,0.36720980420764915,0.09905994879499502,-0.2681498554126541,37.43383707626434,5.971563981042644,99.99999999999999,0,0,4959264765
1526045400,44.75,45.26,44.48,44.97,39.112173913043485,41.181232,54.48,38.42,54.48,38.42,32.9575,39.04,25.1025,21.64,42.063549999999985,44.99299999999998,42.969199999999944,42.395000000000046,42.96195390218019,42.505881836168776,42.17000000000003,44.963927481025756,39.376072518974304,42.063549999999985,44.99299999999998,42.969199999999944,42.395000000000046,44.90333333333333,2738547,4937970.05,61.121363929252745,4.82831460425989,1.5,2.75,NaN,NaN,1.6286533374627867,0.5545896334466427,833.8650806277201,0.4518931123089106,0.29671653497348416,-0.15517657733542645,37.36433657627866,9.097525473071325,99.99999999999999,0,0,4962003312
1526304600,45.35,45.71,44.87,45.11,39.18086956521739,40.977928,54.48,38.42,54.48,38.42,32.9575,39.04,25.1025,21.64,42.10739999999999,44.99269999999998,42.99019999999995,42.514000000000046,43.04619100405548,42.753893089866985,42.496153846153874,45.581618912324,39.41068877998375,42.10739999999999,44.99269999999998,42.99019999999995,42.514000000000046,45.23,2527431,4877117.45,61.60693757522553,4.784418553128553,1.5,2.75,NaN,NaN,1.5723209562154452,0.5182222954257539,832.7758420505635,0.4916311737427136,0.4593623898429655,-0.03226878389974805,32.385135622697604,8.85617760617761,100,0,0,4964530743
1526391000,44.47,44.48,43.74,44.21,39.24956521739131,40.774624,54.48,38.42,54.48,38.42,32.9575,39.04,25.1025,21.64,42.14749999999998,44.989599999999975,42.96379999999995,42.520000000000046,43.09183057252389,42.89256993845108,42.658461538461566,45.86317773762176,39.45374533930137,42.14749999999998,44.989599999999975,42.96379999999995,42.520000000000046,44.14333333333334,6682434,5010292.4,56.7039940117896,2.056044395007962,1.5,2.75,NaN,NaN,1.5578694593429134,1.333741320167262,829.8516292662123,0.4336243931929993,0.5097617075915011,0.07613731439850178,36.47902890230107,8.999013806706111,59.020831684659086,13.135933165842285,27.843235149498632,4957848309
1526477400,44.23,45.02,44.23,44.79,39.31826086956522,40.57132,54.48,38.42,54.48,38.42,32.9575,39.04,25.1025,21.64,42.19079999999999,44.99329999999997,42.94179999999995,42.551000000000045,43.15842545203276,43.073277563360506,42.85769230769233,46.24070101725754,39.47468359812712,42.19079999999999,44.99329999999997,42.94179999999995,42.551000000000045,44.68,5268878,5107236.55,58.97018742972682,2.982913991839081,1.5,2.75,NaN,NaN,1.5044502122469914,1.0316494935015297,832.6163133821411,0.4108556753532179,0.5897069085900242,0.17885123323680627,31.908894031345564,11.141439205955342,61.9009846382442,11.462567758318839,26.636447603436977,4963117187
1526563800,44.63,45.25,44.21,44.65,39.38695652173914,40.368016,54.48,38.42,54.48,38.42,32.9575,39.04,25.1025,21.64,42.23229999999999,44.99329999999997,42.91759999999995,42.61100000000004,43.21691857156089,43.22344160494522,43.121538461538485,46.487465890289926,39.755611032787044,42.23229999999999,44.99329999999997,42.91759999999995,42.61100000000004,44.70333333333334,4154808,5104245.8,58.178603162170404,2.4104263777919983,1.5,2.75,NaN,NaN,1.471275197086492,0.8139905801558381,834.0020586166892,0.3644819252175803,0.6344536397587817,0.26997171454120134,31.342655774744927,6.6905615292712,32.941853009140814,33.72704224311598,33.331104747743204,4958962379
1526650200,44.45,44.63,44.1,44.31,39.45565217391305,40.164712,54.48,38.42,54.48,38.42,32.9575,39.04,25.1025,21.64,42.271849999999986,44.99039999999997,42.87359999999994,42.71050000000004,43.25978450993105,43.326923356855204,43.34230769230771,46.61325348680394,40.071361897811485,42.271849999999986,44.99039999999997,42.87359999999994,42.71050000000004,44.34666666666667,1706445,4905072.3,56.205371684257074,1.4774819026697952,1.5,2.75,NaN,NaN,1.405469825866028,0.34789395459063877,834.8387186432233,0.29214972595725464,0.6351588719877697,0.343009146030515,27.35369169361259,4.87573964497042,19.651988417812767,49.241274419641115,31.10673716254612,4957255934
1526909400,45.12,45.6,44.93,45.28,39.52434782608696,39.961408,54.48,38.42,54.48,38.42,32.9575,39.04,25.1025,21.64,42.31714999999999,44.998799999999974,42.80139999999995,42.86000000000004,43.3390086467965,43.51293065620233,43.70538461538464,46.69622823585866,40.714540994910614,42.31714999999999,44.998799999999974,42.80139999999995,42.86000000000004,45.27,3499209,4917866.85,60.33834910952269,2.9221890818412604,1.5,2.75,NaN,NaN,1.3972219811613118,0.7115298373724779,838.1133505745576,0.2902743183726863,0.7058520439963729,0.4155777256236866,28.81575930493679,7.146237576904883,22.61384335486422,45.359462376199374,32.02669426893641,4960755143
1526995800,45.6,45.739,44.725,44.9,39.593043478260874,39.758104,54.48,38.42,54.48,38.42,32.9575,39.04,25.1025,21.64,42.3597,45.002599999999966,42.72499999999995,43.07300000000004,43.40022399398095,43.64503249846877,44.059230769230794,46.364708681154234,41.753752857307354,42.3597,45.002599999999966,42.72499999999995,43.07300000000004,45.12133333333333,2422153,4600033.85,58.02800651444618,2.365230109358178,1.5,2.75,NaN,NaN,1.369848982506932,0.5265511252705238,836.0608890218855,0.24584273475827395,0.722881144071529,0.4770384093132551,29.955280754341644,3.289625028755463,35.37140011233641,31.336442149845997,33.29215773781759,4958332990
1527082200,44.19,45.309,44.1,45.28,39.66173913043479,39.5548,54.48,38.42,54.48,38.42,32.9575,39.04,25.1025,21.64,42.40335,45.00799999999997,42.67559999999996,43.29350000000004,43.47394070009935,43.800743689090794,44.32307692307695,46.321466807503285,42.32468703865061,42.40335,45.00799999999997,42.67559999999996,43.29350000000004,44.89633333333333,3009562,4507712.7,59.6901879160327,1.5174037424213918,1.5,2.75,NaN,NaN,1.3583597694707221,0.6676472526742886,836.8147758328465,0.22500804067130709,0.758298460152389,0.5332904194810819,26.56399970795159,1.2522361359570713,25.997257813895402,41.25436958415405,32.74837260195056,4961342552
1527168600,45.06,45.2,44,45.02,39.730434782608704,39.351496,54.48,38.42,54.48,38.42,32.9575,39.04,25.1025,21.64,42.4468,45.01489999999997,42.63559999999996,43.43950000000004,43.53457047656604,43.916863337748815,44.536153846153866,46.16066870318352,42.911638989124214,42.4468,45.01489999999997,42.63559999999996,43.43950000000004,44.739999999999995,3219490,4392534.9,57.99778159492424,1.44265304290674,1.5,2.75,NaN,NaN,1.3527626430799562,0.7329457985638315,836.9080263136706,0.17869946520172708,0.7566647509832407,0.5779652857815136,21.988787455385925,0.11118523460085449,29.591366099409317,37.221464567726976,33.18716933286372,4958123062
1527255000,44.68,45.009,44.37,44.65,39.79913043478262,39.148192,54.48,38.42,54.48,38.42,32.9575,39.04,25.1025,21.64,42.48865,45.009499999999974,42.591599999999964,43.56200000000003,43.57831281081835,43.986685877010835,44.72000000000002,45.675888632071285,43.764111367928756,42.48865,45.009499999999974,42.591599999999964,43.56200000000003,44.67633333333333,1971621,4254059.15,55.58257964288217,0.6091070169095616,1.5,2.75,NaN,NaN,1.3025653114313884,0.46346816780862105,835.6196692414354,0.11142469119169163,0.7172461497711282,0.6058214585794366,22.288820802902833,-1.0197295499889178,28.422530606367843,38.49891128028777,33.078558113344386,4956151441
1527600600,43.76,44.18,42.4899,43.15,39.867826086956526,38.944888,54.48,38.42,54.48,38.42,32.9575,39.04,25.1025,21.64,42.53049999999999,44.98109999999997,42.515399999999964,43.65850000000003,43.56151623000195,43.90700150777171,44.69538461538463,45.785779473564716,43.60498975720455,42.53049999999999,44.98109999999997,42.515399999999964,43.65850000000003,43.2733,5521893,4268297.55,47.03176379888169,3.113412430050589,1.5,2.75,NaN,NaN,1.3638177891862893,1.293699170527603,833.53367994344,-0.03783255458491386,0.5585307653482943,0.5963633199332081,29.143078524668702,-2.3976475910427557,4.4445681803693615,77.06183228712398,18.49359953250666,4950629548
1527687000,43.8178,45.04,43.76,44.82,39.93652173913044,38.741584,54.48,38.42,54.48,38.42,32.9575,39.04,25.1025,21.64,42.580149999999996,44.96359999999997,42.51079999999996,43.82750000000003,43.610868534707755,43.99395374512679,44.70307692307694,45.7954669524764,43.61068689367748,42.580149999999996,44.96359999999997,42.51079999999996,43.82750000000003,44.54,3855089,4203177.45,55.28031196986997,1.1349641782227815,1.5,2.75,NaN,NaN,1.4014022328158402,0.9171844505399124,838.0714006367957,-0.02826229159424898,0.5610354554403969,0.5892977470346459,35.95181210149846,0.06697923643670717,21.204605838278493,47.18640843102923,31.608985730692282,4954484637
1527773400,44.6,44.76,43.65,43.9,40.005217391304356,38.53828,54.48,38.42,54.48,38.42,32.9575,39.04,25.1025,21.64,42.620099999999994,44.928099999999965,42.48339999999997,43.99450000000003,43.62220702354274,43.98500576940043,44.62076923076924,45.77953413128813,43.46200433025035,42.620099999999994,44.928099999999965,42.48339999999997,43.99450000000003,44.10333333333333,4016988,4139795.1,50.60499135867916,0.45968214678076935,1.5,2.75,NaN,NaN,1.384873501900423,0.9703349810718893,835.466096313023,-0.08486704591684602,0.4832139396385884,0.5680809855554344,37.14408125226456,-1.67973124300112,5.522065805411889,74.24448654333105,20.23344765125705,4950467649
1527859800,44.72,45.41,44.65,45.27,40.07391304347827,38.334976,54.48,38.42,54.48,38.42,32.9575,39.04,25.1025,21.64,42.6669,44.903399999999976,42.487999999999964,44.24300000000003,43.68682635595283,44.107386172314676,44.633076923076935,45.81552248833265,43.45063135782122,42.6669,44.903399999999976,42.487999999999964,44.24300000000003,45.11000000000001,4400189,3868543.9,56.504342370504254,1.7068523906300075,1.5,2.75,NaN,NaN,1.3938111089075353,1.1374277024489756,839.0177977832107,-0.03364582500481217,0.5260237042994191,0.5596695293042313,41.57588790596967,2.1665538253215995,24.5777596926703,42.953934962065894,32.46830534526381,4954867838
1528119000,45.71,46.03,45.58,45.91,40.14260869565218,38.131672,54.48,38.42,54.48,38.42,32.9575,39.04,25.1025,21.64,42.715999999999994,44.88179999999998,42.57239999999996,44.446000000000026,43.77400963611154,44.279063679713275,44.76384615384616,46.096663608287656,43.43102869940466,42.715999999999994,44.88179999999998,42.57239999999996,44.446000000000026,45.839999999999996,2689193,3708547.55,58.969646593454335,2.7713682837119347,1.5,2.75,NaN,NaN,1.3485388868427113,0.7251337521612741,841.6651104702217,0.035963318262883126,0.6046236771328353,0.5686603588699521,41.71539038138319,1.3913427561837355,40.781567603312375,26.44889937138193,32.7695330253057,4957557031
1528205400,45.94,46.19,45.52,46.01,40.21130434782609,37.928368,54.48,38.42,54.48,38.42,32.9575,39.04,25.1025,21.64,42.774049999999995,44.863999999999976,42.71399999999997,44.63400000000003,43.86169553273462,44.44391475783582,44.85769230769232,46.347248851843915,43.36813576354072,42.774049999999995,44.863999999999976,42.71399999999997,44.63400000000003,45.906666666666666,2540046,3621938.5,59.35727195005988,2.5560751952200413,1.5,2.75,NaN,NaN,1.300071823496803,0.7012946244117618,843.9849850749835,0.07890512257762039,0.6672917620919776,0.5883866395143572,40.09152158526316,2.4721603563474375,73.89098347118076,5.675682029706789,20.433334499112455,4960097077
1528291800,46.33,47.17,45.97,47.17,40.28000000000001,37.725064,54.48,38.42,54.48,38.42,32.9575,39.04,25.1025,21.64,42.83875,44.84699999999998,42.81359999999997,44.87950000000002,43.99143296282346,44.70354192375622,45.05153846153847,46.975170381452884,43.12790654162406,42.83875,44.84699999999998,42.81359999999997,44.87950000000002,46.77,3249402,3611144.65,63.647530914883184,3.66902996124566,1.5,2.75,NaN,NaN,1.2929238361041744,0.899826042692585,846.648148039353,0.17034815804020453,0.8013218370646129,0.6309736790244084,41.57219880982556,4.174028268551238,73.12154169102193,5.992381168835821,20.88607714014225,4963346479
1528378200,47.43,47.5799,46.581,47.09,40.34869565217392,37.52176,54.48,38.42,54.48,38.42,32.9575,39.04,25.1025,21.64,42.90255,44.81969999999998,42.95699999999997,45.060500000000026,44.11294539565391,44.93082364530325,45.26538461538462,47.416386033466836,43.1143831973024,42.90255,44.81969999999998,42.95699999999997,45.060500000000026,47.08363333333333,2745684,3546046.25,63.1524145317918,3.518655648107111,1.5,2.75,NaN,NaN,1.2719221335253046,0.7742944695095277,848.174813903718,0.20787506949590617,0.890817515894291,0.6829424463983849,41.666383013980884,4.59795646379387,79.77806640748187,3.5145196409470474,16.707413951571095,4960600795
1528464600,46.83,47.53,46.73,47.49,40.41739130434784,37.318456,54.48,38.42,54.48,38.42,32.9575,39.04,25.1025,21.64,42.9633,44.80169999999998,43.11399999999997,45.19900000000003,44.245378909549835,45.17455472670294,45.43538461538462,47.89178116799347,42.97898806277577,42.9633,44.80169999999998,43.11399999999997,45.19900000000003,47.25,2116086,3416757.4,64.63380243126781,3.475128651035702,1.5,2.75,NaN,NaN,1.238213409702069,0.6193257970261512,850.2876995405393,0.23979986554449562,0.9826922783290044,0.7428924127845088,41.25580705596709,6.360582306830915,76.06459650976348,4.823456108146881,19.111947382089642,4962716881
1528723800,47.62,48.11,47.56,47.7,40.486086956521746,37.115152,54.48,38.42,54.48,38.42,32.9575,39.04,25.1025,21.64,43.02685,44.77209999999998,43.24219999999997,45.335500000000025,44.38085424643023,45.4150733241598,45.65076923076924,48.35966581610785,42.941872645430635,43.02685,44.77209999999998,43.24219999999997,45.335500000000025,47.79,2045571,3382108.6,65.4198177720393,4.032168835555023,1.5,2.75,NaN,NaN,1.194055309009064,0.6048212053273511,851.9163622965699,0.2538679050993703,1.0602272941587216,0.8063593890593513,40.36153725274716,10.544611819235238,74.2764863864402,5.506232897782505,20.21728071577729,4964762452
1528810200,47.94,48.08,47.5,47.93,40.55478260869566,36.911848,54.48,38.42,54.48,38.42,32.9575,39.04,25.1025,21.64,43.092850000000006,44.746799999999986,43.43239999999996,45.47650000000002,44.520036432844734,45.654590150430295,45.85461538461539,48.80894066626982,42.900290102960966,43.092850000000006,44.746799999999986,43.43239999999996,45.47650000000002,47.836666666666666,2306563,3371065.2,66.30315219438619,3.249392577005787,1.5,2.75,NaN,NaN,1.1501942155084162,0.6842237877807881,852.1155670647923,0.256703942715479,1.1272393174537,0.8705353747382211,31.109183686324094,6.938866577420793,73.95998966393499,5.63369048405538,20.406319852009613,4967069015
1528896600,48.03,48.1593,47.305,47.38,40.623478260869575,48.1593,54.48,38.42,54.48,38.42,32.9575,39.04,25.1025,21.64,43.15505,44.709699999999984,43.58139999999997,45.63500000000002,44.632191866850825,45.81891489800836,46.03615384615386,49.052412746095854,43.01989494621186,43.15505,44.709699999999984,43.58139999999997,45.63500000000002,47.61476666666667,2617064,3167796.7,62.21070984002012,2.6605430035861506,1.5,2.75,NaN,NaN,1.1290589144006724,0.8261464506229202,849.3275374301404,0.20198845134914056,1.1230209389246468,0.9210324875755063,27.935063432858726,7.927107061503426,40.58827837330838,26.577479885047968,32.83424174164366,4964451951
1528983000,47.91,48.06,47.42,47.75,40.69217391304349,48.24960512820513,54.48,38.42,54.48,38.42,32.9575,39.04,25.1025,21.64,43.21885,44.66369999999998,43.71199999999997,45.78300000000002,44.754458852464516,46.002827764864705,46.274615384615394,49.30495037888827,43.24428039034252,43.21885,44.66369999999998,43.71199999999997,45.78300000000002,47.74333333333334,2214764,3015091,63.8282020892271,2.3438808578289647,1.5,2.75,NaN,NaN,1.0969832776577673,0.7345595870904063,851.0816534687544,0.17232093121905567,1.1364336515993259,0.9641127203802702,22.363393873250036,5.478241661144239,72.35909751828598,6.298653050635538,21.342249431078507,4966666715
1529069400,47.33,47.74,46.64,47.56,40.760869565217405,48.339910256410256,54.48,38.42,54.48,38.42,32.9575,39.04,25.1025,21.64,43.28135,44.61229999999998,43.82119999999997,45.92850000000003,44.8644800739365,46.15112988249664,46.61384615384616,49.10922697524136,44.11846533245096,43.28135,44.61229999999998,43.82119999999997,45.92850000000003,47.31333333333333,2356259,2925163.55,62.35228351746142,1.4888477703511376,1.5,2.75,NaN,NaN,1.0979130435393551,0.8055135925647645,849.9564294767164,0.1237775686314031,1.118834681169524,0.9950571125381209,18.17398630138005,3.593988237856689,43.646641096541934,23.998601047713695,32.354757855744374,4964310456
1529328600,46.7,47.32,46.4167,47.23,40.82956521739131,48.43021538461539,54.48,38.42,54.48,38.42,32.9575,39.04,25.1025,21.64,43.3395,44.558399999999985,43.97899999999997,46.07450000000002,44.95724556123311,46.25387941749696,46.799230769230775,49.08312031981985,44.5153412186417,43.3395,44.558399999999985,43.97899999999997,46.07450000000002,46.9889,2556682,2967675.4,59.76729619365265,0.7390113326227636,1.5,2.75,NaN,NaN,1.10115496900083,0.8615099885924182,851.5528857292869,0.05673132990711971,1.0659712749220205,1.0092399450149008,18.31971236648372,2.6515974788089522,19.085618993595787,50.02987163456875,30.884509371835456,4961753774
1529415000,45.94,46.82,45.69,46.69,40.89826086956523,48.52052051282052,47.93,38.42,54.48,38.42,32.9575,39.04,25.1025,21.64,43.391949999999994,44.49839999999998,44.11699999999997,46.145000000000024,45.025196715694555,46.29541471106868,47.01384615384617,48.57885858361324,45.448833724079094,43.391949999999994,44.49839999999998,44.11699999999997,46.145000000000024,46.4,3410864,2963258.15,55.69807983965226,0.8694661102821509,1.5,2.75,NaN,NaN,1.132501042643628,1.1510519257324914,851.0031265276484,-0.03192849007487819,0.969329332421303,1.0012578224961812,20.090317964959937,-1.01759592961629,3.4809983617196605,79.8551197232766,16.66388191500374,4958342910
1529501400,47.06,47.3,46.7352,46.96,40.96695652173914,48.61082564102564,47.93,38.42,54.48,38.42,32.9575,39.04,25.1025,21.64,43.444799999999994,44.42319999999999,44.22039999999997,46.24800000000003,45.10107135429477,46.35870854810976,47.14384615384617,48.34670271442413,45.940989593268206,43.444799999999994,44.42319999999999,44.22039999999997,46.24800000000003,46.998400000000004,2782914,2981296.2,57.26478666690211,0.5025490435498358,1.5,2.75,NaN,NaN,1.0951795395976545,0.9334577355983615,853.9311242618871,-0.07772251061803881,0.9041046842236327,0.9818271948416715,14.021230444874,-0.27606710554258346,18.955035598031984,50.21071436911563,30.834250032852392,4961125824
1529587800,46.93,46.93,45.76,46.05,41.03565217391306,48.70113076923077,47.93,38.42,54.48,38.42,32.9575,39.04,25.1025,21.64,43.49704999999999,44.34959999999999,44.31999999999997,46.28650000000003,45.138284242361635,46.32930773400407,47.154615384615404,48.31484388690053,45.994386882330275,43.49704999999999,44.34959999999999,44.31999999999997,46.28650000000003,46.24666666666667,3239094,2992772.8,50.75048728384474,1.290469207943817,1.5,2.75,NaN,NaN,1.1026667153406795,1.082305345731557,850.8209960979265,-0.16937617827506468,0.7701069719978406,0.9394831502729053,17.827844385705273,-3.0322173089071485,4.632610010695035,76.54618080868894,18.821209180616027,4957886730
1529674200,46.74,46.78,46.15,46.25,41.104347826086965,48.791435897435896,47.93,38.42,54.48,38.42,32.9575,39.04,25.1025,21.64,43.54869999999999,44.29499999999999,44.40279999999997,46.34800000000003,45.18188093873961,46.32175461647987,47.17307692307694,48.26552328480572,46.080630561348165,43.54869999999999,44.29499999999999,44.40279999999997,46.34800000000003,46.39333333333334,1848474,2924222,52.04175599138508,0.5552449557958457,1.5,2.75,NaN,NaN,1.076047664244917,0.6321250575366713,853.804433863475,-0.2137454981758019,0.6723012775531529,0.8860467757289548,17.065375890314794,-3.0398322851153097,14.827249449086594,56.29633697705881,28.876413573854606,4959735204
1529933400,45.6,45.68,43.43,44.4,41.17304347826088,48.88174102564103,47.93,38.42,54.48,38.42,32.9575,39.04,25.1025,21.64,43.59104999999999,44.22059999999998,44.456199999999974,46.33550000000003,45.15121894114198,46.13873036729131,46.96000000000002,48.79792525168172,45.122074748318326,43.59104999999999,44.22059999999998,44.456199999999974,46.33550000000003,44.50333333333332,7442922,3197787.05,41.26431320629462,5.049500975312091,1.5,2.75,NaN,NaN,1.200615688227423,2.3275227160607836,849.4055703738904,-0.356491033486513,0.44043298387081364,0.7969240173573267,27.024438555848604,-7.364907156269562,8.381170586635251,67.82817557416062,23.790653839204126,4952292282
1530019800,44.69,45.13,44.26,44.65,41.241739130434794,48.97204615384616,47.93,38.42,54.48,38.42,32.9575,39.04,25.1025,21.64,43.635499999999986,44.15079999999998,44.49459999999997,46.41050000000003,45.13156329639131,45.996946522787375,46.772307692307706,48.9799608680531,44.564654516562314,43.635499999999986,44.15079999999998,44.49459999999997,46.41050000000003,44.68,2967556,3070070.2,42.982709483465115,3.15537301524332,1.5,2.75,NaN,NaN,1.1770002819254646,0.9666085159876799,851.9140465707455,-0.41858430872226204,0.2736936314544991,0.6922779401767611,27.158228123629975,-5.761924862811321,24.543170561704997,43.03024466116337,32.426584777131616,4955259838
1530106200,44.96,45.759,43.47,43.52,41.31043478260871,49.06235128205128,47.93,38.42,54.48,38.42,32.9575,39.04,25.1025,21.64,43.66869999999999,44.10329999999998,44.48319999999997,46.34550000000003,45.06836473574852,45.76104685395048,46.46692307692309,49.223156678895,43.710689474951174,43.66869999999999,44.10329999999998,44.48319999999997,46.34550000000003,44.24966666666666,4772500,3115940.75,37.62454926232634,3.9211590462690937,1.5,2.75,NaN,NaN,1.256428833216503,1.5316401635685788,848.4873025976093,-0.513985615502721,0.049795920798359816,0.5637815363010809,29.13097070613655,-8.85863874345549,7.552965315589883,69.57366469067017,22.873369993739935,4950487338
1530192600,43.47,44.7,43.11,44.34,43.11,49.15265641025641,47.93,38.42,54.48,38.42,32.9575,39.04,25.1025,21.64,43.70404999999999,44.12329999999998,44.486599999999974,46.36750000000003,45.03980141277799,45.62570905833615,46.20846153846155,49.08138924543008,43.33553383149302,43.70404999999999,44.12329999999998,44.486599999999974,46.36750000000003,44.050000000000004,3977467,3113964.7,43.161662046218105,3.3253921850184076,1.5,2.75,NaN,NaN,1.2802553451296101,1.2772999642545722,850.788441032219,-0.4996467353962049,-0.06077688294417527,0.43886985245202964,31.88924130325144,-6.7703952901597955,24.774642451070935,42.751799947761334,32.473557601167734,4954464805
1530279000,44.88,45.61,44.4,44.54,43.223076923076924,49.24296153846154,47.93,38.42,54.48,38.42,32.9575,39.04,25.1025,21.64,43.74004999999999,44.121799999999986,44.50839999999997,46.33100000000003,45.02020135737493,45.52230819563747,45.94769230769232,48.76306935686248,43.13231525852216,43.74004999999999,44.121799999999986,44.50839999999997,46.33100000000003,44.84999999999999,3857851,3086847.8,44.4567573538394,1.198560962545087,1.5,2.75,NaN,NaN,1.2795228204774947,1.249770396843019,852.8504712220894,-0.45570465554755535,-0.13076096698241457,0.3249436885651408,32.58513722744251,-5.69553250052932,30.895191509281062,35.88218856103623,33.22261992968271,4958322656
1530538200,43.58,44.8,43.45,44.67,43.33615384615385,49.33326666666667,47.93,38.42,54.48,38.42,32.9575,39.04,25.1025,21.64,43.7769,44.129299999999986,44.55539999999997,46.26900000000003,45.00646797081121,45.44113598652914,45.73923076923078,48.50031708319057,42.978144455270986,43.7769,44.129299999999986,44.55539999999997,46.26900000000003,44.30666666666667,4088414,3156808.85,45.32875905396017,2.183110316811762,1.5,2.75,NaN,NaN,1.284556904729102,1.2951097751769163,854.3504712220894,-0.39893997342399434,-0.17373127821485213,0.2252086952091422,33.02936030385402,-4.326408224459191,69.5492607613751,7.583235761637152,22.86750347698774,4962411070
1530624600,45.21,45.25,44,44.17,43.449230769230766,49.4235717948718,47.93,38.42,54.48,38.42,32.9575,39.04,25.1025,21.64,43.810649999999995,44.180599999999984,44.592999999999975,46.17700000000003,44.9736653052892,45.32007541638351,45.46384615384616,48.07801510208589,42.84967720560643,43.810649999999995,44.180599999999984,44.592999999999975,46.17700000000003,44.473333333333336,1803409,3119977,42.561113811615506,2.3611055848675058,1.5,2.75,NaN,NaN,1.282088554391309,0.5780199661728276,857.1018664024654,-0.37640989435415273,-0.2453036727335487,0.131106221620604,33.01373763021915,-5.941226575809197,52.78866897966773,17.20389226051105,30.007438759821213,4960607661
1530797400,44.85,45.34,44.25,45.26,43.56230769230769,49.51387692307693,47.93,38.42,54.48,38.42,32.9575,39.04,25.1025,21.64,43.84875,44.22489999999999,44.68539999999998,46.08150000000003,44.98489411684649,45.31435394815651,45.28692307692308,47.6041413643781,42.96970478946806,43.84875,44.22489999999999,44.68539999999998,46.08150000000003,44.949999999999996,2870385,3101026.15,49.762350424013384,0.4255247967170881,1.5,2.75,NaN,NaN,1.2740822290776441,0.9256242486055786,860.9575980667111,-0.2741904654587177,-0.21163186020279312,0.06255860525592458,36.84321865414853,-1.7155266015200852,87.50769825674692,1.414415769128971,11.077885974124115,4963478046
1530883800,45.3,46.62,45.071,46.37,43.675384615384615,49.60418205128205,47.93,38.42,54.48,38.42,32.9575,39.04,25.1025,21.64,43.891850000000005,44.264299999999984,44.79539999999998,46.045500000000025,45.03921199461722,45.4148916673797,45.22076923076923,47.35413005406351,43.087408407474946,43.891850000000005,44.264299999999984,44.79539999999998,46.045500000000025,46.02033333333333,4121715,3169827.7,55.83478180136002,2.38413829552798,1.5,2.75,NaN,NaN,1.293719212714955,1.3002962274574104,864.404819169764,-0.12548051849399966,-0.094292042861575,0.03118847563242466,38.46820322598034,0.2594594594594539,87.77387900364852,1.3573832777138004,10.868737718637684,4967599761
1531143000,47,47.69,46.98,47.68,43.78846153846154,49.69448717948718,47.93,38.42,54.48,38.42,32.9575,39.04,25.1025,21.64,43.941100000000006,44.31299999999998,44.90699999999998,46.05500000000002,45.142772308553795,45.63061627048639,45.29692307692307,47.68955773179957,42.90428842204658,43.941100000000006,44.31299999999998,44.90699999999998,46.05500000000002,47.449999999999996,3152189,3221632.85,61.71619156399666,3.9876293603961783,1.5,2.75,NaN,NaN,1.2955964118067438,0.9784445176612847,867.0264372494873,0.05762269162139662,0.10321684015917043,0.04559414853777381,41.52283268348503,7.38738738738739,87.97840733662477,1.305306519917592,10.716286143457635,4970751950
1531229400,47.93,48.239,47.76,48.14,43.90153846153846,49.784792307692314,47.93,38.42,54.48,38.42,32.9575,39.04,25.1025,21.64,43.99425,44.34919999999998,45.02579999999998,46.07700000000002,45.260310649394825,45.869605197106736,45.3876923076923,48.094687847413596,42.680696767971,43.99425,44.34919999999998,45.02579999999998,46.07700000000002,48.04633333333334,2952411,3266974.85,63.55167251475641,4.293458722675291,1.5,2.75,NaN,NaN,1.2429823823919761,0.9037140276730321,866.3255606054369,0.19830801191835667,0.29347916343571967,0.09517115151736298,30.735278797001115,7.816349384098549,87.20617779943946,1.4703265063574458,11.32349569420309,4973704361
1531315800,47.25,47.73,46.9301,47.17,44.01461538461538,49.87509743589744,47.93,38.42,54.48,38.42,32.9575,39.04,25.1025,21.64,44.04255,44.35899999999999,45.14479999999999,46.03900000000002,45.33520042784993,45.99345232119181,45.47384615384614,48.32701754411496,42.62067476357732,44.04255,44.35899999999999,45.14479999999999,46.03900000000002,47.276700000000005,3519485,3327620.95,57.3117784273087,2.333497702753524,1.5,2.75,NaN,NaN,1.2406193550782632,1.0576580244213212,863.0818948517922,0.2133204203547619,0.36182167696081535,0.14850125660605346,34.82943397319635,8.386948529411761,74.4129532001823,5.44956454599958,20.13748225381811,4970184876
1531402200,47.83,48.42,47.5,48.36,44.12769230769231,49.96540256410257,47.93,38.42,54.48,38.42,32.9575,39.04,25.1025,21.64,44.09785000000001,44.38059999999999,45.28319999999999,46.08800000000002,45.453820018914634,46.218837814411636,45.63615384615384,48.8630555605784,42.409252131729275,44.09785000000001,44.38059999999999,45.28319999999999,46.08800000000002,48.093333333333334,3730327,3383284.1,62.21348174053748,3.6063849662785823,1.5,2.75,NaN,NaN,1.2412894011441014,1.1025757488116354,865.4891488464657,0.28613646052667707,0.5061718322643998,0.22003537173772272,30.066037765550398,9.066305818673873,76.18692038820133,4.763238272460286,19.049841339338375,4973915203
1531488600,48.29,48.67,48.01,48.45,44.24076923076923,50.05570769230769,47.93,38.42,54.48,38.42,32.9575,39.04,25.1025,21.64,44.15335000000001,44.411399999999986,45.44099999999999,46.123000000000026,45.57131727307485,46.43132945113434,45.9476923076923,49.41045380103303,42.48493081435157,44.15335000000001,44.411399999999986,45.44099999999999,46.123000000000026,48.376666666666665,2325286,3388810.2,62.56359880875682,3.5478951154246445,1.5,2.75,NaN,NaN,1.1997687296338087,0.6861658997603347,864.9599985842527,0.3205139670069342,0.6206778304963905,0.3001638634894563,29.951951079673517,8.778625954198482,73.31642742635931,5.894690235649292,20.78888233799139,4976240489
1531747800,48.52,48.582,48.0901,48.35,44.35384615384615,50.14601282051282,47.93,38.42,54.48,38.42,32.9575,39.04,25.1025,21.64,44.20640000000001,44.44869999999999,45.60199999999998,46.16250000000002,45.68028522315034,46.614059979597734,46.23230769230769,49.82733976744997,42.637275617165415,44.20640000000001,44.44869999999999,45.60199999999998,46.16250000000002,48.3407,1436151,3342804.8,61.877555194119395,2.7848230507022524,1.5,2.75,NaN,NaN,1.1492066775171081,0.4296245476253953,861.857185186642,0.3161409472620925,0.6953400475670719,0.3791991003049794,30.532012589406424,8.238191179762705,54.67686236814435,15.868356588628805,29.45478104322685,4974804338
1531834200,47.9,49.159,47.88,48.93,44.466923076923074,50.236317948717954,47.93,38.42,54.48,38.42,32.9575,39.04,25.1025,21.64,44.26165000000002,44.48959999999999,45.74359999999998,46.24750000000002,45.807725018320916,46.834625695826524,46.64846153846153,50.14234054789279,43.15458252903027,44.26165000000002,44.48959999999999,45.74359999999998,46.24750000000002,48.65633333333333,3225267,3376234.05,64.3212781517314,3.504709493969338,1.5,2.75,NaN,NaN,1.1584776291230288,0.9552853718775807,863.7616494491012,0.3303845515513735,0.7921797897441962,0.46179523819282275,30.398278098533293,10.77654516640253,55.855015260784135,15.102166899094703,29.042817840121174,4978029605
1531920600,48.98,49.29,48.71,49.22,44.58,50.32662307692308,47.93,38.42,54.48,38.42,32.9575,39.04,25.1025,21.64,44.316600000000015,44.512,45.882999999999974,46.374000000000024,45.9415397234848,47.061804200985904,47.02384615384615,50.49350841594282,43.55418389174948,44.316600000000015,44.512,45.882999999999974,46.374000000000024,49.07333333333333,2005376,3305959.65,65.51169154993664,3.3676435894234045,1.5,2.75,NaN,NaN,1.1171577984713836,0.6065942153891685,865.3228989487009,0.3362898861179797,0.8821575958402974,0.5458677097223177,27.670500634169276,8.749447635881577,87.59390501193661,1.3864016543930089,11.019693333670384,4980034981
1532007000,48.81,49.04,48.38,48.64,44.69307692307692,50.41692820512821,47.93,38.42,54.48,38.42,32.9575,39.04,25.1025,21.64,44.366000000000014,44.5122,46.01059999999997,46.45800000000002,46.04736169511285,47.21210856279677,47.33923076923077,50.58670042599395,44.09176111246758,44.366000000000014,44.5122,46.01059999999997,46.45800000000002,48.68666666666667,2648307,3299229.3,61.119483789005436,2.1964683927217976,1.5,2.75,NaN,NaN,1.0973608128662844,0.8027047407708219,868.0236613682889,0.2803715471691802,0.896332143683793,0.6159605965146128,28.955831509765883,4.895406512831579,54.92648217297428,15.704445575214072,29.369072251811644,4977386674
1532093400,48.54,48.89,48.39,48.51,44.80615384615385,50.50723333333334,47.93,38.42,54.48,38.42,32.9575,39.04,25.1025,21.64,44.41345000000001,44.529500000000006,46.111399999999975,46.581000000000024,46.143935746284896,47.33571727110184,47.63461538461539,50.53746931596391,44.73176145326686,44.41345000000001,44.529500000000006,46.111399999999975,46.581000000000024,48.596666666666664,2139152,3244232.2,60.14612764309847,1.6009392666179443,1.5,2.75,NaN,NaN,1.0546921833758354,0.6593708058257975,866.9710865875419,0.21671358436150168,0.8868525769664899,0.6701389926049882,27.236350701600504,1.7407718120805333,28.194796533753845,38.751678973967536,33.05352449227862,4975247522
1532352600,48.35,48.86,48.1585,48.77,44.919230769230765,50.59753846153846,47.93,38.42,54.48,38.42,32.9575,39.04,25.1025,21.64,44.46165000000002,44.564900000000016,46.19239999999998,46.70700000000002,46.24691865819529,47.472315626235,47.98846153846154,50.13996685984213,45.83695621708095,44.46165000000002,44.564900000000016,46.19239999999998,46.70700000000002,48.596166666666676,1643644,3233990.7,61.46781993739088,1.6229929841092279,1.5,2.75,NaN,NaN,1.0294641702775615,0.5082401752113882,865.3185024042826,0.1759365856541606,0.8900597246726889,0.7141231390185283,22.90428392283253,1.3086830078936489,46.310583959984726,21.867710691857614,31.821705348157646,4976891166
1532439000,49.52,49.96,48.95,49.41,45.03230769230769,50.68784358974359,47.93,38.42,54.48,38.42,32.9575,39.04,25.1025,21.64,44.50960000000002,44.625200000000014,46.281199999999984,46.957500000000024,46.37096106375626,47.656856995165,48.30769230769231,49.90534739410737,46.71003722127724,44.50960000000002,44.625200000000014,46.281199999999984,46.957500000000024,49.44,3432161,3033452.65,64.581548244157,2.583471204148093,1.5,2.75,NaN,NaN,1.0409310152577356,1.1314371430851244,863.9729147777766,0.17548824680370445,0.9334834475231588,0.7579952007194544,23.385859053624184,4.748781004875969,47.511389248114085,20.944614517624014,31.543996234261908,4980323327
1532525400,49.33,50.9146,49.32,50.78,45.145384615384614,50.778148717948724,47.93,38.42,54.48,38.42,32.9575,39.04,25.1025,21.64,44.56505000000002,44.692400000000006,46.39459999999998,47.264000000000024,46.543864551452096,47.954299186101665,48.64692307692307,50.325500947812316,46.96834520603383,44.56505000000002,44.692400000000006,46.39459999999998,47.264000000000024,50.3382,3663772,3068263.45,70.14343617543202,3.546491512917755,1.5,2.75,NaN,NaN,1.080478799882183,1.1940865117042019,866.1211126500316,0.24652755469375776,1.0661546440866516,0.8196270893928939,22.247253669136665,5.004135649296943,55.16644323503542,15.547898083854436,29.28565868111013,4983987099
1532611800,50.3,50.78,50.22,50.33,45.25846153846154,50.86845384615385,47.93,38.42,54.48,38.42,32.9575,39.04,25.1025,21.64,44.61910000000002,44.74040000000001,46.51699999999998,47.60450000000002,46.692340451395154,48.18055640647293,48.85076923076924,50.649477511533505,47.05206095000497,44.61910000000002,44.74040000000001,46.51699999999998,47.60450000000002,50.44333333333333,2383919,2948834.4,66.45214507699723,3.278244635375411,1.5,2.75,NaN,NaN,1.0433017427477416,0.8084275603947105,868.3228069128934,0.24193990239571816,1.1220519673875415,0.8801120649918234,20.918658343635563,3.880288957688329,56.44793363682059,14.723896784648305,28.828169578531096,4981603180
1532698200,50.58,50.58,48.76,49.33,45.37153846153846,50.95875897435898,47.93,38.42,54.48,38.42,32.9575,39.04,25.1025,21.64,44.66675000000002,44.774800000000006,46.607799999999976,47.85400000000003,46.79577808075221,48.29002722490408,48.9423076923077,50.707826205748376,47.176789178867025,44.66675000000002,44.774800000000006,46.607799999999976,47.85400000000003,49.55666666666668,3060241,2902973.1,59.019263501920726,1.391882603044642,1.5,2.75,NaN,NaN,1.0987801896943314,1.0541747699970074,865.1449129717761,0.15454008382699036,1.0732871697755613,0.9187470859485709,25.093842036537684,2.0268872802481837,49.97786859790357,19.11504015134637,30.907091250750053,4978542939
1532957400,49.35,49.44,48.21,48.48,45.48461538461538,51.0490641025641,47.93,38.42,54.48,38.42,32.9575,39.04,25.1025,21.64,44.70920000000002,44.801,46.684399999999975,48.05100000000003,46.86182599915408,48.30811987015131,49.04307692307694,50.518107762188905,47.56804608396497,44.70920000000002,44.801,46.684399999999975,48.05100000000003,48.71,2313889,2825775,53.537618958259316,0.5723133899453806,1.5,2.75,NaN,NaN,1.1081530332875933,0.8188511116419389,863.8697595456495,0.02903726815015073,0.9550436711362593,0.9260064029861086,27.385632174591333,-0.9196811771919127,30.47718624868892,36.27901752988986,33.24379622142122,4976229050
1533043800,49.02,49.5973,48.741,49.19,45.597692307692306,51.13936923076923,47.93,38.42,54.48,38.42,32.9575,39.04,25.1025,21.64,44.75615000000003,44.827799999999996,46.78199999999998,48.27700000000003,46.953126940363724,48.39210845394642,49.106923076923096,50.52906414133991,47.68478201250628,44.75615000000003,44.827799999999996,46.78199999999998,48.27700000000003,49.1761,2551079,2748908.25,57.1201841552352,0.7881715034439386,1.5,2.75,NaN,NaN,1.1088063880527652,0.9280335202166169,866.9926397790848,-0.014279329207179337,0.9081572414771344,0.9224365706843137,27.8292116673969,-0.06095083299471991,26.341024381552405,40.859964993195284,32.799010625252286,4978780129
1533130200,49.31,49.65,48.63,49.03,45.71076923076923,51.229674358974364,50.78,38.42,54.48,38.42,32.9575,39.04,25.1025,21.64,44.80165000000002,44.82919999999999,46.85699999999998,48.520000000000024,47.034572942702404,48.45286002976105,49.15153846153847,50.5239668798225,47.77911004325444,44.80165000000002,44.82919999999999,46.85699999999998,48.520000000000024,49.10333333333333,2450805,2781278.05,56.070939440427566,0.4327827013688009,1.5,2.75,NaN,NaN,1.1024630746204245,0.8811794275656833,864.3617523570443,-0.059301291564414105,0.8483099562287961,0.9076112477932102,27.67801586420902,0.8018092105263169,4.638504227292061,76.52554247141926,18.835953301288676,4976329324
1533216600,48.21,49.87,48.07,49.73,45.82384615384615,51.31997948717949,50.78,38.42,54.48,38.42,32.9575,39.04,25.1025,21.64,44.84990000000003,44.83929999999999,46.95359999999998,48.743500000000026,47.14027596455721,48.57449240787904,49.25769230769232,50.57820861338849,47.93717600199614,44.84990000000003,44.83929999999999,46.95359999999998,48.743500000000026,49.223333333333336,2931695,2784343.55,59.57001641987428,1.368633781830658,1.5,2.75,NaN,NaN,1.1522871407189652,1.0529214327736245,866.7861184639696,-0.04801366748107305,0.8475941634418689,0.8956078309229419,27.762461489260435,2.514945372088227,22.330353921837208,45.7238008249628,31.945845253199984,4979261019
1533303000,49.87,50.42,49.74,50.41,45.93692307692307,51.41028461538462,50.78,38.42,54.48,38.42,32.9575,39.04,25.1025,21.64,44.90115000000002,44.86589999999998,47.05619999999997,48.94550000000003,47.26850043653536,48.7493026547477,49.37153846153847,50.809396829525575,47.93368009355137,44.90115000000002,44.86589999999998,47.05619999999997,48.94550000000003,50.19,1928304,2674673,62.67987226965162,2.123361015750924,1.5,2.75,NaN,NaN,1.119266630667611,0.720949439426801,868.9835780947317,-0.0031909218371033443,0.8916191786265628,0.8948101004636662,28.275691780704765,3.3627229854418563,48.8717138774423,19.928101404333994,31.200184718223696,4981189323
1533562200,50.37,51.13,50.188,50.96,46.05,51.50058974358975,50.78,38.42,54.48,38.42,32.9575,39.04,25.1025,21.64,44.95465000000002,44.90529999999998,47.174999999999976,49.10950000000003,47.41326512529868,48.959845259057445,49.50538461538463,51.16823879530199,47.84253043546727,44.95465000000002,44.90529999999998,47.174999999999976,49.10950000000003,50.75933333333334,2344709,2634299,65.0233122447282,2.905648639238615,1.5,2.75,NaN,NaN,1.1066047284770673,0.8900694264394436,871.0819645716352,0.05201228238510058,0.9598254534450419,0.9078131710599413,28.55725225182119,3.1370167982189927,77.07402822405129,4.441655748170618,18.48431602777811,4983534032
1533648600,51.35,51.67,51.2609,51.44,46.16307692307692,51.59089487179487,50.78,38.42,54.48,38.42,32.9575,39.04,25.1025,21.64,45.01025000000002,44.95119999999997,47.31079999999997,49.27450000000003,47.57117629685559,49.19605047248054,49.72076923076925,51.59178642081422,47.849752040724276,45.01025000000002,44.95119999999997,47.31079999999997,49.27450000000003,51.456966666666666,2416908,2607523.85,66.97248292277307,3.4402655164709395,1.5,2.75,NaN,NaN,1.0782758193001338,0.9268977539745226,872.4679850013472,0.10624213077714517,1.0406158345313727,0.9343737037542276,28.227828793300834,1.2997243009058617,77.0237000412328,4.459967856453876,18.516332102313314,4985950940
1533735000,51.34,51.6199,51.1,51.38,46.276153846153846,51.681200000000004,50.78,38.42,54.48,38.42,32.9575,39.04,25.1025,21.64,45.06275000000002,44.995399999999975,47.47539999999997,49.48500000000003,47.720541932273015,49.404045665577634,49.94153846153848,51.86553824010629,48.01753868297067,45.06275000000002,44.995399999999975,47.47539999999997,49.48500000000003,51.36663333333333,1859934,2524546.3,66.47380923634076,2.900578906385384,1.5,2.75,NaN,NaN,1.0383918322072672,0.7367399045127436,871.3580822767938,0.12231539456043783,1.0872679469547748,0.964952552394337,24.050351289077835,2.0862308762169763,81.44605037644453,2.9827671056918335,15.57118251786364,4984091006
1533821400,51.42,51.64,51.07,51.16,46.389230769230764,51.771505128205135,50.78,38.42,54.48,38.42,32.9575,39.04,25.1025,21.64,45.11625000000003,45.05649999999997,47.60219999999997,49.62500000000003,47.85542264081133,49.5712794117131,50.12538461538463,52.02303685530338,48.227732375465884,45.11625000000003,45.05649999999997,47.60219999999997,49.62500000000003,51.29,1871363,2431598.1,64.57517308911494,2.392394766580683,1.5,2.75,NaN,NaN,1.004935272763891,0.7696020983072819,871.9905378088274,0.10314065554263707,1.0938783718226333,0.9907377162799962,23.48385094263984,3.7097101155483445,54.18847512561032,16.206159403532933,29.605365470856743,4982219643
1533907800,50.25,50.5785,49.681,50.1,46.50230769230769,51.86181025641026,50.78,38.42,54.48,38.42,32.9575,39.04,25.1025,21.64,45.16350000000003,45.10479999999997,47.72619999999996,49.707500000000024,47.94344528234814,49.62163375345471,50.17846153846156,52.03117424654618,48.325748830376945,45.16350000000003,45.10479999999997,47.72619999999996,49.707500000000024,50.11983333333333,2915324,2461100,56.24017157163006,0.20980004696476368,1.5,2.75,NaN,NaN,1.0387970389950414,1.1845613749949209,869.2352398818027,0.0090364067164318,1.002033224675536,0.9929968179591041,23.780089880468566,3.341584158415851,23.997259929911312,43.66419562853806,32.338544441550646,4979304319
1534167000,50.24,50.6266,49.35,49.52,46.61538461538461,51.95211538461539,50.78,38.42,54.48,38.42,32.9575,39.04,25.1025,21.64,45.21075000000003,45.14959999999997,47.811199999999964,49.76600000000003,48.005270957550174,49.61195434836379,50.081538461538486,51.930061300561725,48.233015622515246,45.21075000000003,45.14959999999997,47.811199999999964,49.76600000000003,49.8322,3367613,2557673.1,52.26498304886274,0.6790697014946758,1.5,2.75,NaN,NaN,1.0557829647811101,1.3166706097037968,866.5579013539134,-0.09648722417478084,0.8723877877406281,0.9688750119154089,22.29414677745875,0.6708680626143635,4.298649372666619,77.50680626139047,18.194544365942907,4975936706
1534253400,49.98,50.609,49.74,50.45,46.72846153846154,52.04242051282052,51.44,38.42,54.48,38.42,32.9575,39.04,25.1025,21.64,45.262000000000036,45.23719999999997,47.90199999999996,49.84200000000003,48.10114268470507,49.69176821994819,50.090769230769254,51.9453512743071,48.23618718723141,45.262000000000036,45.23719999999997,47.90199999999996,49.84200000000003,50.266333333333336,2305718,2511695.65,57.457455415236,0.7593704638388692,1.5,2.75,NaN,NaN,1.0581556101538878,0.9179925919766593,870.2440414578675,-0.10705199314737768,0.8350600204811869,0.9421120136285646,23.223419808655766,2.8961860085661875,3.8284280145658958,78.85254990533979,17.319022080094328,4978242424
1534339800,49.67,49.719,48.477,49.36,46.841538461538455,52.132725641025644,51.44,38.42,54.48,38.42,32.9575,39.04,25.1025,21.64,45.30305000000004,45.34149999999997,47.96899999999996,49.849000000000025,48.15050963824604,49.66017124661979,50.09307692307694,51.94393758965901,48.24221625649488,45.30305000000004,45.34149999999997,47.96899999999996,49.849000000000025,49.185333333333325,4299872,2626420.45,50.52100442756369,1.7131413408019789,1.5,2.75,NaN,NaN,1.123501638000039,1.6371605696262377,867.073624073397,-0.18621225224615456,0.7093466983208714,0.895558950567026,27.042508048231795,-0.7440176955559973,2.6451686311732714,82.61908541570354,14.735745953123184,4973942552
1534426200,50.16,51.03,50.16,50.51,46.95461538461538,52.223030769230775,51.44,38.42,54.48,38.42,32.9575,39.04,25.1025,21.64,45.351950000000045,45.42469999999997,48.035799999999966,49.942500000000024,48.24303867204031,49.74110731837028,50.249230769230785,51.855783917356135,48.642677621105435,45.351950000000045,45.42469999999997,48.035799999999966,49.942500000000024,50.566666666666656,3018989,2644954.55,56.4892118581588,1.1043276595619582,1.5,2.75,NaN,NaN,1.1625372352857508,1.141414320333028,870.6691668596711,-0.16084114171115726,0.6945075234280793,0.8553486651392366,29.05777096126363,0.19837333862329187,13.845091351963864,57.92621707263909,28.228691575397047,4976961541
1534512600,50.33,51.3,50.14,51,47.067692307692305,52.313335897435906,51.44,38.42,54.48,38.42,32.9575,39.04,25.1025,21.64,45.402600000000035,45.53549999999998,48.11399999999996,50.06700000000002,48.351154802548535,49.861001859477874,50.388461538461556,51.91544642386045,48.86147665306266,45.402600000000035,45.53549999999998,48.11399999999996,50.06700000000002,50.81333333333333,3372106,2706602.25,58.77116648432331,1.5412291048409033,1.5,2.75,NaN,NaN,1.1623560041939112,1.2458816215053394,873.8755202017696,-0.11303485795976742,0.7140550926895273,0.8270899506492947,28.547306122861343,0.0784929356357911,36.92396081346198,29.935839854790455,33.14019933174756,4980333647
1534771800,51.3,51.5139,51.035,51.34,47.18076923076923,52.40364102564103,51.44,38.42,54.48,38.42,32.9575,39.04,25.1025,21.64,45.45395000000004,45.652499999999975,48.19099999999997,50.19550000000002,48.46836441813487,50.00185882524189,50.56615384615387,51.95040679017015,49.181900902137585,45.45395000000004,45.652499999999975,48.19099999999997,50.19550000000002,51.2963,2516820,2750261.05,60.32599886470142,2.065398592028469,1.5,2.75,NaN,NaN,1.1160377181800603,0.9151204028432138,877.0891011955737,-0.06298774693501019,0.748355266980532,0.8113430139155422,28.124913785739178,-0.19440124416795163,66.00645508311052,9.265182150261218,24.72836276662826,4982850467
1534858200,51.68,52.2336,51.585,51.66,47.29384615384615,52.49394615384616,51.44,38.42,54.48,38.42,32.9575,39.04,25.1025,21.64,45.50675000000004,45.75619999999997,48.27019999999997,50.30800000000002,48.59352659781585,50.15977703236171,50.7146153846154,52.122103389966455,49.307127379264344,45.50675000000004,45.75619999999997,48.27019999999997,50.30800000000002,51.8262,2456264,2701466.2,61.78667230422338,2.566295567575913,1.5,2.75,NaN,NaN,1.1001493097386272,0.9092336598547854,879.5040546112734,-0.015292472506179933,0.7922274232828173,0.8075198957889972,27.827544681014004,0.5449591280653835,66.52823231940606,9.001574214442742,24.470193466151194,4985306731
1534944600,51.44,51.91,51.29,51.61,47.40692307692307,52.584251282051284,51.44,38.42,54.48,38.42,32.9575,39.04,25.1025,21.64,45.55750000000005,45.888099999999966,48.34379999999997,50.34950000000002,48.71181967241131,50.29789350547012,50.8069230769231,52.27834070033435,49.33550545351185,45.55750000000005,45.888099999999966,48.34379999999997,50.34950000000002,51.60333333333333,2035366,2620045.9,61.40625135385914,1.9045684392305313,1.5,2.75,NaN,NaN,1.0658529304715822,0.7768436423193961,880.4273985897365,0.004850770234368862,0.8135833585819583,0.8087325883475894,27.823622470582457,0.879593432369044,82.29177778600724,2.727472113387152,14.980750100605608,4983271365
1535031000,51.5,52,51.19,51.37,47.519999999999996,52.674556410256415,51.44,38.42,54.48,38.42,32.9575,39.04,25.1025,21.64,45.60620000000005,46.00249999999996,48.42359999999997,50.40150000000001,48.8160620381991,50.39999888590154,50.83846153846155,52.3389403575025,49.3379827194206,45.60620000000005,46.00249999999996,48.42359999999997,50.40150000000001,51.52,2147217,2608210.8,59.51215859272142,1.4036657039310367,1.5,2.75,NaN,NaN,1.0475777211521837,0.8232528597765181,878.8362206820976,-0.005467420797266032,0.8018983123510068,0.8073657331482729,27.847422222794982,2.534930139720551,56.742585430171594,14.53778418078922,28.71963038903918,4981124148
1535117400,51.74,52.37,51.69,52.25,47.63307692307692,52.764861538461545,51.44,38.42,54.48,38.42,32.9575,39.04,25.1025,21.64,45.65945000000005,46.112799999999964,48.51359999999997,50.54750000000001,48.950726271995215,50.57618946819663,50.90076923076925,52.55534724415117,49.24619121738733,45.65945000000005,46.112799999999964,48.51359999999997,50.54750000000001,52.10333333333333,2470212,2578709.35,63.90812366181163,2.3980393232044457,1.5,2.75,NaN,NaN,1.0441793124984564,0.9579257158236929,881.51761461394,0.03715089307633601,0.8538043494936929,0.8166534564173569,25.631094842993942,5.5129240710823835,53.22001054845219,16.842479704733385,29.93750974681442,4983594360
1535376600,53,53.59,52.94,53.48,47.746153846153845,52.85516666666667,51.44,38.42,54.48,38.42,32.9575,39.04,25.1025,21.64,45.717800000000054,46.226599999999955,48.63199999999997,50.7975,49.12834484956403,50.852742852177904,51.06230769230771,53.20927913844586,48.915336246169566,45.717800000000054,46.226599999999955,48.63199999999997,50.7975,53.336666666666666,3018998,2613964.8,68.97809190642823,3.923282691729743,1.5,2.75,NaN,NaN,1.0653093616057097,1.1549497529576527,883.9320023816118,0.13296616817335616,0.9828611666340521,0.8498949984606959,25.563510421879574,6.005946481665004,56.7643196569083,14.531480337848926,28.70420000524277,4986613358
1535463000,53.84,53.88,53.32,53.63,47.85923076923076,52.9454717948718,51.44,38.42,54.48,38.42,32.9575,39.04,25.1025,21.64,45.77925000000005,46.36949999999995,48.75999999999997,51.01950000000001,49.304880345659555,51.11724353292286,51.25230769230772,53.800008361190315,48.70460702342512,45.77925000000005,46.36949999999995,48.75999999999997,51.01950000000001,53.61000000000001,2224819,2597651.8,69.54003966455824,3.5913367293969642,1.5,2.75,NaN,NaN,1.0292158357767305,0.856473142397299,882.998498995743,0.1878753392043524,1.0847391724661364,0.896863833261784,24.690927384061737,8.650729335494335,56.16200766334,14.913562353473315,28.924429983186677,4988838177
1535549400,53.73,54.608,53.58,54.45,47.97230769230769,54.608,51.44,38.42,54.48,38.42,32.9575,39.04,25.1025,21.64,45.84520000000005,46.51609999999995,48.91519999999997,51.29050000000001,49.506649743868984,51.43464891073973,51.5869230769231,54.55012700422761,48.62371914961859,45.84520000000005,46.51609999999995,48.91519999999997,51.29050000000001,54.21266666666666,2129965,2581609.8,72.47536523380998,4.386510859080697,1.5,2.75,NaN,NaN,1.0291289903641068,0.8250530347382475,884.9013692048429,0.25659655606766507,1.2176095283463653,0.9610129722787002,17.445915515596695,7.800435557315392,80.1323167732077,3.391544841816955,16.476138384975343,4990968142
1535635800,54.14,54.38,53.42,53.75,48.08538461538461,54.72742037037037,51.44,38.42,54.48,38.42,32.9575,39.04,25.1025,21.64,45.90710000000004,46.63569999999995,49.050999999999966,51.49150000000001,49.67305563626628,51.655158538288326,51.91230769230772,54.824733631635794,48.99988175297965,45.90710000000004,46.63569999999995,49.050999999999966,51.49150000000001,53.849999999999994,2677891,2568919.6,66.57714502361502,2.8505826280824227,1.5,2.75,NaN,NaN,1.0291912053380992,1.0424191555080198,882.3750846165318,0.23278473147219803,1.2519938866189477,1.0192091551467497,19.553592018542997,5.392156862745098,74.60575586966372,5.376924301648082,20.01731982868818,4988290251
1535722200,53.51,54.05,53.19,53.75,48.19846153846154,54.84684074074074,51.44,38.42,54.48,38.42,32.9575,39.04,25.1025,21.64,45.970350000000046,46.76249999999995,49.20499999999996,51.658500000000004,49.83293580739309,51.854667248927534,52.16615384615387,55.09968979038477,49.232617901922964,45.970350000000046,46.76249999999995,49.20499999999996,51.658500000000004,53.66333333333334,2799298,2612469.3,66.57714502361502,2.1226477897406566,1.5,2.75,NaN,NaN,1.0171061192425206,1.07151421836804,883.6445375661785,0.1963650455275776,1.2646654620562217,1.068300416528644,19.716434144482193,4.694195559018302,67.46806705933051,8.540789607001171,23.99114333366832,4988290251
1536067800,53.51,53.69,52.85,53.5,48.311538461538454,54.96626111111111,51.44,38.42,54.48,38.42,32.9575,39.04,25.1025,21.64,46.03555000000005,46.87639999999996,49.349999999999966,51.7855,49.97674224631885,52.01136560617253,52.48461538461541,54.99946501015036,49.96976575908046,46.03555000000005,46.87639999999996,49.349999999999966,51.7855,53.346666666666664,2390166,2614742.15,64.40609962450108,1.4116135686623943,1.5,2.75,NaN,NaN,1.0087413964394834,0.9141115501580147,880.7168373473329,0.13755020484833214,1.2402381725890592,1.102687967740727,20.475283975520966,3.561749903213325,28.447787068847187,38.47203013219208,33.08018279896072,4985900085
1536154200,53.25,53.36,52.4016,53.09,48.42461538461538,55.08568148148148,51.44,38.42,54.48,38.42,32.9575,39.04,25.1025,21.64,46.093700000000055,46.98999999999997,49.523799999999966,51.867999999999995,50.09883078567889,52.11409269129896,52.683076923076946,54.93695405596985,50.42919979018404,46.093700000000055,46.98999999999997,49.523799999999966,51.867999999999995,52.95053333333333,2584490,2623121.25,60.8987378787824,0.5634550698735155,1.5,2.75,NaN,NaN,1.0151455824080915,0.9852727928607952,879.1757338465907,0.05725735523176989,1.1742596617804395,1.1170023065486696,21.483140226409503,2.8676613059484675,5.829251384099713,73.47641375994434,20.694334855955965,4983315595
1536240600,53.1,53.27,51.91,52.6,48.5376923076923,55.20510185185185,54.45,38.42,54.48,38.42,32.9575,39.04,25.1025,21.64,46.15105000000006,47.088699999999974,49.68279999999996,51.92899999999999,50.19691585290717,52.16036957784191,52.806153846153876,54.84327909756598,50.76902859474177,46.15105000000006,47.088699999999974,49.68279999999996,51.92899999999999,52.593333333333334,2514527,2655850.9,56.90996947706006,0.31978641173707,1.5,2.75,NaN,NaN,1.0397780408075141,0.9467877131204918,876.999970772603,-0.0375243246339374,1.0700969007562477,1.1076212253901851,22.507787339687077,2.394393614950368,0,100,0,4980801068
1536327000,51.86,52.8122,51.7287,52.19,48.65076923076923,55.32452222222222,54.45,38.42,54.48,38.42,32.9575,39.04,25.1025,21.64,46.20560000000006,47.16969999999996,49.856199999999966,51.980499999999985,50.27507601553826,52.16319152280935,52.871538461538485,54.765786372433205,50.977290550643765,46.20560000000006,47.16969999999996,49.856199999999966,51.980499999999985,52.243633333333335,2650631,2694814.3,53.7383069677674,0.7791796807588253,1.5,2.75,NaN,NaN,1.0429010378926913,0.9836043247952188,874.104697262958,-0.13122777169501942,0.9435865107714108,1.0748142824664302,22.913844656471525,-0.11483253588517181,0,100,0,4978150437
1536586200,52.83,52.99,52.37,52.49,48.763846153846146,55.44394259259259,54.45,38.42,54.48,38.42,32.9575,39.04,25.1025,21.64,46.25755000000006,47.25289999999996,50.019199999999955,52.09999999999999,50.3619357796348,52.19431613968465,52.93538461538464,54.71443562230016,51.156333608469126,46.25755000000006,47.25289999999996,50.019199999999955,52.09999999999999,52.61666666666667,1730490,2635572.6,55.68445895168206,0.07922856031709918,1.5,2.75,NaN,NaN,1.0255509637574993,0.6565897672483012,876.3828063520707,-0.17373367784357718,0.8576471851619587,1.0313808630055359,20.978977350097153,-1.8511593118922867,2.232503045257621,84.09819367886642,13.669303275875958,4979880927
1536672600,52.09,53.28,51.861,53.05,48.87692307692307,55.56336296296296,54.45,38.42,54.48,38.42,32.9575,39.04,25.1025,21.64,46.31275000000005,47.348899999999965,50.18939999999996,52.276499999999984,50.46735006278637,52.275809840667065,53.046153846153864,54.65222958843405,51.44007810387368,46.31275000000005,47.348899999999965,50.18939999999996,52.276499999999984,52.73033333333333,1957009,2565042.4,59.13991924641783,0.8044155985959203,1.5,2.75,NaN,NaN,1.0536544663462497,0.7629538599439916,877.2972498421518,-0.16493316058425622,0.8252144122752156,0.9901475728594719,16.792929999631507,-1.0814842438933534,12.611609413956947,59.956260056265464,27.432130529777588,4981837936
1536759000,52.99,53.4,52.56,53.07,48.989999999999995,55.68278333333333,54.45,38.42,54.48,38.42,32.9575,39.04,25.1025,21.64,46.36685000000005,47.45639999999997,50.35739999999996,52.407499999999985,50.56941476620651,52.351446998698776,53.1769230769231,54.46019736537756,51.893648788468646,46.36685000000005,47.45639999999997,50.35739999999996,52.407499999999985,53.01,2661084,2582810.7,59.26209224228533,0.5511827461545585,1.5,2.75,NaN,NaN,1.0383934330358031,1.0303054730259558,878.9746166243535,-0.1585217311863869,0.7919954088764882,0.9505171400628751,16.659774058569905,-2.5344352617079937,39.37837116298541,27.68362060754251,32.93800822947209,4984499020
1536845400,53.69,54.08,53.521,53.94,49.10307692307692,55.8022037037037,54.45,38.42,54.48,38.42,32.9575,39.04,25.1025,21.64,46.425500000000056,47.57289999999996,50.55279999999996,52.63649999999999,50.701594579296454,52.50273776072746,53.3069230769231,54.52921309954796,52.08463305429824,46.425500000000056,47.57289999999996,50.55279999999996,52.63649999999999,53.847,1817672,2458700.7,64.26723598506285,1.7815196855361468,1.5,2.75,NaN,NaN,1.0363653306761027,0.7392815237739184,880.9075841968605,-0.09933751616314657,0.8263452448589419,0.9256827610220885,17.052890467821644,0.35348837209301903,69.39274260412446,7.638910213704831,22.96834718217072,4986316692
1536931800,54.1,54.19,53.49,53.96,49.216153846153844,55.92162407407407,54.45,38.42,54.48,38.42,32.9575,39.04,25.1025,21.64,46.47795000000006,47.706099999999964,50.726799999999955,52.80899999999999,50.82937518402993,52.64152464065818,53.34384615384617,54.612923067597954,52.07476924009439,46.47795000000006,47.706099999999964,50.726799999999955,52.80899999999999,53.879999999999995,1873613,2401431.9,64.37559396311745,1.5925262544430017,1.5,2.75,NaN,NaN,1.0123392356278094,0.7802065925750383,881.815778844636,-0.06419747978923196,0.8454359112855485,0.9096333910747805,15.24530848569792,0.39069767441860626,100,0,0,4988190305
1537191000,53.9,53.9499,52.92,53.09,49.32923076923076,56.04104444444444,54.45,38.42,54.48,38.42,32.9575,39.04,25.1025,21.64,46.52645000000006,47.82829999999996,50.86119999999996,52.913499999999985,50.918027137597385,52.68423657964312,53.302307692307714,54.56654121129562,52.03807417331981,46.52645000000006,47.82829999999996,50.86119999999996,52.913499999999985,53.319966666666666,1709485,2318300.85,56.3680193087478,0.49051710353203287,1.5,2.75,NaN,NaN,1.0143150045115372,0.7373870393051014,879.4538913797694,-0.10262136930790822,0.7813566794398952,0.8839780487478034,17.995507992625647,-0.7663551401869095,81.14717381729979,3.084477737337417,15.7683484453628,4986480820
1537277400,53.21,54.29,53.2,53.92,49.442307692307686,56.16046481481481,54.45,38.42,54.48,38.42,32.9575,39.04,25.1025,21.64,46.573650000000065,47.94649999999996,50.98599999999997,53.0425,51.03575156357396,52.80192833396282,53.26153846153848,54.40335472464661,52.119722198430345,46.573650000000065,47.94649999999996,50.98599999999997,53.0425,53.80333333333334,1700509,2277485.3,61.312229981952854,1.6614713090169857,1.5,2.75,NaN,NaN,1.0275782184749986,0.7466608017184568,881.2787201388588,-0.07641553527610401,0.7884586296526734,0.8648741649287774,20.176273413462663,1.5633829346392885,80.64859813099498,3.24003963911601,16.111362229889,4988181329
1537363800,53.97,54.37,53.88,54.12,49.55538461538461,56.27988518518518,54.45,38.42,54.48,38.42,32.9575,39.04,25.1025,21.64,46.62300000000007,48.065699999999964,51.10559999999997,53.16549999999999,51.15670248264949,52.9274589688235,53.29000000000001,54.495755428702765,52.08424457129726,46.62300000000007,48.065699999999964,51.10559999999997,53.16549999999999,54.123333333333335,1218826,2215613.4,62.41736626499846,1.4961412964731942,1.5,2.75,NaN,NaN,0.9891797742982126,0.5501077038078935,879.5063166460237,-0.051105757474663505,0.800991968085448,0.8520977255601115,19.47404767609872,2.889733840304175,76.8744903141484,4.528726044283003,18.5967836415686,4989400155
1537450200,54.9,55.61,54.839,55.38,49.668461538461536,56.39930555555555,54.45,38.42,54.48,38.42,32.9575,39.04,25.1025,21.64,46.67945000000006,48.20729999999996,51.26979999999997,53.354,51.322321993133826,53.16103430512602,53.41538461538463,55.049362590654994,51.78140664011427,46.67945000000006,48.20729999999996,51.26979999999997,53.354,55.27633333333333,2039682,2215829.2,68.5186441006541,3.297335555251071,1.5,2.75,NaN,NaN,1.024952647562626,0.9205050641989915,882.57648373039,0.04007881327194318,0.9021962421500405,0.8621174288780973,21.397406826900344,6.112282046369045,77.73120095218889,4.219148695143667,18.049650352667445,4991439837
1537536600,55.89,55.95,55.13,55.25,49.78153846153845,55.95,54.45,38.42,54.48,38.42,32.9575,39.04,25.1025,21.64,46.73770000000006,48.34539999999996,51.40759999999997,53.548,51.47634858163838,53.35998341892355,53.55000000000002,55.45547389623444,51.6445261037656,46.73770000000006,48.34539999999996,51.40759999999997,53.548,55.443333333333335,2138003,2215368.5,67.30459625009644,2.892335629805061,1.5,2.75,NaN,NaN,1.0103131727367243,0.9650778188820506,883.2663112950505,0.07897448172675736,0.960835531036544,0.8818610493097866,20.392060968261397,5.258144408458749,43.925366020805406,23.829072093555688,32.245561885638914,4989301834
1537795800,54.86,54.959,54.32,54.73,49.89461538461538,56.033875,54.45,38.42,54.48,38.42,32.9575,39.04,25.1025,21.64,46.793400000000055,48.487099999999955,51.53319999999997,53.672000000000004,51.603942754907465,53.49046118854988,53.67615384615386,55.65870136754047,51.693606324767245,46.793400000000055,48.487099999999955,51.53319999999997,53.672000000000004,54.669666666666664,2156031,2199659.45,62.531802509327086,1.3516392294305941,1.5,2.75,NaN,NaN,1.004576517541244,0.9801658161221274,882.4458174427501,0.05798861630936236,0.9543468196964895,0.8963582033871271,22.163862225978608,3.1668237511781334,38.18573111528998,28.707241337299234,33.10702754741077,4987145803
1537882200,54.86,54.9193,54.27,54.41,50.0076923076923,56.11775,54.45,38.42,54.48,38.42,32.9575,39.04,25.1025,21.64,46.845400000000055,48.62819999999995,51.65439999999997,53.718500000000006,51.71398421549933,53.57803631344989,53.81538461538462,55.72910214754537,51.90166708322388,46.845400000000055,48.62819999999995,51.65439999999997,53.718500000000006,54.5331,1670048,2132211.95,59.7249780031688,0.9167153275704418,1.5,2.75,NaN,NaN,0.979199623431155,0.7832467124105555,880.821881439826,0.01320164427871462,0.9128602587355203,0.8996586144568057,22.428475210522443,2.524967024684372,16.355950076304882,53.9425957030997,29.70145422059542,4985475755
1537968600,54.5,55.2428,53.67,53.9,50.12076923076923,56.20162500000001,54.45,38.42,54.48,38.42,32.9575,39.04,25.1025,21.64,46.891250000000056,48.74869999999994,51.75379999999998,53.732000000000006,51.79971032469543,53.60869952169276,53.94692307692309,55.61498292855883,52.27886322528735,46.891250000000056,48.74869999999994,51.75379999999998,53.732000000000006,54.27093333333334,1894547,2115698.35,55.45286088581081,0.9448967202868098,1.5,2.75,NaN,NaN,1.0215996503289297,0.8954712282117155,878.2836777687022,-0.05631103853534236,0.8292698162876277,0.8855808548229701,23.451083575156073,-0.07415647015201919,5.256432417657094,74.90239641313082,19.841171169212075,4983581208
1538055000,54.21,55.04,54.04,54.34,50.233846153846144,56.285500000000006,55.38,38.42,54.48,38.42,32.9575,39.04,25.1025,21.64,46.937250000000056,48.86959999999995,51.85619999999998,53.7265,51.899329527648554,53.67834718629345,54.08923076923078,55.53693370387665,52.64152783458491,46.937250000000056,48.86959999999995,51.85619999999998,53.7265,54.473333333333336,1622174,2090308.8,58.22892796988379,0.7936189706826087,1.5,2.75,NaN,NaN,1.0300568181625775,0.7760451470136852,879.4006464556487,-0.07692222328028708,0.7894280757226113,0.8663502990028984,22.00839928339888,0.7042253521126808,3.420417206395729,80.0350828354808,16.54449995812347,4985203382
1538141400,53.96,54.66,53.93,54.32,50.34692307692307,56.369375000000005,55.38,38.42,54.48,38.42,32.9575,39.04,25.1025,21.64,46.98190000000006,48.99019999999994,51.969799999999985,53.754999999999995,51.99425778146626,53.739456978075026,54.1869230769231,55.506675608863134,52.86717054498307,46.98190000000006,48.99019999999994,51.969799999999985,53.754999999999995,54.303333333333335,1492977,2031063.1,58.05184037750179,0.3886516657560123,1.5,2.75,NaN,NaN,1.0086241882938218,0.7350716971816385,881.1805738679103,-0.09498322810176396,0.7476212638756934,0.8426044919774573,22.016982124097918,2.316820493501595,4.007216135828342,78.28242270731893,17.710361156852716,4983710405
1538400600,55.16,55.59,54.5,54.89,50.459999999999994,56.453250000000004,55.38,38.42,54.48,38.42,32.9575,39.04,25.1025,21.64,47.037650000000056,49.10439999999994,52.09739999999998,53.812,52.10781629984013,53.849032503972644,54.326923076923094,55.523414990564085,53.130431163282104,47.037650000000056,49.10439999999994,52.09739999999998,53.812,54.99333333333334,1943400,1988268.2,61.633098387593094,1.424294840671325,1.5,2.75,NaN,NaN,1.0272938891299777,0.9774335273279531,878.4859737927196,-0.07263013419287445,0.7518168242363643,0.8244469584292388,19.726136611268917,1.798961424332342,22.353393337610264,45.69814727186226,31.94845939052748,4985653805
1538487000,54.8,55.267,54.5815,54.8,50.57307692307692,56.537125,55.38,38.42,54.48,38.42,32.9575,39.04,25.1025,21.64,47.09560000000006,49.20519999999994,52.21799999999998,53.876999999999995,52.21339213121895,53.93960083692763,54.39307692307693,55.59177839012391,53.19437545602995,47.09560000000006,49.20519999999994,52.21799999999998,53.876999999999995,54.882833333333345,1228275,1930173.65,60.7511772853257,1.0997680049358192,1.5,2.75,NaN,NaN,1.0028800399064082,0.6363546616647678,876.2713975745489,-0.06807217162270596,0.7393567439008564,0.8074289155235623,18.255921500581298,1.2564671101256462,24.91020199710301,42.54715720046222,32.542640802434775,4984425530
1538573400,55.46,55.75,54.68,54.92,50.68615384615384,56.62100000000001,55.38,38.42,54.48,38.42,32.9575,39.04,25.1025,21.64,47.14885000000006,49.30469999999994,52.32819999999999,53.968500000000006,52.31953361626919,54.032972185791664,54.46692307692308,55.66808622129952,53.26575993254664,47.14885000000006,49.30469999999994,52.32819999999999,53.968500000000006,55.116666666666674,1638469,1882872.6,61.541369895810064,1.3325988984447983,1.5,2.75,NaN,NaN,1.0076743227702363,0.8701964222114655,875.8165387484016,-0.06134992890584079,0.7307415043912613,0.7920914332971021,18.21341458065662,-0.8306247742867476,55.25309416173074,15.496773391205151,29.250132447064104,4986063999
1538659800,54.58,54.61,52.61,53.61,50.79923076923076,56.70487500000001,55.38,38.42,54.48,38.42,32.9575,39.04,25.1025,21.64,47.191200000000066,49.38969999999994,52.384799999999984,54.019000000000005,52.37014014112138,53.992689120478175,54.50692307692308,55.54566150154831,53.46818465229785,47.191200000000066,49.38969999999994,52.384799999999984,54.019000000000005,53.60999999999999,4263429,1970317.7,49.7629467587925,1.758338294275063,1.5,2.75,NaN,NaN,1.1006975854295054,2.1638281988737145,870.6893681068217,-0.14474297875476605,0.6111627098536445,0.7559056886084106,17.90188510183754,-2.9683257918552046,14.830486314754765,56.288288532376455,28.881225152868783,4981800570
1538746200,53.73,54.0301,51.8,52.79,50.912307692307685,56.78875000000001,55.38,38.42,54.48,38.42,32.9575,39.04,25.1025,21.64,47.23255000000007,49.47549999999994,52.43399999999999,54.049,52.386605233626426,53.878147299480254,54.42,55.78006787160958,53.05993212839042,47.23255000000007,49.47549999999994,52.43399999999999,54.049,52.87336666666666,4200936,2047832.95,44.076345095966005,2.674120927859226,1.5,2.75,NaN,NaN,1.181369186470255,2.051405609036616,867.1076161097648,-0.24864639288930657,0.4450976974967773,0.6937440903860839,19.18265437242981,-3.5446738534624482,9.233057915812385,66.07667612491285,24.690265959274765,4977599634
1539005400,52.3,52.8999,51.4,52.66,51.02538461538461,56.872625000000006,55.38,38.42,54.48,38.42,32.9575,39.04,25.1025,21.64,47.273750000000064,49.55419999999994,52.500599999999984,54.057500000000005,52.397326597013624,53.76213327095832,54.30769230769231,55.95837335774228,52.65701125764233,47.273750000000064,49.55419999999994,52.500599999999984,54.057500000000005,52.319966666666666,3714691,2147043,43.23286484877058,2.927902952366994,1.5,2.75,NaN,NaN,1.2041213874366654,1.7301428057099928,867.6880956716265,-0.3153576138855163,0.2995470730291885,0.6149046869147048,18.947656701641087,-3.2163205293144643,1.290521319803959,88.07566094835308,10.633817731842951,4973884943
1539091800,52.45,53.23,52.1021,52.46,51.138461538461534,56.956500000000005,55.38,38.42,54.48,38.42,32.9575,39.04,25.1025,21.64,47.31280000000006,49.632299999999944,52.580199999999984,54.028000000000006,52.39978437752289,53.6381205784861,54.08307692307692,55.87739932983895,52.288754516314896,47.31280000000006,49.632299999999944,52.580199999999984,54.028000000000006,52.597366666666666,3446862,2221535.65,41.904251070831435,2.0285484182866043,1.5,2.75,NaN,NaN,1.1986770026197604,1.5515672683443096,866.4457276662151,-0.3590088489903558,0.1661436256767601,0.5251524746671159,18.90469581904236,-2.6716141001855247,0.9779846730409003,89.68098312335357,9.34103220360553,4970438081
1539178200,52.09,52.1146,47.2276,47.49,51.25153846153846,57.040375000000004,55.38,38.42,54.48,38.42,32.9575,39.04,25.1025,21.64,47.327250000000056,49.664099999999934,52.54619999999998,53.74900000000001,52.20724381369846,53.05258528529695,53.48615384615385,57.326767086141906,49.64554060616579,47.327250000000056,49.664099999999934,52.54619999999998,53.74900000000001,48.944066666666664,9485442,2562753.55,22.993688314865153,8.304824485903971,1.5,2.75,NaN,NaN,1.486800073861206,3.7012696753458796,859.70399343887,-0.6895102644335959,-0.3367353558748789,0.35277490855871696,58.347466936086064,-12.605815237394186,0,100,0,4960952639
1539264600,46.87,47.74,43.39,44.27,51.36461538461538,57.12425000000001,55.38,38.42,54.48,38.42,32.9575,39.04,25.1025,21.64,47.326400000000056,49.65399999999994,52.45099999999998,53.26550000000001,51.89597935041617,52.216148591459145,52.681538461538466,58.83127439660152,46.53180252647541,47.326400000000056,49.65399999999994,52.45099999999998,53.26550000000001,45.13333333333333,14312374,3187488.65,17.487430542065184,14.526455040501007,1.5,2.75,NaN,NaN,1.6913143542996913,4.490172537555545,854.5458389843147,-1.0692259403291038,-0.9837575168526627,0.08546842347644107,65.05030375822953,-18.50147275405007,0,100,0,4946640265
1539351000,46.61,46.7,44.37,46.17,51.4776923076923,57.20812500000001,55.38,38.42,54.48,38.42,32.9575,39.04,25.1025,21.64,47.33465000000005,49.66669999999995,52.379799999999975,52.87600000000001,51.67143114059593,51.640324916082086,52.04769230769231,59.000328349438924,45.09505626594569,47.33465000000005,49.66669999999995,52.379799999999975,52.87600000000001,45.74666666666667,8069366,3497276.3,28.385101528731823,11.186539557280122,1.5,2.75,NaN,NaN,1.7440776147068564,2.3073287060561958,857.297887401731,-1.1306994171099625,-1.327905847911012,-0.19720643080104955,73.78824783583813,-15.886318090726906,4.593726347122534,76.68572822194878,18.720545430928695,4954709631
1539610200,45.87,46.65,45.29,45.35,51.590769230769226,57.29200000000001,55.38,38.42,54.48,38.42,32.9575,39.04,25.1025,21.64,47.33770000000006,49.66739999999995,52.278599999999976,52.48900000000001,51.4235318801804,51.0412463526457,51.39,59.09428452226422,43.68571547773578,47.33770000000006,49.66739999999995,52.278599999999976,52.48900000000001,45.76333333333333,4841843,3653894.2,26.743467906716248,9.377300629486744,1.5,2.75,NaN,NaN,1.7166434993706523,1.3251185543358097,859.9127487747296,-1.1604892605242099,-1.647818006456312,-0.48732874593210207,71.80707514630687,-17.24452554744525,4.498833870399285,76.93553566175125,18.565630467849477,4949867788
1539696600,46.39,48.54,46.17,48.22,51.70384615384614,57.37587500000001,55.38,38.42,54.48,38.42,32.9575,39.04,25.1025,21.64,47.357150000000054,49.69939999999995,52.223799999999976,52.20400000000001,51.297903178996854,50.7725562238223,50.91923076923077,58.59280765674032,43.245653881721225,47.357150000000054,49.69939999999995,52.223799999999976,52.20400000000001,47.64333333333334,5154939,3826615.7,39.85461830810451,4.388310031255564,1.5,2.75,NaN,NaN,1.8218832494156056,1.3471274369150787,865.9767350729135,-0.9307266142863408,-1.6507370137900281,-0.7200103995036873,85.2226658728106,-12.199563000728336,12.628285180717288,59.92077929038622,27.450935528896494,4955022727
1539783000,48.32,48.6625,46.82,48.28,51.81692307692307,57.45975000000001,55.38,38.42,54.48,38.42,32.9575,39.04,25.1025,21.64,47.372600000000055,49.73569999999995,52.160599999999974,51.91200000000001,51.17955403472247,50.5351699167916,50.45461538461538,57.978246322215064,42.930984447015696,47.372600000000055,49.73569999999995,52.160599999999974,51.91200000000001,47.92083333333333,5035131,4017430.95,40.09599998692581,3.370347156200538,1.5,2.75,NaN,NaN,1.8233558744573481,1.2533211056185047,863.461265691884,-0.7275323545894409,-1.6294258427404884,-0.9018934881510475,85.16381029094904,-9.942174967356832,32.54909589067499,34.17035706550229,33.280547043822736,4960057858
1539869400,47.78,48.108,45.46,46.25,51.92999999999999,57.54362500000001,55.38,44.27,54.48,38.42,32.9575,39.04,25.1025,21.64,47.373900000000056,49.76669999999996,52.05799999999997,51.45550000000001,50.98623819022355,50.127058496144784,49.79,57.15374068820167,42.426259311798326,47.373900000000056,49.76669999999996,52.05799999999997,51.45550000000001,46.605999999999995,6828458,4256869.75,34.98081429647877,6.215989366827536,1.5,2.75,NaN,NaN,1.8945447405675375,1.6041031088630324,859.2394734881198,-0.6833631476952848,-1.7560974227701536,-1.0727342750748687,86.73951576898106,-12.388709982951315,48.661245636990294,20.116508212555626,31.222246150454097,4953229400
1539955800,46.6,47.64,45.71,46.06,52.04307692307692,57.62750000000001,55.38,44.27,54.48,38.42,32.9575,39.04,25.1025,21.64,47.37135000000006,49.779099999999964,51.955999999999975,50.996,50.79305237884223,49.739719591750045,49.11769230769231,56.115868570542304,42.119516044842314,47.37135000000006,49.779099999999964,51.955999999999975,50.996,46.47,6193370,4459638.1,34.536711423167134,5.106248460707048,1.5,2.75,NaN,NaN,1.8970772590984277,1.3887606709611706,858.5394734881197,-0.6222011616139551,-1.8504857270923125,-1.2282845654783574,86.95020662101592,-12.533232054690457,17.45281324659659,52.37585304293337,30.17133371047005,4947036030
1540215000,46.51,46.66,45.17,45.52,52.15615384615384,57.71137500000001,55.38,44.27,54.48,38.42,32.9575,39.04,25.1025,21.64,47.361700000000056,49.79529999999997,51.864399999999975,50.5355,50.5862660110445,49.3378415353929,48.394615384615385,54.75910154012461,42.03012922910616,47.361700000000056,49.79529999999997,51.864399999999975,50.5355,45.78333333333333,4825909,4593132,33.24488734236971,5.5323457234604945,1.5,2.75,NaN,NaN,1.8680003120199682,1.0506793621433044,855.9470637528938,-0.5745127031492276,-1.946425444414892,-1.3719127412656644,86.67668252808507,-13.22912695386961,17.553966789352625,52.21848746150234,30.227545749145047,4942210121
1540301400,43.42,45.39,42.3,44.74,52.26923076923076,57.79525000000001,55.38,44.27,54.48,38.42,32.9575,39.04,25.1025,21.64,47.346700000000055,49.789999999999964,51.76879999999997,50.05200000000001,50.35700067727805,48.899951865355476,47.71230769230769,53.576163886609834,41.848451498005545,47.346700000000055,49.789999999999964,51.76879999999997,50.05200000000001,44.14333333333334,7697808,4894520,31.416907693338175,7.961155863715227,1.5,2.75,NaN,NaN,1.9645717183042566,1.5727401256915898,852.1700513376626,-0.5517759072169295,-2.0616326252868262,-1.5098567180698967,86.40950980818118,-5.790692777426827,3.2822173862634547,80.49004887439112,16.22773373934542,4934512313
1540387800,44.65,44.8499,40.42,40.69,52.382307692307684,57.87912500000001,55.38,44.27,54.48,38.42,32.9575,39.04,25.1025,21.64,47.30980000000006,49.737799999999964,51.57359999999998,49.3915,49.977902611502444,48.118051687702575,46.78153846153847,52.958870951083654,40.60420597199328,47.30980000000006,49.737799999999964,51.57359999999998,49.3915,41.98663333333334,9348175,5267201.4,24.028924125908063,11.590946693544863,1.5,2.75,NaN,NaN,2.1406665955682382,1.7747897393860808,847.2255836014922,-0.7532963821578968,-2.451477195767268,-1.698180813609371,84.79445513889235,-8.086740456290954,0,99.99999999999999,0,4925164138
1540474200,41.6,43.68,41.1034,42.92,52.49538461538461,57.96300000000001,55.38,44.27,55.38,38.42,54.48,39.04,32.9575,21.64,47.285450000000054,49.70689999999996,51.44479999999998,48.820499999999996,49.70112211693372,47.62299914601662,46.0323076923077,51.497606073048914,40.56700931156648,47.285450000000054,49.70689999999996,51.44479999999998,48.820499999999996,42.5678,6732001,5522692.75,33.32613420800132,8.375495026501286,1.5,2.75,NaN,NaN,2.2013332673133643,1.218970763854281,851.117645798856,-0.6823210899976613,-2.5510821761064477,-1.8687610861087864,85.24385040159017,-7.039202945635694,4.044300349529591,78.200352692685,17.75534695778539,4931896139
1540560600,40.87,42.23,39.14,40.56,52.60846153846153,58.046875000000014,55.38,44.27,55.38,38.42,54.48,39.04,32.9575,21.64,47.243900000000046,49.64079999999996,51.245799999999974,48.1325,49.342646739799065,46.9503325606817,45.11692307692307,49.91479686636442,40.319049287481725,47.243900000000046,49.64079999999996,51.245799999999974,48.1325,40.64333333333334,10652274,5980657.6,29.246921511953786,11.634277775046753,1.5,2.75,NaN,NaN,2.3140951767909814,1.7811208586828313,847.2232053170067,-0.7356393013744227,-2.788310212826815,-2.052670911452392,84.92263048054237,-10.56229327453142,3.3176383014156783,80.37859915132493,16.30376254725937,4921243865
1540819800,42.16,42.81,38.07,39.87,38.07,58.13075000000001,55.38,44.27,55.38,38.42,54.48,39.04,32.9575,21.64,47.19415000000006,49.56859999999996,51.02319999999997,47.3815,48.97117039706185,46.276015173950114,44.53076923076923,49.8583720199503,39.20316644158816,47.19415000000006,49.56859999999996,51.02319999999997,47.3815,40.25,8851130,6326044.1,28.16157088984565,11.477096215065412,1.5,2.75,NaN,NaN,2.487374092734483,1.3991571762833586,845.0065456122,-0.7558150747104628,-2.997439754840471,-2.241624680130008,84.90749294298676,-17.316466196598924,2.6446497479471276,82.67173054269124,14.683619709361638,4912392735
1540906200,39.84,41.83,39.5801,41.72,38.010705882352944,58.21462500000001,55.38,44.27,55.38,38.42,54.48,39.04,32.9575,21.64,47.156300000000044,49.510899999999964,50.83079999999996,46.727500000000006,48.68681077364766,45.84210896690725,44.33461538461539,49.86990421946467,38.79932654976611,47.156300000000044,49.510899999999964,50.83079999999996,46.727500000000006,41.043366666666664,6286932,6578976.95,35.11416850778812,7.600236282249817,1.5,2.75,NaN,NaN,2.4704116575391626,0.9556093671980413,848.3711785367522,-0.590340641043344,-2.979550481434188,-2.389209840390844,80.16179019587015,-13.587406793703401,11.956571407807818,61.184201480276236,26.859227111915953,4918679667
1540992600,43.0099,44.19,42.7601,43.01,37.95141176470588,58.29850000000001,55.38,44.27,55.38,38.42,54.48,39.04,32.9575,21.64,47.118050000000046,49.46399999999997,50.65779999999997,46.132000000000005,48.464190743308535,45.57238430339227,44.09153846153846,49.56021765042914,38.62285927264779,47.118050000000046,49.46399999999997,50.65779999999997,46.132000000000005,43.32003333333333,6174041,6805755.55,39.51033482179346,1.5896566791193487,1.5,2.75,NaN,NaN,2.4703822534292224,0.9071793652653305,851.0235914227197,-0.35157108351851596,-2.8286736947889892,-2.4771026112704733,83.91313074993586,-7.00540540540541,32.4812389667473,34.34892109605796,33.16983993719474,4924853708
1541079000,43.46,44.46,42.8659,44.39,37.892117647058825,58.38237500000001,55.38,44.27,55.38,38.42,54.48,39.04,32.9575,21.64,47.08770000000005,49.42859999999997,50.51339999999996,45.67100000000001,48.30441855729644,45.45977627449777,44.01769230769231,49.44215061511749,38.593234000267124,47.08770000000005,49.42859999999997,50.51339999999996,45.67100000000001,43.905300000000004,4317566,6808462.4,43.88997808848899,0.6367995684417246,1.5,2.75,NaN,NaN,2.4077906638985636,0.6341469991814892,855.5359202129467,-0.0728333657171798,-2.568144318416948,-2.4953109526997683,84.60553459070186,-3.6257056013894955,28.392396181014487,38.693046516318624,32.914557302666886,4929171274
1541165400,44.93,45.17,42.42,43.48,37.83282352941176,58.46625000000002,55.38,44.27,55.38,38.42,54.48,39.04,32.9575,21.64,47.04965000000005,49.389599999999966,50.35559999999997,45.20550000000001,48.115225672696575,45.27122615311703,43.653076923076924,48.505732878580595,38.80042096757325,47.04965000000005,49.389599999999966,50.35559999999997,45.20550000000001,43.69,6079748,6902403,41.74365537012376,1.4134539415895098,1.5,2.75,NaN,NaN,2.432234187905809,0.8808161447542254,853.448171269186,0.07036728070483544,-2.4073518518187242,-2.4777191325235597,85.13943994119205,-4.481546572934987,36.30742269355463,30.59513519328367,33.0974421131617,4923091526
1541428200,43.78,44.5299,43.281,44.24,37.773529411764706,58.550125000000016,55.38,39.87,55.38,38.42,54.48,39.04,32.9575,21.64,47.009100000000046,49.35449999999996,50.195399999999964,44.78450000000001,47.963256038473176,45.173014138534455,43.3423076923077,47.42651482821475,39.25810055640065,47.009100000000046,49.35449999999996,50.195399999999964,44.78450000000001,44.01696666666667,2801905,6856763.7,44.19800412436811,0.4017999089639452,1.5,2.75,NaN,NaN,2.347710317341108,0.40863374072523456,856.8253095978807,0.2275242193713658,-2.1933138583093523,-2.420838077680718,86.0183020858403,-1.117568171658471,71.26642931108925,6.772779184445265,21.96079150446549,4925893431
1541514600,44.21,45.17,44.17,45.08,37.71423529411765,58.634000000000015,55.38,39.87,55.38,38.42,54.48,39.04,32.9575,21.64,46.97100000000004,49.32969999999996,50.027399999999965,44.41550000000001,47.85018717421933,45.164155649150224,43.252307692307696,47.122192634713045,39.38242274990235,46.97100000000004,49.32969999999996,50.027399999999965,44.41550000000001,44.80666666666667,2298014,6799321.3,46.862672273579776,1.4207271417719707,1.5,2.75,NaN,NaN,2.251445294673886,0.33797696837771146,859.6499325149541,0.389777104610054,-1.9336166969181505,-2.3233938015282045,86.29511571236887,10.788891619562548,65.62732187051638,9.462735627686026,24.90994250179758,4928191445
1541601000,46.3,48.0037,46.058,47.89,37.65494117647059,58.717875000000014,55.38,39.87,55.38,38.42,54.48,39.04,32.9575,21.64,46.947350000000036,49.336299999999966,49.912599999999955,44.435500000000005,47.85174846150485,45.42375987304068,43.39307692307693,47.762180929905476,39.02397291624839,46.947350000000036,49.336299999999966,49.912599999999955,44.435500000000005,47.31723333333334,4159317,6533015.05,54.66215788355511,6.034206234974574,1.5,2.75,NaN,NaN,2.299463487911466,0.6366611691794587,864.3720620623815,0.671550882936486,-1.4839551978575969,-2.155506080794083,67.29379007875659,11.579683131407267,62.61395029636235,11.06970388825649,26.316345815381165,4932350762
1541687400,47.54,48.07,47.0301,47.66,37.59564705882353,48.07,55.38,39.87,55.38,38.42,54.48,39.04,32.9575,21.64,46.92220000000003,49.34599999999997,49.77679999999996,44.605000000000004,47.844228913994854,45.63673512322728,43.557692307692314,48.37337280978387,38.742011805600754,46.92220000000003,49.34599999999997,49.77679999999996,44.605000000000004,47.5867,2813878,5958090.25,53.96396359587415,5.172908297652121,1.5,2.75,NaN,NaN,2.2094946673463616,0.4722785123974918,862.9491455651741,0.8179306961681843,-1.1330927105838526,-1.951023406752037,63.76645976655465,17.504930966469413,36.21161080998579,30.54446842839158,33.243920761622626,4929536884
1541773800,46.95,47.0399,45.48,46.33,37.536352941176474,47.838235294117645,55.38,39.87,55.38,38.42,54.48,39.04,32.9575,21.64,46.88145000000003,49.339699999999965,49.62839999999996,44.613000000000014,47.78484738795584,45.70276034958659,43.680000000000014,48.68656184806117,38.67343815193886,46.88145000000003,49.339699999999965,49.62839999999996,44.613000000000014,46.2833,4498641,5779554,49.98781877519241,2.135410122403253,1.5,2.75,NaN,NaN,2.20738790539305,0.7783716528991683,859.8076238195061,0.7997110636983402,-0.9513845771291116,-1.7510956408274518,54.276083284671884,16.202658640581895,41.45024862872227,25.837481057474523,32.712270313803195,4925038243
1542033000,45.99,46.11,43.39,43.64,37.47705882352941,47.6064705882353,55.38,39.87,55.38,38.42,54.48,39.04,32.9575,21.64,46.83260000000003,49.31559999999997,49.42619999999995,44.52750000000001,47.62230435313405,45.506306982959295,43.90692307692309,48.608984062788004,39.20486209105818,46.83260000000003,49.31559999999997,49.42619999999995,44.52750000000001,44.379999999999995,5285228,5801723.25,43.07481084853221,2.0976386257341875,1.5,2.75,NaN,NaN,2.259717340722118,0.9109755450675797,856.0505252749263,0.5906640646534194,-1.0127655600106777,-1.603429624664097,67.02338882399005,4.602109300095882,14.889612340918,56.209881155696074,28.90050650338592,4919753015
1542119400,43.9023,44.98,43.01,43.4,37.417764705882355,47.37470588235294,55.38,39.87,55.38,38.42,54.48,39.04,32.9575,21.64,46.791050000000034,49.28709999999997,49.22419999999995,44.286500000000004,47.45672379026605,45.30570631791555,43.94384615384617,48.621804541279324,39.26588776641301,46.791050000000034,49.28709999999997,49.22419999999995,44.286500000000004,43.79666666666666,4814315,5784692.05,42.50995560496097,2.96580257211733,1.5,2.75,NaN,NaN,2.239023244956252,0.8322508715049058,855.6784210711586,0.4279757917742717,-1.0684598849462574,-1.4964356767205291,63.193509364026795,0.9067658684026985,4.701994969105518,76.36786486915297,18.93014016174151,4914938700
1542205800,44.43,44.62,41.69,42.52,37.35847058823529,47.142941176470586,55.38,39.87,55.38,38.42,54.48,39.04,32.9575,21.64,46.744450000000036,49.268299999999975,49.01279999999995,43.99850000000001,47.26312677888306,45.040400954304545,44.0946153846154,48.44121876504311,39.74801200418769,46.744450000000036,49.268299999999975,49.01279999999995,43.99850000000001,42.943333333333335,5201197,5792995.35,40.41711932200927,4.023268449308095,1.5,2.75,NaN,NaN,2.288378727459377,0.8978424261983915,852.813829939262,0.2610539101886493,-1.1701182889847175,-1.4311721991733668,62.13056490593359,-4.212660509123671,0,100,0,4909737503
1542292200,41.86,44.0999,41.02,43.87,37.299176470588236,46.91117647058824,55.38,39.87,55.38,38.42,54.48,39.04,32.9575,21.64,46.70565000000004,49.26049999999997,48.83819999999995,43.87950000000001,47.13006298363275,44.92893419675173,44.40230769230771,48.01316443143937,40.791450953176046,46.70565000000004,49.26049999999997,48.83819999999995,43.87950000000001,42.996633333333335,6201772,5761661.05,44.89880507441296,3.206428734326318,1.5,2.75,NaN,NaN,2.3449159612122785,1.0763861230608143,855.1030451604926,0.24194720118878132,-1.1287381976873903,-1.3706853988761716,62.068248776767106,0.8969641214351439,6.654837094097558,71.54691463591509,21.798248269987344,4915939275
1542378600,43.25,44.65,42.94,44.12,37.23988235294118,46.67941176470588,55.38,39.87,55.38,38.42,54.48,39.04,32.9575,21.64,46.68490000000004,49.26649999999997,48.67679999999995,43.782500000000006,47.01202129800009,44.85189284468014,44.58692307692309,47.85994929003474,41.31389686381144,46.68490000000004,49.26649999999997,48.67679999999995,43.782500000000006,43.903333333333336,4776149,5690800,45.71314459895869,1.0414545982257475,1.5,2.75,NaN,NaN,2.299564821125687,0.8392754972938778,856.5253631649301,0.24573890715618818,-1.0635117649309365,-1.3092506720871246,60.868141305448816,-0.27124773960218024,22.849958994094024,45.08585099650323,32.06419000940275,4920715424
1542637800,43.83,43.96,41.43,42.08,37.18058823529412,46.44764705882353,55.38,39.87,55.38,38.42,54.48,39.04,32.9575,21.64,46.68360000000004,49.24389999999997,48.46859999999995,43.61050000000001,46.81860869807852,44.58790304994869,44.51538461538463,47.95934133256655,41.071427898202714,46.68360000000004,49.24389999999997,48.46859999999995,43.61050000000001,42.49,5329921,5716000.6,40.45865239243712,4.882821843251665,1.5,2.75,NaN,NaN,2.3274530481881377,0.9324563401900273,852.4858524199483,0.11698158969702521,-1.163023684965843,-1.2800052746628683,65.80032106130012,-6.654835847382431,24.276295426936834,43.30910516890177,32.4145994041614,4915385503
1542724200,40.17,40.93,39.14,39.63,37.12129411764706,46.21588235294118,55.38,39.87,55.38,38.42,54.48,39.04,32.9575,21.64,46.65830000000003,49.194799999999965,48.20019999999995,43.355000000000004,46.53670247462446,44.115721807096435,44.14923076923079,48.46934801506469,39.82911352339689,46.65830000000003,49.194799999999965,48.20019999999995,43.355000000000004,39.9,7919505,5727085.45,35.22230943380485,9.230702949784911,1.5,2.75,NaN,NaN,2.3712064018889847,1.3828159312691939,846.8589937526688,-0.1145370832731154,-1.4231766287542627,-1.3086395454811472,70.70639038210687,-17.24785967842973,20.19722128447136,48.51124399089662,31.291534724632008,4907465998
1542810600,40.38,40.912,39.98,40.01,37.062,45.984117647058824,55.38,39.87,55.38,38.42,54.48,39.04,32.9575,21.64,46.63875000000004,49.14819999999997,47.93899999999995,43.321000000000005,46.28075335797252,43.72470068261106,43.88230769230771,48.731264146868305,39.03335123774712,46.63875000000004,49.14819999999997,47.93899999999995,43.321000000000005,40.300666666666665,3872750,5453314.2,36.593051431846206,6.5513586864258455,1.5,2.75,NaN,NaN,2.2934059446111994,0.7101644720929522,851.2620230129244,-0.21746294987045367,-1.5804682328192143,-1.3630052829487607,55.89620058455532,-16.05119597146454,39.640224530256695,27.40858038518552,32.9511950845578,4911338748
1542983400,39.1,39.8575,39.0701,39.2,37.00270588235294,45.75235294117647,55.38,39.87,55.38,38.42,54.48,39.04,32.9575,21.64,46.639550000000035,49.098499999999966,47.64419999999995,43.135000000000005,46.00307675569909,43.29377680807667,43.49461538461541,48.93682429918516,38.05240647004565,46.639550000000035,49.098499999999966,47.64419999999995,43.135000000000005,39.37586666666667,1819222,5207675.25,34.89787335725427,8.283471768219334,1.5,2.75,NaN,NaN,2.1967269485675422,0.34933476314599304,849.8503191482919,-0.30984117057803506,-1.7503067461713044,-1.4404655755932694,55.2670633646922,-15.389596373839835,18.729076809955544,50.52045901914155,30.75046417090291,4909519526
1543242600,40.3,41.04,40.06,41,36.943411764705886,45.52058823529412,55.38,39.87,55.38,38.42,54.48,39.04,32.9575,21.64,46.640400000000035,49.055899999999966,47.38499999999995,43.157000000000004,45.8068776672403,43.07532187397413,43.18076923076925,48.69122062391419,37.67031783762431,46.640400000000035,49.055899999999966,47.38499999999995,43.157000000000004,40.69999999999999,3589005,4854511.8,41.39502973856994,3.637986559273456,1.5,2.75,NaN,NaN,2.171246452241289,0.7393132714189715,852.9490946546096,-0.2234954189402425,-1.7198348492685724,-1.49633943032833,65.92713487606242,-6.049495875343722,13.560106904412574,58.344971168123415,28.094921927464004,4913108531
1543329000,40.52,41.41,40.19,41.4,36.88411764705882,45.288823529411765,55.38,39.87,55.38,38.42,54.48,39.04,32.9575,21.64,46.635250000000035,49.006199999999964,47.151199999999946,43.23350000000001,45.63405893519166,42.91576740978612,42.68153846153848,47.53130512462553,37.83177179845143,46.635250000000035,49.006199999999964,47.151199999999946,43.23350000000001,41,3522539,4588082.25,42.76207900103725,2.6050541531444558,1.5,2.75,NaN,NaN,2.1033002770811966,0.7677584681486475,850.1229944962175,-0.11849066895202065,-1.6444527665183557,-1.525962097566335,59.318800823290694,-4.6082949308755765,37.52643702693647,29.33389803627163,33.139664936791895,4916631070
1543415400,41.98,44.27,41.48,44.27,36.824823529411766,45.05705882352941,55.38,39.87,55.38,38.42,54.48,39.04,32.9575,21.64,46.642550000000035,48.97209999999996,46.95819999999994,43.361000000000004,45.58056642792924,43.04474194218744,42.42076923076925,46.470266533196664,38.37127192834184,46.642550000000035,48.97209999999996,46.95819999999994,43.361000000000004,43.34,5697261,4558598.7,51.503238455124325,3.0746024718749756,1.5,2.75,NaN,NaN,2.158064543003969,1.249783403834165,855.245034530974,0.15060435104324466,-1.3377066587622792,-1.4883110098055239,72.34888461675395,4.1157102539981185,89.63992000517196,0.9831705616570574,9.376909433170983,4922328331
1543501800,43.87,44.76,43.26,43.97,36.7655294117647,44.82529411764706,55.38,39.87,55.38,38.42,54.48,39.04,32.9575,21.64,46.63980000000003,48.93039999999996,46.75519999999994,43.409000000000006,45.517406960167314,43.13286175721721,42.23923076923079,45.74678272323791,38.73167881522367,46.63980000000003,48.93039999999996,46.75519999999994,43.409000000000006,43.99666666666667,4628246,4481308.95,50.63279387568299,3.8045272360544233,1.5,2.75,NaN,NaN,2.1110599327893995,1.032788868529138,853.8094246920009,0.3057963156333834,-1.1060656152637947,-1.411861930897178,71.21381580215747,0.22794620469569507,55.98143163788877,15.037840270554453,28.980728091556774,4917700085
1543588200,43.89,45.0899,43.73,44.86,36.70623529411765,44.593529411764706,55.38,39.2,55.38,38.42,54.48,39.04,32.9575,21.64,46.63315000000003,48.90729999999996,46.54479999999994,43.432500000000005,45.491626295062716,43.29735111367272,42.333076923076945,46.04485762461783,38.621296221536056,46.63315000000003,48.90729999999996,46.54479999999994,43.432500000000005,44.55996666666666,4103267,4470594,53.161857119209294,3.8889104403429977,1.5,2.75,NaN,NaN,2.057405651875871,0.917834855949791,855.7634415338376,0.4567066808215514,-0.8409785798702387,-1.2976852606917901,69.88745907543378,1.6772438803263872,73.05060914174138,6.013874808547932,20.935516049710692,4921803352
1543847400,47.05,47.11,45.6849,46.5,36.64694117647059,47.11,55.38,39.2,55.38,38.42,54.48,39.04,32.9575,21.64,46.63465000000003,48.888699999999965,46.36979999999994,43.5835,45.531170361923,43.60236529332293,42.57153846153848,46.87759749256653,38.26547943051043,46.63465000000003,48.888699999999965,46.36979999999994,43.5835,46.43163333333333,6069655,4470089.35,57.48411693159351,6.419838918182472,1.5,2.75,NaN,NaN,2.0711623910275945,1.3578375116819534,860.4673743699849,0.6438447726976084,-0.49287929481977955,-1.136724067517388,72.52904138778523,10.503802281368825,78.91714458526661,3.8256649668622362,17.257190447871153,4927873007
1543933800,46.07,46.31,41.83,42.1,36.58764705882353,47.05,55.38,39.2,55.38,38.42,54.48,39.04,32.9575,21.64,46.618300000000026,48.82519999999997,46.11719999999994,43.4765,45.39661466145544,43.459282884435034,42.5392307692308,46.85264784434715,38.22581369411444,46.618300000000026,48.82519999999997,46.11719999999994,43.4765,43.413333333333334,7951475,4727567.85,45.38360587868602,1.7789247957748062,1.5,2.75,NaN,NaN,2.256793648811338,1.6819377854090451,854.0415151537659,0.4569534718746835,-0.5655322276740335,-1.022485699548717,90.27655084725988,6.232652031289424,45.73419391567762,22.444996323096337,31.820809761226034,4919921532
1544106600,40,41.87,38.36,41.86,36.52835294117647,46.99,55.38,39.2,55.38,38.42,54.48,39.04,32.9575,21.64,46.60450000000002,48.76029999999996,45.86619999999994,43.3155,45.25792389041797,43.30697022877455,42.38461538461541,46.63984648479978,38.12938428443103,46.60450000000002,48.76029999999996,45.86619999999994,43.3155,40.696666666666665,9949976,5110165.95,44.82928541279161,5.633649085043368,1.5,2.75,NaN,NaN,2.3627369596105288,1.9470944969996522,850.589073287679,0.30986493676077187,-0.6351545285977522,-0.9450194653585241,82.09148216228192,4.623844038990256,15.225402196291402,55.82038594528205,28.954211858426557,4909971556
1544193000,41.62,42.4464,38.44,38.89,36.46905882352941,46.93,55.38,39.2,55.38,38.42,54.48,39.04,32.9575,21.64,46.57475000000002,48.659899999999965,45.56599999999994,42.865500000000004,45.00820138491138,42.88630639746269,41.982307692307714,46.48681588775372,37.47779949686171,46.57475000000002,48.659899999999965,45.56599999999994,42.865500000000004,39.925466666666665,9520177,5378208.95,38.55365496291988,8.625094058150182,1.5,2.75,NaN,NaN,2.480141462495491,1.7701389232934135,847.181194715365,0.020506161056184635,-0.9193867640382933,-0.939892925094478,93.60865852554093,-0.790816326530618,12.059230304418792,61.002761244422636,26.938008451158577,4900451379
1544452200,38.79,39.5599,36.67,39.08,36.40976470588235,46.87,55.38,39.2,55.38,38.42,54.48,39.04,32.9575,21.64,46.535250000000026,48.55849999999996,45.26079999999993,42.43650000000001,44.77572289922858,42.52380102627577,41.75153846153849,46.51246821012814,36.990608712948834,46.535250000000026,48.55849999999996,45.26079999999993,42.43650000000001,38.43663333333333,8545859,5664808,39.14061018940478,9.059480548463451,1.5,2.75,NaN,NaN,2.5094099294600984,1.5085875814325922,843.4860836001418,-0.14123910007812546,-1.1164418001921348,-0.9752027001140093,92.9927264351834,-4.682926829268297,15.46540017019457,55.344258845938114,29.190340983867323,4908997238
1544538600,40.6628,40.7552,38.37,39.09,36.3504705882353,46.81,55.38,39.2,55.38,38.42,54.48,39.04,32.9575,21.64,46.48760000000002,48.46299999999996,44.95619999999994,42.07450000000001,44.55275337376864,42.196772357106646,41.71000000000003,46.55296158595928,36.86703841404078,46.48760000000002,48.46299999999996,44.95619999999994,42.07450000000001,39.40506666666667,7198209,5799786.4,39.17354328235133,5.719015322992245,1.5,2.75,NaN,NaN,2.5005377916415203,1.2411162245561318,841.8954483553645,-0.22568499571272693,-1.257308944754918,-1.031623949042191,88.48308909369698,-5.579710144927525,15.435175015846777,55.390770932798624,29.1740540513546,4916195447
1544625000,40.55,41.2299,39.64,39.69,36.29117647058823,46.75,55.38,39.2,55.38,38.42,54.48,39.04,32.9575,21.64,46.45215000000002,48.37479999999995,44.65219999999994,41.877,44.36205716303261,41.958032132620296,41.68538461538464,46.56576679073882,36.805002440030464,46.45215000000002,48.37479999999995,44.65219999999994,41.877,40.18663333333333,6801606,5875605.3,41.22852265846938,2.7971774418523854,1.5,2.75,NaN,NaN,2.4747779493814117,1.1576009028380447,845.6984322584548,-0.21908754979125522,-1.30548338628126,-1.0863958364900048,88.86881426269136,-10.345606505534233,36.03845130353277,30.748073738335165,33.213474958132075,4922997053
1544711400,40.14,40.59,39.09,39.61,36.23188235294118,46.69,55.38,39.2,55.38,38.42,54.48,39.04,32.9575,21.64,46.42405000000002,48.283199999999944,44.34839999999994,41.68750000000001,44.17570198016858,41.734410024751696,41.716923076923095,46.53758619514742,36.89625995869877,46.42405000000002,48.283199999999944,44.34839999999994,41.68750000000001,39.763333333333335,5364774,5903128.25,41.029485373561485,3.9249016665573393,1.5,2.75,NaN,NaN,2.405150952997025,0.9088018712790121,842.6244384064363,-0.19866841675521485,-1.3347313574340234,-1.1360629406788085,76.63403017731719,-9.915851717079827,46.49596431423241,21.76434332580527,31.73969235996232,4917632279
1544797800,38.51,39,37.15,37.44,36.17258823529412,46.629999999999995,55.38,39.2,55.38,38.42,54.48,39.04,32.9575,21.64,46.39435000000003,48.16349999999994,43.99879999999994,41.4335,43.911556804475694,41.32541859382296,41.44307692307694,46.773087081043215,36.11306676511066,46.39435000000003,48.16349999999994,43.99879999999994,41.4335,37.86333333333334,6949617,5990549.25,35.958496878230775,7.972804856176961,1.5,2.75,NaN,NaN,2.409068742068666,1.160096797468112,837.9025982304152,-0.3035826345717425,-1.5155412338934866,-1.211958599321744,80.76333557320622,-16.540347748551053,53.713903739481424,16.543482703263045,29.742613557255524,4910682662
1545057000,36.94,37.48,34.43,35.27,36.11329411764706,46.57,55.38,39.2,55.38,38.42,54.48,39.04,32.9575,21.64,46.350400000000036,48.008399999999945,43.631999999999934,41.0035,43.57267222390802,40.74871206107792,40.97153846153848,47.23606052522303,34.70701639785393,46.350400000000036,48.008399999999945,43.631999999999934,41.0035,35.72666666666667,9401868,6150554.05,31.73459175406866,12.710180068584917,1.5,2.75,NaN,NaN,2.454849546206618,1.528621311766214,833.271293922573,-0.48086166569905453,-1.8130356814455624,-1.3321740157465078,80.68036270598807,-24.150537634408597,20.941052821200667,47.552560851677256,31.506386327122073,4901280794
1545143400,35.98,36.27,34.3601,35.1,36.054,46.51,55.38,39.2,55.38,38.42,54.48,39.04,32.9575,21.64,46.29825000000003,47.85609999999995,43.278199999999934,40.5525,43.24041056806849,40.2107394838324,40.26615384615387,46.93803531743796,33.59427237486978,46.29825000000003,47.85609999999995,43.278199999999934,40.5525,35.24336666666667,7564165,6289954.85,31.42317884356514,11.241449550897887,1.5,2.75,NaN,NaN,2.4159245786204306,1.2025785844869779,831.4341766154856,-0.5654729914789942,-2.0390152550952507,-1.4735422636162565,72.60478137992013,-16.6270783847981,4.577950317275041,76.71182211743006,18.71022756529489,4893716629
1545229800,35.13,36.8,32.69,33.37,35.99470588235294,46.449999999999996,55.38,39.2,55.38,38.42,54.48,39.04,32.9575,21.64,46.23565000000004,47.69649999999995,42.89239999999993,40.117000000000004,42.85333564383051,39.55924048537217,39.45076923076925,46.680321665212674,32.22121679632582,46.23565000000004,47.69649999999995,42.89239999999993,40.117000000000004,34.28666666666666,11983271,6622622.35,28.371950205864437,12.243842366536972,1.5,2.75,NaN,NaN,2.536929965861828,1.809445015387296,827.4749247068953,-0.685833257532553,-2.330833835531948,-1.6450005779993948,59.27298090069639,-20.28189202102246,0,100,0,4881733358
1545316200,32.93,33.6033,30.836,31.88,35.93541176470588,46.39,55.38,39.2,55.38,38.42,54.48,39.04,32.9575,21.64,46.16575000000003,47.530499999999954,42.48079999999994,39.7295,42.42300875583716,38.82788424867006,38.45230769230771,45.99628401108184,30.908331373533585,46.16575000000003,47.530499999999954,42.48079999999994,39.7295,32.106433333333335,13724940,6912894.1,26.027792534148503,16.903496247378797,1.5,2.75,NaN,NaN,2.5533849683002687,1.9854115803683439,821.9885780171572,-0.8054113907051621,-2.6517648163808474,-1.8463534256756853,59.386221207509166,-18.025199280020573,0,100,0,4868008418
1545402600,32.17,33.36,29.6,29.91,35.87611764705883,46.33,55.38,39.2,55.38,38.42,54.48,39.04,32.9575,21.64,46.08275000000003,47.337699999999955,42.12919999999994,39.2245,41.93230253011806,37.978561939272915,37.17615384615386,44.45091332285046,29.90139436945726,46.08275000000003,47.337699999999955,42.12919999999994,39.2245,30.956666666666667,12712731,7354893.15,23.288131027573883,19.767186100382965,1.5,2.75,NaN,NaN,2.6395717562788206,1.7284725611547462,816.4980903752938,-0.9470275979611089,-3.0301379231270715,-2.0831103251659626,56.801554883611225,-23.4646878198567,0,100,0,4855295687
1545661800,29.23,29.71,27.48,27.54,35.816823529411764,46.269999999999996,55.38,39.2,55.38,38.42,54.48,39.04,32.9575,21.64,45.97600000000004,47.12279999999996,41.79459999999994,38.64149999999999,41.367898509329116,36.98441318315169,36.05615384615386,44.363720511870454,27.748587180437273,45.97600000000004,47.12279999999996,41.79459999999994,38.64149999999999,28.24333333333333,7749417,7651402.9,20.493397876647762,28.64456889705153,1.5,2.75,NaN,NaN,2.6246023451160476,1.0128099514926863,812.9745432115135,-1.1184016855773327,-3.4811124321376283,-2.3627107465602957,61.242574743421315,-29.547198772064476,0,100,0,4847546270
1545834600,28.08,31.59,27.27,31.53,27.27,46.21,55.38,39.2,55.38,38.42,54.48,39.04,32.9575,21.64,45.890050000000045,46.94079999999996,41.50179999999994,38.16799999999999,40.9820985677868,36.46494526094676,35.26153846153848,43.16273543474877,27.36034148832819,45.890050000000045,46.94079999999996,41.50179999999994,38.16799999999999,30.13,13894430,8166674.15,34.701018477222675,14.034327910311099,1.5,2.75,NaN,NaN,2.7457021776077584,1.7013572165114486,819.4538280544165,-0.8910143176911562,-3.476478643674241,-2.585464325983085,114.96433091638139,-20.559334845049122,5.774772348819077,73.83457845607772,20.3906491951032,4861440700
1545921000,30.08,32.21,28.66,32.2,26.993076923076924,46.15,55.38,39.2,55.38,38.42,54.48,39.04,32.9575,21.64,45.81230000000005,46.75869999999996,41.23879999999994,37.708,40.63770254552065,36.05875999799945,34.746923076923096,42.50595705571347,26.98788909813272,45.81230000000005,46.75869999999996,41.23879999999994,37.708,31.023333333333337,14909606,8736027.5,36.74510323351405,11.619987031080834,1.5,2.75,NaN,NaN,2.8031520220643467,1.7066802960498921,818.6285042268859,-0.6354548583646,-3.379782898938835,-2.744328040574235,115.68565757494024,-18.707397121938897,26.843454875123513,40.56908403689019,32.58746108798629,4876350306
1546007400,32.74,33.43,31.5,32.01,26.716153846153844,46.089999999999996,55.38,39.2,55.38,38.42,54.48,39.04,32.9575,21.64,45.737250000000046,46.56919999999997,40.91459999999994,37.095,40.29936126922573,35.67316380771379,34.20307692307694,41.65608203558697,26.750071810566915,45.737250000000046,46.56919999999997,40.91459999999994,37.095,32.31333333333333,13116081,9106968.5,36.3971480355774,4.966401820287402,1.5,2.75,NaN,NaN,2.7407840204883223,1.4402247026548955,820.5013876476285,-0.4290693877788754,-3.2806647752978293,-2.851595387518954,115.47452976957905,-14.50320512820513,27.37470315924884,39.96349393969719,32.66180290105399,4863234225
1546266600,32.67,32.92,31.88,32.9,26.439230769230768,46.03,55.38,39.2,55.38,38.42,54.48,39.04,32.9575,21.64,45.66750000000005,46.383799999999965,40.60699999999994,36.5415,40.00919023906001,35.409052968883906,33.726923076923086,40.641729418792835,26.812116735053337,45.66750000000005,46.383799999999965,40.60699999999994,36.5415,32.56666666666666,9072110,9329161.7,39.29686791323244,3.783478965679855,1.5,2.75,NaN,NaN,2.6192994475963,0.9724464310657195,825.3878537551961,-0.1944232752317201,-3.094624481558604,-2.900201206326884,116.17569039400163,-6.719591721009369,57.96005401020797,13.861840849484537,28.178105140307476,4872306335
1546439400,31.32,33.32,31.26,32.93,26.162307692307692,45.97,55.38,27.54,55.38,38.42,54.48,39.04,32.9575,21.64,45.59735000000005,46.199299999999965,40.34059999999994,35.94499999999999,39.73157493556746,35.17295268613306,33.20692307692309,39.20586854638371,27.207977607462468,45.59735000000005,46.199299999999965,40.34059999999994,35.94499999999999,32.50333333333333,10632782,9655637.45,39.39716500217687,3.455536151696591,1.5,2.75,NaN,NaN,2.579349487053707,1.1011993827502295,830.281727476493,-0.00880453766795286,-2.911206878411825,-2.902402340743872,112.40018902157868,-6.182336182336187,76.12211353542767,4.825291475356409,19.052594989215905,4882939117
1546525800,32.17,32.2699,30.34,30.49,25.885384615384616,45.91,55.38,27.54,55.38,38.42,54.48,39.04,32.9575,21.64,45.524550000000055,45.99259999999997,40.02919999999994,35.144499999999994,39.36916023221187,34.72695719221562,32.50538461538463,37.371061043240445,27.639708187528814,45.524550000000055,45.99259999999997,40.02919999999994,35.144499999999994,31.033299999999997,10652689,9884789.15,34.41640128140703,7.578976717089445,1.5,2.75,NaN,NaN,2.580110237978442,1.0776850004939154,827.4561530273337,-0.021255212176495952,-2.9289713559644923,-2.9077161437879964,119.31860736629774,-8.630506442912793,49.98857264510181,19.20743548684444,30.803991868053764,4872286428
1546612200,31.8,33.86,31.641,33.57,25.608461538461537,45.85,55.38,27.54,55.38,38.42,54.48,39.04,32.9575,21.64,45.46605000000005,45.82729999999996,39.79019999999994,34.717999999999996,39.14174218388983,34.61677079295699,32.20769230769232,36.229709817856964,28.185674797527675,45.46605000000005,45.82729999999996,39.79019999999994,34.717999999999996,33.023666666666664,13208759,10147653.35,44.03464552066992,1.4085505579604964,1.5,2.75,NaN,NaN,2.6365309352656965,1.3016565056393063,829.2627961550329,0.1951226772032406,-2.6638127972839456,-2.858935474487186,131.93579752628492,5.301129234629865,48.84267897698276,20.04873924358867,31.108581779428576,4885495187
1546871400,33.75,35.02,33.32,34.38,25.33153846153846,45.79,55.38,27.54,55.38,38.42,54.48,39.04,32.9575,21.64,45.412750000000045,45.675899999999956,39.58299999999994,34.343999999999994,38.95500719628631,34.59422119362775,32.139230769230785,35.976469051268545,28.301992487193026,45.412750000000045,45.675899999999956,39.58299999999994,34.343999999999994,34.24,7799493,10040129.2,46.26649407155887,3.265314484062672,1.5,2.75,NaN,NaN,2.569635868461004,0.7768319355890361,832.4079854289657,0.3982721698566962,-2.361095262166316,-2.759367432023012,129.02024882240693,14.944834503510538,77.62040500370661,4.2432851898808455,18.136309806412548,4893294680
1546957800,35.39,35.58,34.24,35.31,25.054615384615385,45.73,55.38,27.54,55.38,38.42,54.48,39.04,32.9575,21.64,45.38085000000004,45.52449999999996,39.475399999999944,34.16499999999999,38.812065737608414,34.662390603758446,32.15538461538463,36.04377059958555,28.266998631183704,45.38085000000004,45.52449999999996,39.475399999999944,34.16499999999999,35.04333333333333,7245655,9926403.1,48.79154281732073,4.30596794664749,1.5,2.75,NaN,NaN,2.4818047349995034,0.7299376145625197,837.3267281393285,0.5892313044460709,-2.022828301465424,-2.6120596059114947,120.928769742456,28.213507625272346,76.95413024215051,4.4834861136094055,18.56238364424008,4900540335
1547044200,35.68,36.24,35.14,35.83,24.777692307692305,45.67,55.38,27.54,55.38,38.42,54.48,39.04,32.9575,21.64,45.365350000000035,45.38919999999997,39.33359999999994,34.00249999999999,38.6951219831924,34.773591498638595,32.344615384615395,36.66631459021366,28.022916179017134,45.365350000000035,45.38919999999997,39.33359999999994,34.00249999999999,35.736666666666665,7309460,9864583.15,50.2006793851446,5.346873131703251,1.5,2.75,NaN,NaN,2.383104396785253,0.7409801193677403,840.855183892204,0.735031145889864,-1.693270673549165,-2.428301819439029,103.40347005339704,13.63780526482714,75.44584992532029,5.049292163904867,19.50485791077483,4907849795
1547130600,35.15,36.33,34.825,36.23,24.50076923076923,45.61,55.38,27.54,55.38,38.42,54.48,39.04,32.9575,21.64,45.33555000000003,45.24639999999996,39.246999999999936,33.85949999999999,38.59845053287113,34.91229707019682,32.679230769230784,37.45498016053271,27.90348137792886,45.33555000000003,45.24639999999996,39.246999999999936,33.85949999999999,35.794999999999995,5935757,9801460.55,51.31058808057381,4.763924607355744,1.5,2.75,NaN,NaN,2.320382654157735,0.6055992338815259,843.3581233406031,0.835549544338483,-1.3838648890159249,-2.219414433354408,76.67025598095587,12.51552795031054,100,0,0,4913785552
1547217000,35.7,36.24,35.4301,36.24,24.223846153846154,45.55,55.38,27.54,55.38,38.42,54.48,39.04,32.9575,21.64,45.31715000000003,45.098799999999954,39.17439999999994,33.68699999999999,38.5059622766801,35.03874496827331,33.166153846153854,38.00362005171445,28.32868764059326,45.31715000000003,45.098799999999954,39.17439999999994,33.68699999999999,35.97003333333333,5612331,9741996.8,51.33978671469325,4.1319289474996115,1.5,2.75,NaN,NaN,2.212491036003611,0.5760965760120142,845.4511958144923,0.8756237957048763,-1.1248846887233128,-2.000508484428189,76.88785176592495,13.21462043111529,100,0,0,4919397883
1547476200,35.37,35.97,35.1701,35.58,23.946923076923078,45.489999999999995,55.38,27.54,55.38,38.42,54.48,39.04,32.9575,21.64,45.296850000000035,44.94119999999995,39.05159999999994,33.48549999999999,38.39121865798676,35.090293066533,33.78461538461539,37.516149326860884,30.0530814423699,45.296850000000035,44.94119999999995,39.05159999999994,33.48549999999999,35.57336666666666,3991540,9673335.1,49.24092962174901,2.9377158517798154,1.5,2.75,NaN,NaN,2.130877390574782,0.41263328094567925,842.243133055339,0.8309585096929262,-0.9618103473120314,-1.7927688570049576,78.25673985005213,8.145896656534955,84.87823588731429,2.023257359173331,13.098506753512389,4915406343
1547562600,35.77,36.95,35.77,36.81,23.669999999999998,45.43,55.38,27.54,55.38,38.42,54.48,39.04,32.9575,21.64,45.27445000000002,44.79269999999996,38.92759999999994,33.453999999999986,38.32921008316375,35.25407467924414,34.19076923076924,38.00084866897572,30.380689792562762,45.27445000000002,44.79269999999996,38.92759999999994,33.453999999999986,36.51,6128399,9632274.2,53.08987099301897,4.401833434394051,1.5,2.75,NaN,NaN,2.0765290055337267,0.6362359368880923,845.3019435821745,0.8542430135146839,-0.7249650901116027,-1.5792081036262866,78.86047665426038,11.78256908593988,84.39306390292114,2.148316179544191,13.458619917534666,4921534742
1547649000,37.01,37.48,36.9001,37.02,23.393076923076922,45.37,55.38,27.54,55.38,38.42,54.48,39.04,32.9575,21.64,45.267450000000025,44.64679999999996,38.78019999999994,33.541499999999985,38.277868511274974,35.42225804312565,34.56153846153847,38.46158064003896,30.661496283037977,45.267450000000025,44.64679999999996,38.78019999999994,33.541499999999985,37.13336666666667,5783692,9451365.4,53.734901117204735,5.236312769282052,1.5,2.75,NaN,NaN,1.976062647995603,0.6119424818767455,847.8680506844556,0.8518555073144634,-0.5143887194832075,-1.3662442267976709,78.67965265770565,21.416857986225008,83.56132494382548,2.370639407268762,14.068035648905752,4927318434
1547735400,36.64,38.31,36.63,37.91,23.116153846153846,45.309999999999995,55.38,27.54,55.38,38.42,54.48,39.04,32.9575,21.64,45.257350000000024,44.512199999999964,38.66879999999994,33.68199999999998,38.26344229514655,35.65918584854226,35.015384615384626,38.99447314947509,31.036296081294164,45.257350000000024,44.512199999999964,38.66879999999994,33.68199999999998,37.61666666666667,5419357,9344125,56.466946421878454,5.27945696512658,1.5,2.75,NaN,NaN,1.954915315995917,0.5799747969981138,851.5329951836013,0.8749568999843138,-0.2725481018172786,-1.1475050018015924,54.78873425624951,12.928209711051524,83.38354485038018,2.4194515402117807,14.197003609408048,4932737791
1547821800,38.78,39.61,38.37,39.35,22.839230769230767,45.25,55.38,27.54,55.38,38.42,54.48,39.04,32.9575,21.64,45.248000000000026,44.38319999999997,38.570999999999934,33.98099999999998,38.30605240121923,36.0106919582049,35.51153846153848,39.899338654407835,31.12373826866912,45.248000000000026,44.38319999999997,38.570999999999934,33.98099999999998,39.10999999999999,7009746,9095448.75,60.5283559783975,7.7077182237856725,1.5,2.75,NaN,NaN,1.936707079139066,0.7706872077092403,855.9551615707419,0.9459287388259625,0.03490592173086071,-0.9110228170951018,30.649320726832197,14.456079115764975,84.63818816593422,2.0847043800393137,13.277107454026472,4939747537
1548167400,38.64,38.73,37,37.81,22.56230769230769,45.19,55.38,27.54,55.38,38.42,54.48,39.04,32.9575,21.64,45.226550000000024,44.22649999999998,38.42559999999994,34.27749999999998,38.2865993658773,36.18205462885206,35.88692307692309,40.16057318041783,31.61327297342835,45.226550000000024,44.22649999999998,38.42559999999994,34.27749999999998,37.846666666666664,7651468,8791775.15,54.655682081059275,3.736780229022481,1.5,2.75,NaN,NaN,1.966228002057704,0.8702984174930816,851.3856977072236,0.8508517837418367,0.15254191258219407,-0.6983098711596426,43.64291236817389,7.080147267063155,71.8731445898785,6.525947302237606,21.6009081078839,4932096069
1548253800,38.3,38.6,36.83,37.96,22.285384615384615,45.129999999999995,55.38,27.54,55.38,38.42,54.48,39.04,32.9575,21.64,45.21965000000002,44.06979999999998,38.22699999999993,34.679999999999986,38.2737915476076,36.35138275943758,36.461538461538474,39.51172227596264,33.41135464711431,45.21965000000002,44.06979999999998,38.22699999999993,34.679999999999986,37.796666666666674,7529414,8532609.3,55.11251511549964,3.01592890795843,1.5,2.75,NaN,NaN,1.9522117161964396,0.8824280750789796,851.723759409115,0.7625953411445482,0.25493430527104266,-0.5076610358735055,42.30059479539454,5.944739045492612,73.41674901876407,5.872842640739358,20.71040834049658,4939625483
1548340200,37.93,38.34,37.43,38.06,22.00846153846154,45.07,55.38,27.54,55.38,38.42,54.48,39.04,32.9575,21.64,45.21100000000001,43.90589999999998,38.03499999999993,35.20599999999998,38.26540756534848,36.514108210919716,36.80692307692309,39.460227369430655,34.15361878441553,45.21100000000001,43.90589999999998,38.03499999999993,35.20599999999998,37.943333333333335,6140551,8452166,55.4348618750354,2.864804824750176,1.5,2.75,NaN,NaN,1.8777680221824085,0.7265061997125943,855.2979726092473,0.678311419966009,0.3402282390840057,-0.3380831808820033,42.094459713977876,5.051062655258089,73.88464588931606,5.6810759536618205,20.434278157022096,4945766034
1548426600,38.91,39.4001,38.7281,39.1,21.731538461538463,45.01,55.38,27.54,55.38,38.42,54.48,39.04,32.9575,21.64,45.19755000000001,43.759399999999985,37.89039999999993,35.584499999999984,38.298136680432854,36.760383619403555,37.17000000000001,39.68363053401619,34.65636946598383,45.19755000000001,43.759399999999985,37.89039999999993,35.584499999999984,39.07606666666666,6643178,8089603.4,58.7523916653181,4.864645584386598,1.5,2.75,NaN,NaN,1.8393631634550935,0.8211994669602715,859.5602098934287,0.6593782957271752,0.4861396887769658,-0.17323860695020946,43.739665694991345,7.891832229580572,75.10230658969532,5.195615305446817,19.702078104857875,4952409212
1548685800,37.97,38.14,37.26,38.14,21.454615384615384,44.949999999999996,55.38,27.54,55.38,38.42,54.48,39.04,32.9575,21.64,45.18290000000001,43.60329999999999,37.78039999999993,35.88149999999998,38.291935241984504,36.89177565565083,37.38769230769232,39.70151902610497,35.07386558927967,45.18290000000001,43.60329999999999,37.78039999999993,35.88149999999998,37.84666666666667,5606745,7624460.35,54.7041847558228,1.6420202050834645,1.5,2.75,NaN,NaN,1.83940865177973,0.7353628640747014,857.621386501632,0.5532601064631157,0.5183365261286852,-0.03492358033443052,47.49217957924745,7.195053400786966,51.053203801435785,18.47173545256694,30.475060745997272,4946802467
1548772200,38.18,38.44,37.56,37.94,21.177692307692308,44.89,55.38,27.54,55.38,38.42,54.48,39.04,32.9575,21.64,45.16205000000001,43.44769999999998,37.67119999999993,36.17799999999998,38.278133859945896,36.99160654558885,37.55000000000001,39.69375658778984,35.40624341221018,45.16205000000001,43.44769999999998,37.67119999999993,36.17799999999998,37.98,4434812,7190396.9,53.87138849467938,1.5242300542115772,1.5,2.75,NaN,NaN,1.7708794623668918,0.6167687349776199,859.4701787525042,0.4452993311356481,0.5217005835851296,0.07640125244948151,45.68433881621282,3.0698179842433997,60.16899774576333,12.55520293532149,27.275799318915166,4942367655
1548858600,38.67,40.15,38.32,39.74,20.900769230769228,44.83,55.38,27.54,55.38,38.42,54.48,39.04,32.9575,21.64,45.15210000000001,43.314199999999985,37.61559999999993,36.51999999999999,38.33546194386959,37.25335830315182,37.82000000000001,40.10991098248215,35.53008901751787,45.15210000000001,43.314199999999985,37.61559999999993,36.51999999999999,39.403333333333336,7311062,7102344.5,59.80259954382368,4.700376724825368,1.5,2.75,NaN,NaN,1.8022452150549708,1.029387127025449,864.670911301638,0.46846354118471606,0.6619806789303766,0.19351713774566054,48.84798647688118,7.347379794705561,60.35929123731257,12.443552774885976,27.19715598780145,4949678717
1548945000,39.72,41.01,39.6,40.8,20.623846153846152,44.769999999999996,55.38,27.54,55.38,27.54,54.48,38.42,32.9575,39.04,45.14245000000001,43.19619999999998,37.55419999999993,36.913499999999985,38.43211049509039,37.59113370285165,38.17076923076923,40.76226373915281,35.579274722385655,45.14245000000001,43.19619999999998,37.55419999999993,36.913499999999985,40.47,8228158,6982113.3,62.83331307730733,6.002857065421634,1.5,2.75,NaN,NaN,1.7742276996939013,1.1784624004884023,869.3277637268071,0.5243072511910083,0.8489012017344209,0.32459395054341256,49.96324977402545,7.623318385650227,64.09691987777208,10.346715825643233,25.556364296584686,4957906875
1549031400,40.8699,41.35,40.44,40.83,20.346923076923076,44.709999999999994,55.38,27.54,55.38,27.54,54.48,38.42,32.9575,39.04,45.12615000000001,43.082599999999985,37.488399999999935,37.43049999999999,38.526145377635864,37.89959715972292,38.57461538461539,41.059382705523575,36.08984806370721,45.12615000000001,43.082599999999985,37.488399999999935,37.43049999999999,40.87333333333333,5232202,6711088.95,62.91852571038723,5.682914766181859,1.5,2.75,NaN,NaN,1.7124971497157657,0.7796353228189592,871.372476680703,0.530779223093376,0.9880679794101326,0.4572887563167566,49.34139343944258,3.761118170266828,62.490447553725176,11.225595660321604,26.283956785953205,4963139077
1549290600,40.88,41.72,40.52,41.69,20.07,44.65,55.38,27.54,55.38,27.54,54.48,38.42,32.9575,39.04,45.11375000000001,42.97459999999998,37.48059999999994,37.83649999999999,38.65021810792465,38.26058790641598,38.95,41.71381007919252,36.186189920807486,45.11375000000001,42.97459999999998,37.48059999999994,37.83649999999999,41.31,3941425,6247722.25,65.3696687801822,5.849870542766184,1.5,2.75,NaN,NaN,1.6758902104503535,0.6308579098566681,874.6003792255004,0.5577255823337967,1.1544457342340024,0.5967201519002058,46.529848123729195,10.26183549325574,83.14545076376923,2.489586859885456,14.36496237634533,4967080502
1549377000,41.93,42.36,41.65,42.21,19.793076923076924,44.589999999999996,55.38,27.54,55.38,27.54,54.48,38.42,32.9575,39.04,45.10755,42.86619999999998,37.53219999999993,38.22799999999999,38.78981739780996,38.63672239151922,39.34923076923077,42.3699944173422,36.328467121119346,45.10755,42.86619999999998,37.53219999999993,38.22799999999999,42.07333333333333,5332007,6124347.95,66.79874611080363,6.431721967661126,1.5,2.75,NaN,NaN,1.6068980525610426,0.8706244392923495,877.2933954617304,0.5731231431083599,1.3131240807856557,0.7400009376772958,36.315974607788164,11.19599578503688,100,0,0,4972412509
1549463400,42.07,42.3,41.6532,42.05,19.516153846153845,44.529999999999994,55.38,27.54,55.38,27.54,54.48,38.42,32.9575,39.04,45.1062,42.755999999999986,37.57299999999994,38.56499999999998,38.91766769593506,38.96179644946977,39.66769230769231,42.88115584863907,36.45422876674556,45.1062,42.755999999999986,37.57299999999994,38.56499999999998,42.00106666666667,3422335,5933181.95,65.8976515981542,5.166861480116687,1.5,2.75,NaN,NaN,1.5383196202352536,0.5768127505343065,874.8370347664804,0.5357727001928071,1.4097168129183046,0.8739441127254975,37.12860424648599,10.483447188649487,84.52072448693976,2.1186053466265955,13.360670166433659,4968990174
1549549800,41.2,41.46,39.98,40.82,19.23923076923077,44.47,55.38,27.54,55.38,27.54,54.48,38.42,32.9575,39.04,45.09884999999999,42.624799999999986,37.60539999999993,38.81449999999999,38.99226896276114,39.13876821618694,39.78076923076924,43.04461746949661,36.51692099204187,45.09884999999999,42.624799999999986,37.60539999999993,38.81449999999999,40.75333333333334,7435011,5939459.5,59.27758513343772,1.9163033752257153,1.5,2.75,NaN,NaN,1.5762967902184497,1.2517992588382831,871.3153449944285,0.39781276775494134,1.3712100724191743,0.9733973046642329,43.60023929735972,4.398976982097183,42.51377178246795,24.96113326249931,32.525094955032756,4961555163
1549636200,40.16,40.99,39.75,40.94,18.96230769230769,44.41,55.38,27.54,55.38,27.54,54.48,38.42,32.9575,39.04,45.10035,42.494599999999984,37.604199999999935,39.04999999999999,39.06865057206462,39.31031410035961,40.021538461538476,43.126252952599756,36.916823970477196,45.10035,42.494599999999984,37.604199999999935,39.04999999999999,40.56,4921035,5888723.4,59.702915951099904,1.1691043184975023,1.5,2.75,NaN,NaN,1.552275590917132,0.8356709367602492,870.2791576510749,0.28927199442746243,1.3349872976985608,1.0457153032710984,41.720074385938624,7.341373885684313,41.79987264627023,25.56285925611042,32.63726809761935,4966476198
1549895400,41.28,41.4069,40.75,41.03,18.685384615384613,44.349999999999994,55.38,27.54,55.38,27.54,54.48,38.42,32.9575,39.04,45.10115,42.37399999999998,37.59679999999993,39.28949999999999,39.14556623590522,39.47409370984917,40.25769230769232,43.15966144124129,37.35572317414334,45.10115,42.37399999999998,37.59679999999993,39.28949999999999,41.0623,4301752,5823194.45,60.040020436507305,2.0016792769659224,1.5,2.75,NaN,NaN,1.4883201915659083,0.73872717748589,873.4984178710068,0.2022866274759536,1.2985735876160405,1.0962869601400869,37.40629466094765,8.144438587243025,43.32273373159694,24.260950325699,32.41631594270406,4970777950
1549981800,41.83,42.779,41.78,42.61,18.408461538461538,44.29,55.38,27.54,55.38,27.54,54.48,38.42,32.9575,39.04,45.103699999999996,42.26089999999997,37.56359999999993,39.640999999999984,39.28142638351678,39.7727514517683,40.60769230769232,43.46214258586017,37.753242029524465,45.103699999999996,42.26089999999997,37.56359999999993,39.640999999999984,42.38966666666666,4793923,5863313.6,65.49694251781597,4.793719496444878,1.5,2.75,NaN,NaN,1.5069401778826295,0.8176132690565963,877.4693649938771,0.2279989552613222,1.3812856542167395,1.1532866989554174,40.16392498454279,7.221942627075988,42.092903051088214,25.286101783317108,32.62099516559468,4975571873
1550068200,43.02,43.4499,42.81,42.98,18.13153846153846,44.23,55.38,27.54,55.38,27.54,54.48,38.42,32.9575,39.04,45.10759999999999,42.14949999999997,37.543799999999926,39.949499999999986,39.426468486123966,40.07820369445703,40.906153846153856,43.876639830340366,37.935667861967346,45.10759999999999,42.14949999999997,37.543799999999926,39.949499999999986,43.07996666666667,5265722,5820179.75,66.64563682523135,5.123017452558754,1.5,2.75,NaN,NaN,1.459294450891013,0.9047352876000092,880.5869122867975,0.24526110312261418,1.4598630778586852,1.214601974736071,33.52375297851909,5.3431372549019605,65.70770096435535,9.418284987430154,24.874014048214498,4980837595
1550154600,42.42,43.3,42,42.69,17.854615384615386,44.169999999999995,55.38,27.54,55.38,27.54,54.48,38.42,32.9575,39.04,45.11495,42.02259999999997,37.50039999999993,40.23299999999999,39.554450114119106,40.326946199746835,41.25615384615385,43.89406139059466,38.61824630171304,45.11495,42.02259999999997,37.50039999999993,40.23299999999999,42.663333333333334,6092333,5835611.8,64.82399235815797,4.146790213953102,1.5,2.75,NaN,NaN,1.4479162758273691,1.0439921654829747,881.8541464218101,0.21364327381455617,1.4816560670042662,1.26801279318971,32.20278165152971,4.555473916238059,69.94652693001927,7.362614395353867,22.690858674626874,4974745262
1550241000,43.6,44.08,43.49,44.07,17.577692307692306,44.11,55.38,27.54,55.38,27.54,54.48,38.42,32.9575,39.04,45.128099999999996,41.910799999999966,37.45179999999993,40.541,39.73153050180071,40.68342751405666,41.72769230769231,43.99081681694466,39.46456779843996,45.128099999999996,41.910799999999966,37.45179999999993,40.541,43.879999999999995,5479180,5838602.95,69.14585696368732,5.199727926607518,1.5,2.75,NaN,NaN,1.443779398982557,0.9384402479363663,886.0766510641457,0.2591344429764788,1.5919308469103086,1.3327964039338298,35.612760886238895,5.708803070280649,71.19051080430884,6.803728855773531,22.00576033991763,4980224442
1550586600,43.66,44.64,43.64,44.3,17.30076923076923,44.05,55.38,27.54,55.38,27.54,54.48,38.42,32.9575,39.04,45.14679999999999,41.80649999999997,37.49579999999993,40.78849999999999,39.910686168396765,41.02786298890841,42.07846153846154,44.412950066253124,39.743973010669954,45.14679999999999,41.80649999999997,37.49579999999993,40.78849999999999,44.19333333333333,3781759,5677203.6,69.81158726142446,5.57751560805158,1.5,2.75,NaN,NaN,1.412080870483803,0.6661305928855538,889.0342265487703,0.27659038306840444,1.6785343827693353,1.4019439997009309,34.60959690897406,4.951433309642256,72.64357941538464,6.21471940549209,21.141701179123274,4984006201
1550673000,44.28,44.7783,44.0085,44.56,17.02384615384615,43.989999999999995,55.38,27.54,55.38,27.54,54.48,38.42,32.9575,39.04,45.168099999999995,41.70799999999998,37.549799999999934,41.126,40.093012201008655,41.36425698996475,42.36769230769231,44.91859144143565,39.816793173948966,45.168099999999995,41.70799999999998,37.549799999999934,41.126,44.448933333333336,4334608,5511360.6,70.58425864371898,4.829474430015117,1.5,2.75,NaN,NaN,1.366203665449246,0.786486008554766,891.5342265487703,0.2768434399707489,1.747998299664367,1.4711548596936181,34.37562535472163,5.969084423305601,72.31693913411688,6.353955265802348,21.329105600080766,4988340809
1550759400,44.23,44.4,43.55,44.07,16.746923076923075,43.93,55.38,27.54,55.38,27.54,54.48,38.42,32.9575,39.04,45.179199999999994,41.609699999999975,37.65339999999993,41.4315,40.24897250685145,41.6219468004443,42.61692307692307,45.15123390256123,40.082612251284914,45.179199999999994,41.609699999999975,37.65339999999993,41.4315,44.00666666666666,4584317,5364105.75,67.0986719556496,3.2113302893683455,1.5,2.75,NaN,NaN,1.340760546488586,0.8546283786444739,889.4955382449829,0.21780656724150282,1.7434130687454967,1.525606501503994,35.324697764417415,7.961783439490445,44.521758503221754,23.37747049338467,32.100771003393575,4983756492
1550845800,44.41,44.98,44.26,44.91,16.47,43.87,55.38,27.54,55.38,27.54,54.48,38.42,32.9575,39.04,45.19249999999999,41.51539999999997,37.76999999999993,41.774,40.43175789873963,41.93509472421151,42.864615384615384,45.608858201687745,40.12037256754302,45.19249999999999,41.51539999999997,37.76999999999993,41.774,44.71666666666666,6849299,5399543.15,69.84756771264121,3.9946770422796227,1.5,2.75,NaN,NaN,1.3099919360251153,1.2684960208161313,893.2543987449302,0.20908379333126836,1.7869612431680792,1.5778774498368109,28.3516643866319,9.697117733268195,79.83358076434601,3.5100537944823706,16.656365441171623,4990605791
1551105000,45.63,45.91,45.0018,45.08,16.193076923076923,43.809999999999995,55.38,27.54,55.38,27.54,54.48,38.42,32.9575,39.04,45.20659999999999,41.42299999999997,37.88979999999993,42.073,40.614041902710625,42.234609512381844,43.08538461538462,46.037365597026664,40.133403633742574,45.20659999999999,41.42299999999997,37.88979999999993,42.073,45.330600000000004,5170808,5325924.65,70.38681050257851,4.657832665143466,1.5,2.75,NaN,NaN,1.287849654880464,0.9708751700045174,893.0399762379626,0.18911980502065928,1.814277206112635,1.6251574010919758,28.28394312766184,9.870826224713618,79.75072365414229,3.5411493372948275,16.70812700856286,4995776599
1551191400,44.84,45.4155,44.75,44.97,15.916153846153845,43.75,55.38,27.54,55.38,27.54,54.48,38.42,32.9575,39.04,45.21409999999999,41.32379999999998,37.99539999999993,42.414500000000004,40.78486378887884,42.495122892155,43.31000000000001,46.3555516110197,40.26444838898032,45.21409999999999,41.32379999999998,37.99539999999993,42.414500000000004,45.04516666666667,3184654,5204820.1,69.52044138312607,3.6729559471909923,1.5,2.75,NaN,NaN,1.2433961081032883,0.611866296781324,890.9583102384964,0.1448565983989849,1.8062281490907068,1.661371550691722,28.848514535835847,5.538605961042007,61.14801981065058,11.962263931508357,26.88971625784106,4992591945
1551277800,44.57,45.07,44.055,44.87,15.639230769230767,43.69,55.38,27.54,55.38,27.54,54.48,38.42,32.9575,39.04,45.21485,41.22449999999997,38.10059999999993,42.761,40.945065208922806,42.72130166433072,43.621538461538464,46.40150908843194,40.841567834644984,45.21485,41.22449999999997,38.10059999999993,42.761,44.665,3532526,5159705.8,68.69266309752842,2.6968844964520082,1.5,2.75,NaN,NaN,1.2270821003816248,0.6846370969445583,892.126676347676,0.08799148207556051,1.7713609032861726,1.683369421210612,22.853993943557683,4.3973941368078195,37.90688359428591,29.082034213530807,33.011082192183295,4989059419
1551364200,44.75,44.98,44.45,44.58,15.362307692307692,43.629999999999995,55.38,27.54,55.38,27.54,54.48,38.42,32.9575,39.04,45.2129,41.12109999999997,38.24339999999993,43.003,41.08761167131799,42.898320553442076,43.901538461538465,46.24350142720303,41.5595754958739,45.2129,41.12109999999997,38.24339999999993,43.003,44.669999999999995,3285363,4958420.85,66.22981442191818,2.0361090770579917,1.5,2.75,NaN,NaN,1.1772905217829368,0.662582523627457,890.723003654452,0.01388278974160495,1.7007229083876183,1.6868401186460134,23.64511656816099,4.427266338721013,41.98059017900425,25.493596991461295,32.52581282953446,4985774056
1551450600,45.4499,45.66,44.69,45.45,15.085384615384614,43.56999999999999,55.38,27.54,55.38,27.54,54.48,38.42,32.9575,39.04,45.2146,41.03949999999997,38.44699999999993,43.23550000000001,41.25868572342316,43.14133764359045,44.24153846153847,46.03681167672321,42.446265246353725,45.2146,41.03949999999997,38.44699999999993,43.23550000000001,45.26666666666667,4276987,4760862.3,69.73545554068725,2.8765511244919924,1.5,2.75,NaN,NaN,1.1703411987984411,0.8983639371380265,893.6119747249464,0.006847906481252775,1.6954000017475792,1.6885520952663264,24.170538715451777,3.1313818924438452,33.88127925185902,32.91609735111774,33.20262339702325,4990051043
1551709800,46,46.12,43.69,44.89,14.808461538461538,43.51,55.38,27.54,55.38,27.54,54.48,38.42,32.9575,39.04,45.218,40.960499999999975,38.64279999999994,43.438500000000005,41.401090204857546,43.30787691562945,44.416923076923084,45.96943735760329,42.86440879624288,45.218,40.960499999999975,38.64279999999994,43.438500000000005,44.9,7861734,4892338.9,65.05419541262879,1.642293241847717,1.5,2.75,NaN,NaN,1.2603168274556953,1.6069479569373248,891.8051250127809,-0.04905249950559387,1.627236470884334,1.676288970389928,20.043084322300476,1.331828442437931,4.725035248173686,76.30505741900942,18.969907332816906,4982189309
1551796200,44.99,45.1,44.44,44.74,14.53153846153846,43.449999999999996,55.38,27.54,55.38,27.54,54.48,38.42,32.9575,39.04,45.217749999999995,40.881299999999975,38.87019999999993,43.59100000000001,41.53202784388274,43.44426959033141,44.5523076923077,45.8690438400762,43.2355715445392,45.217749999999995,40.881299999999975,38.87019999999993,43.59100000000001,44.76,3892042,4889869.75,63.818410102767,1.467894476948138,1.5,2.75,NaN,NaN,1.217437054066003,0.7959398100532228,890.5786064331878,-0.10637343406813926,1.543322177804754,1.6496956118728932,20.118759651479127,0.40394973070017887,4.426871140820228,77.11438432187346,18.45874453730631,4978297267
1551882600,44.8,44.8,43.76,43.88,14.254615384615384,43.38999999999999,55.38,27.54,55.38,27.54,54.48,38.42,32.9575,39.04,45.213899999999995,40.795499999999976,39.110199999999935,43.67450000000001,41.624105183338315,43.485767724585564,44.64384615384616,45.5226053651659,43.76508694252642,45.213899999999995,40.795499999999976,39.110199999999935,43.67450000000001,44.14666666666667,4327952,4839667,57.11894994189877,0.46585584420419507,1.5,2.75,NaN,NaN,1.2047629787755743,0.8942664856900279,886.4995680395382,-0.20664796505075733,1.3913856555594464,1.5980336206102037,22.90637954799357,-0.431132289539364,4.151682542264402,77.88357374602826,17.964743711707335,4973969315
1551969000,43.65,43.7187,42.36,42.82,13.977692307692307,43.33,55.38,27.54,55.38,27.54,54.48,38.42,32.9575,39.04,45.20645,40.748799999999974,39.36839999999993,43.71300000000001,41.671003019285834,43.42236127462503,44.547692307692316,45.83510244128262,43.26028217410201,45.20645,40.748799999999974,39.36839999999993,43.71300000000001,42.96623333333333,6250689,4981084.7,50.133223768087625,2.872499187919097,1.5,2.75,NaN,NaN,1.2272799088630335,1.254885105647772,883.0096145612094,-0.3408809617607129,1.1719324184093125,1.5128133801700254,26.014326587485932,-4.653751948341119,3.297071490012594,80.43362285084116,16.269305659146248,4967718626
1552055400,41.79,42.6,41.56,42.53,41.56,43.269999999999996,45.45,27.54,55.38,27.54,54.48,38.42,32.9575,39.04,45.192699999999995,40.73139999999997,39.668199999999935,43.798500000000004,41.704689175392275,43.33737448656551,44.41153846153847,46.08994147821549,42.733135444861446,45.192699999999995,40.73139999999997,39.668199999999935,43.798500000000004,42.23,6246255,4921646.9,48.3895712806685,3.8651059991594914,1.5,2.75,NaN,NaN,1.2296170582299595,1.2691391981005382,881.4714105992553,-0.43944521360213207,0.9635068631673605,1.4029520767694925,22.03360716930666,-5.65661047027506,0,100,0,4961472371
1552311000,42.88,44.45,42.87,44.4,41.85163265306123,43.209999999999994,45.45,27.54,55.38,27.54,54.48,38.42,32.9575,39.04,45.1902,40.713699999999974,39.92559999999994,43.971500000000006,41.81038763910238,43.43857691641641,44.399230769230776,46.0754437452062,42.72301779325535,45.1902,40.713699999999974,39.92559999999994,43.971500000000006,43.906666666666666,3862525,4868721.4,58.42982050128636,0.9141790438554928,1.5,2.75,NaN,NaN,1.2789301254992484,0.7933345703453066,886.6537983556029,-0.371638347848555,0.9384041419587987,1.3100424898073537,35.438331264459705,-1.2675116744496338,2.9994152716020896,81.3778199980779,15.62276473032002,4965334896
1552397400,44.65,45.14,44.57,44.87,42.14326530612245,43.15,45.45,27.54,55.38,27.54,54.48,38.42,32.9575,39.04,45.18814999999999,40.70889999999997,40.17899999999993,44.163500000000006,41.930372437568955,43.57490292437675,44.46076923076923,46.14284599730538,42.77869246423308,45.18814999999999,40.70889999999997,40.17899999999993,44.163500000000006,44.86000000000001,3725802,4839923.9,60.50924609924818,1.9618342452487132,1.5,2.75,NaN,NaN,1.2404351165350165,0.7698059054192979,888.7284067523854,-0.2916055270542093,0.945535580989592,1.2371411080438013,36.089044144388886,0,13.081093167367943,59.11232490076397,27.806581931868077,4969060698
1552483800,45.35,46.25,45.26,45.76,42.43489795918367,43.089999999999996,45.45,27.54,55.38,27.54,54.48,38.42,32.9575,39.04,45.191849999999995,40.68429999999997,40.45399999999994,44.321000000000005,42.08055391060547,43.78300740776944,44.526153846153846,46.33434952075135,42.71795817155634,45.191849999999995,40.68429999999997,40.45399999999994,44.321000000000005,45.75666666666666,4906407,4845548.1,64.16476149612976,3.4843298871090522,1.5,2.75,NaN,NaN,1.2504040367825155,1.0125597556239305,892.2488127555285,-0.18063712042510405,1.0113447075124213,1.1919818279375254,37.78247261439576,2.646926873037236,35.32055450092974,31.38552075070839,33.29392474836186,4973967105
1552570200,45.77,45.9799,45.41,45.65,42.7265306122449,43.029999999999994,45.45,27.54,55.38,27.54,54.48,38.42,32.9575,39.04,45.19685,40.65799999999997,40.70899999999993,44.4545,42.220532188620936,43.960816226077114,44.57,46.45576856398739,42.68423143601261,45.19685,40.65799999999997,40.70899999999993,44.4545,45.679966666666665,4316980,4798111,63.383819175647425,2.6705333673273133,1.5,2.75,NaN,NaN,1.2017966055837648,0.8997249125749696,890.676787193454,-0.11950199043985243,1.0426043398877098,1.1621063303275623,37.521070622961346,0.4400440044004306,40.21221442810229,26.899667711688195,32.888117860209505,4969650125
1552656600,45.95,46.75,45.85,46.33,43.01816326530613,42.97,45.45,27.54,55.38,27.54,54.48,38.42,32.9575,39.04,45.21275,40.65879999999997,40.97699999999993,44.6365,42.38168778906717,44.18645277597453,44.674615384615386,46.77609640646809,42.57313436276268,45.21275,40.65879999999997,40.97699999999993,44.6365,46.31,5508805,4768934.6,66.12830045959441,3.5842010904856245,1.5,2.75,NaN,NaN,1.1945254194706387,1.1551437505559419,892.7543432856544,-0.04211787373386788,1.1094589881602275,1.1515768618940954,36.85639744179249,3.2078413900645972,77.09176348638971,4.429560146266457,18.478676367343837,4975158930
1552915800,46.45,46.97,46.3167,46.78,43.30979591836735,42.91,45.45,27.54,55.38,27.54,54.48,38.42,32.9575,39.04,45.22255,40.66599999999997,41.30279999999994,44.772,42.55417062086846,44.433457273500764,44.82153846153846,47.20523754107328,42.43783938200364,45.22255,40.66599999999997,41.30279999999994,44.772,46.6889,4443081,4717129.65,67.84586229387266,3.6322179444475244,1.5,2.75,NaN,NaN,1.1558664609370217,0.9419035154142943,896.2461581553657,0.026812122260313265,1.185092014719487,1.1582798924591737,35.8850763906833,4.55967814036656,78.73386343475873,3.8645299998059355,17.401606565435323,4979602011
1553002200,47.4,47.8099,46.34,46.86,43.60142857142857,42.849999999999994,45.45,27.54,55.38,27.54,54.48,38.42,32.9575,39.04,45.237350000000006,40.67939999999997,41.56859999999994,44.9,42.72302667495205,44.6645565807864,44.99692307692307,47.608358103763344,42.38548805008279,45.237350000000006,40.67939999999997,41.56859999999994,44.9,47.0033,5591717,4807627.55,68.15501890978513,3.6656830658155504,1.5,2.75,NaN,NaN,1.1782974280129486,1.1630928023948113,893.5904790371462,0.06315616902174659,1.2372251037363569,1.1740689347146103,35.616871115648486,6.7912488605287065,80.72915665427038,3.210426678864799,16.060416666864818,4985193728
1553088600,46.72,47.38,45.8,46.39,43.8930612244898,42.78999999999999,45.45,27.54,55.38,27.54,54.48,38.42,32.9575,39.04,45.24295,40.69589999999997,41.808799999999934,44.991499999999995,42.86682955044413,44.82888452547341,45.06923076923076,47.7771162518504,42.36134528661111,45.24295,40.69589999999997,41.808799999999934,44.991499999999995,46.52333333333333,7503951,4966094.7,64.24674188078615,2.7239133593204645,1.5,2.75,NaN,NaN,1.206990468869167,1.5110366300505707,891.716545231758,0.04192709832780794,1.22647780762437,1.1845507092965621,33.66665550048027,8.337225595516115,44.587785575180455,23.274790358101274,32.13742406671828,4977689777
1553175000,45.93,48.17,45.91,47.92,44.18469387755103,42.73,45.45,27.54,55.38,27.54,54.48,38.42,32.9575,39.04,45.253,40.76819999999997,42.06099999999994,45.18399999999999,43.064993097485534,45.12327647542833,45.30230769230768,48.4016689550014,42.20294642961396,45.253,40.76819999999997,42.06099999999994,45.18399999999999,47.333333333333336,7996675,5136712.6,70.23122581464717,4.3513315192064,1.5,2.75,NaN,NaN,1.2822054353785128,1.556769012149911,895.592529727851,0.1132649432518893,1.3261318883614237,1.2128669451095344,30.826382908113512,12.673407006818715,71.8289459403472,6.543357011307994,21.627697048344828,4985686452
1553261400,47.16,47.47,45.1559,45.18,44.47632653061225,42.669999999999995,45.45,27.54,55.38,27.54,54.48,38.42,32.9575,39.04,45.248850000000004,40.79079999999997,42.24799999999994,45.19749999999999,43.147934544642965,45.12867871586372,45.33615384615383,48.41978346036386,42.252524231943795,45.248850000000004,40.79079999999997,42.24799999999994,45.19749999999999,45.935300000000005,10391484,5313821.85,53.09221535518539,0.5115813314580152,1.5,2.75,NaN,NaN,1.3880550471371904,1.9555574675504037,889.9895968224115,-0.033877288363171054,1.1705203346555706,1.2043976230187416,50.27494520527551,1.7567567567567595,36.14095556555341,30.65402236941431,33.20502206503227,4975294968
1553520600,45,45.62,44.38,45.02,44.76795918367347,42.61,45.45,27.54,55.38,27.54,54.48,38.42,32.9575,39.04,45.2381,40.83539999999998,42.423799999999936,45.19449999999999,43.22134887622559,45.11832836197194,45.423846153846135,48.399806642226714,42.447885665465556,45.2381,40.83539999999998,42.423799999999936,45.19449999999999,45.00666666666667,8812428,5495902.85,52.28975023270681,1.4871327841982458,1.5,2.75,NaN,NaN,1.3774796866273906,1.6034541076358364,890.9653016958235,-0.14551837452582883,1.0224996548614556,1.1680180293872844,44.527304814551904,0.3342990862491769,16.15018095116938,54.274174129551106,29.57564491927951,4966482540
1553607000,46.01,46.5823,45.32,46.03,45.0595918367347,42.55,45.45,27.54,55.38,27.54,54.48,38.42,32.9575,39.04,45.232800000000005,40.89699999999998,42.61959999999995,45.24749999999999,43.33149205755008,45.20515423226033,45.67076923076921,48.24746313561898,43.09407532591944,45.232800000000005,40.89699999999998,42.61959999999995,45.24749999999999,45.97743333333333,7546987,5714019.5,56.735203584825534,0.6668608546113026,1.5,2.75,NaN,NaN,1.3906811375825765,1.3207842570365746,894.7786554253727,-0.15405728779804861,0.9754464196397237,1.1295037074377723,45.88156881763092,0.5900349650349719,19.089401852117106,50.036812012485186,30.873786135397705,4974029527
1553693400,46.08,46.37,44.5,45.34,45.351224489795925,42.489999999999995,45.45,27.54,55.38,27.54,54.48,38.42,32.9575,39.04,45.22205000000001,40.933199999999985,42.81479999999995,45.27099999999999,43.410257074901054,45.21799668633077,45.886923076923054,47.74458719519938,44.02925895864673,45.22205000000001,40.933199999999985,42.81479999999995,45.27099999999999,45.403333333333336,7767625,5925774.45,53.095433599418705,0.5203148127744751,1.5,2.75,NaN,NaN,1.424918199183821,1.310820225363117,893.5130449357257,-0.2056650333484884,0.8724224157521618,1.0780874491006502,45.478058103304235,-0.6790799561883794,19.005761114657528,50.152555086072226,30.841683799270257,4966261902
1553779800,45.66,46.09,45.04,45.87,45.642857142857146,42.42999999999999,47.92,27.54,55.38,27.54,54.48,38.42,32.9575,39.04,45.21290000000001,40.96179999999998,42.99599999999995,45.33549999999998,43.50671758176768,45.28009224001355,45.999999999999986,47.64911164897019,44.35088835102978,45.21290000000001,40.96179999999998,42.99599999999995,45.33549999999998,45.666666666666664,5779211,6050466.85,55.45912889308865,0.1387411830330121,1.5,2.75,NaN,NaN,1.3981383278135482,0.9551677818051346,896.4605987341313,-0.20323582321916,0.8240426700767003,1.0272784932958603,46.01844391226447,-0.9928771854090241,14.946948901532231,56.12054092744613,28.932510171021654,4972041113
1553866200,46.67,46.86,46.048,46.76,45.93448979591837,42.37,47.92,27.54,55.38,27.54,54.48,38.42,32.9575,39.04,45.20705000000001,40.98549999999998,43.19079999999995,45.40099999999998,43.634297284443456,45.42103583620274,46.1453846153846,47.70097236746992,44.58979686329928,45.20705000000001,40.98549999999998,43.19079999999995,45.40099999999998,46.556000000000004,6036863,6138460.65,59.179242830136616,1.665906978036626,1.5,2.75,NaN,NaN,1.3689855901125807,0.9834490019904256,898.8856211969044,-0.14362706482276066,0.8477446622674094,0.9913717270901701,46.58772117575454,-0.04275331338179377,40.33662540424493,26.811542409609142,32.851832186145934,4978077976
1554125400,47.79,48.49,47.64,48.36,46.226122448979595,42.309999999999995,47.92,27.54,55.38,27.54,54.48,38.42,32.9575,39.04,45.211950000000016,41.03429999999999,43.399799999999956,45.574499999999986,43.81961895956332,45.700937185135814,46.345384615384596,48.2749539636648,44.41581526710439,45.211950000000016,41.03429999999999,43.399799999999956,45.574499999999986,48.163333333333334,4310011,5960874.5,64.86121311655657,4.257013050148465,1.5,2.75,NaN,NaN,1.394772333675968,0.7230501162203633,903.8593225267022,-0.005666166494383007,0.9842890189721913,0.9899551854665743,50.12311445052463,3.201024327784891,71.11580226821727,6.8461004204246825,22.038097311358058,4982387987
1554211800,48.45,48.52,47.94,48.41,46.51775510204082,42.24999999999999,47.92,27.54,55.38,27.54,54.48,38.42,32.9575,39.04,45.21525000000001,41.075999999999986,43.58099999999996,45.75799999999998,43.99963390232554,45.95894316750383,46.55769230769229,48.7269623564365,44.38842225894808,45.21525000000001,41.075999999999986,43.58099999999996,45.75799999999998,48.29,2783494,5905447.1,65.02504926085203,3.9335676226422804,1.5,2.75,NaN,NaN,1.336574309841971,0.4713434821895196,902.1485900798867,0.07526773237240958,1.0840398509320863,1.0087721185596767,50.13254016906426,4.3543867212761285,65.29078674635284,9.645190837022044,25.064022416625104,4985171481
1554298200,49.09,49.2999,48.28,48.65,46.809387755102044,42.19,47.92,27.54,55.38,27.54,54.48,38.42,32.9575,39.04,45.220700000000015,41.111699999999985,43.79779999999996,45.99649999999998,44.18200120027356,46.215234294408226,46.736153846153826,49.16707691820866,44.305230774098995,45.220700000000015,41.111699999999985,43.79779999999996,45.99649999999998,48.743300000000005,4948257,5936462.35,65.84816872538033,3.9833173808770286,1.5,2.75,NaN,NaN,1.31395471628183,0.8335363231942338,903.6009791332275,0.12816932979591766,1.1689837808045738,1.040814451008656,49.40822140115907,1.5233722871452355,100,0,0,4990119738
1554384600,48.8,49.1361,48.4,49.01,47.101020408163265,42.129999999999995,47.92,27.54,55.38,27.54,54.48,38.42,32.9575,39.04,45.22960000000002,41.12289999999998,44.01879999999996,46.305999999999976,44.37133448653734,46.48140245684554,46.90769230769229,49.62467200916686,44.190712606217716,45.22960000000002,41.12289999999998,44.01879999999996,46.305999999999976,48.8487,4480601,5847957.95,67.0989779955546,3.606225588676308,1.5,2.75,NaN,NaN,1.2726793794045563,0.766182150813858,906.5493802773955,0.16809363042754155,1.250931489043083,1.0828378586155414,46.26892445254285,8.477202301903493,100,0,0,4994600339
1554471000,49.39,49.71,49.21,49.66,47.39265306122449,42.06999999999999,47.92,27.54,55.38,27.54,54.48,38.42,32.9575,39.04,45.244450000000015,41.14289999999998,44.25079999999996,46.66249999999998,44.578733134124114,46.78412603238406,47.1230769230769,50.20958737106863,44.03656647508517,45.244450000000015,41.14289999999998,44.25079999999996,46.66249999999998,49.526666666666664,3994792,5735384.8,69.28626262348628,4.227087269071244,1.5,2.75,NaN,NaN,1.2317737094470882,0.6965168230734928,909.944564031962,0.2159151181526735,1.3527317563063832,1.1368166381537097,25.120448798115728,10.306530430919576,100,0,0,4998595131
1554730200,49.43,49.85,49.05,49.81,47.68428571428572,42.00999999999999,47.92,27.54,55.38,27.54,54.48,38.42,32.9575,39.04,45.25870000000002,41.17769999999999,44.46499999999996,46.93299999999998,44.78388085435454,47.07230450549034,47.38615384615382,50.748557184990155,44.02375050731748,45.25870000000002,41.17769999999999,44.46499999999996,46.93299999999998,49.57,3444149,5714466,69.78546247678703,3.6907350389417495,1.5,2.75,NaN,NaN,1.200932730200868,0.6027070595922699,910.6091440998746,0.2337785822080216,1.4290398659137367,1.195261283705715,24.14310593904114,8.212035628937652,100,0,0,5002039280
1554816600,49.23,49.42,48.705,49.01,47.97591836734694,41.949999999999996,47.92,27.54,55.38,27.54,54.48,38.42,32.9575,39.04,45.27350000000002,41.23139999999999,44.68239999999997,47.13999999999997,44.94961101692888,47.256846933538874,47.46999999999998,50.934288138664584,44.00571186133537,45.27350000000002,41.23139999999999,44.68239999999997,47.13999999999997,49.04499999999999,5590911,5807721.45,63.82705750462689,2.160372834783839,1.5,2.75,NaN,NaN,1.1940803923293777,0.9626685866623304,906.8993764201373,0.17076889580258436,1.4087224034589454,1.237953507656361,26.989190566359632,8.094397882664301,70.71157387576054,7.041668672790552,22.24675745144891,4996448369
1554903000,49.26,49.56,49.01,49.51,48.26755102040816,41.88999999999999,47.92,27.54,55.38,27.54,54.48,38.42,32.9575,39.04,45.28980000000002,41.29249999999999,44.91379999999997,47.32749999999997,45.12844980057872,47.47143293986851,47.8030769230769,51.1533686175223,44.452785228631505,45.28980000000002,41.29249999999999,44.91379999999997,47.32749999999997,49.35999999999999,3316357,5728218.95,65.79288842314483,2.392683394651492,1.5,2.75,NaN,NaN,1.1480746500201369,0.5789508098324349,911.0921019499593,0.14294630344798764,1.4166363869663456,1.273690083518358,23.320196193684083,7.935469805973405,68.14791082908988,8.234656369041026,23.61743280186908,4999764726
1554989400,49.79,49.79,49.15,49.47,48.55918367346939,41.83,47.92,27.54,55.38,27.54,54.48,38.42,32.9575,39.04,45.315150000000024,41.36199999999999,45.108399999999975,47.518499999999975,45.29870667114426,47.66177265988103,48.1453846153846,51.18306202150735,45.107707209261854,45.315150000000024,41.36199999999999,45.108399999999975,47.518499999999975,49.46999999999999,3253040,5675021.95,65.4862777282864,2.19373333447986,1.5,2.75,NaN,NaN,1.1117836035901272,0.5732206903622636,912.7453815189776,0.10384946422088515,1.4035019137944644,1.2996524495735793,23.853066152723184,5.795551753635588,41.972688315645804,25.445621978086685,32.581689706267504,4996511686
1555075800,50.37,50.5999,49.98,50.45,48.85081632653062,41.769999999999996,47.92,27.54,55.38,27.54,54.48,38.42,32.9575,39.04,45.34415000000003,41.42779999999999,45.301399999999965,47.72449999999998,45.50071817423664,47.927318120844745,48.4853846153846,51.4891219324319,45.48164729833731,45.34415000000003,41.42779999999999,45.301399999999965,47.72449999999998,50.3433,3344069,5566785.15,69.26536695681855,3.30325489522568,1.5,2.75,NaN,NaN,1.1130776319051179,0.6007181721392643,915.623097627283,0.1245929895477722,1.4553936865082946,1.3308006969605224,23.925341901214022,4.32175351530191,39.97471138441674,27.1692515161772,32.856037099406066,4999855755
1555335000,50.49,50.53,49.88,50.35,49.14244897959184,41.709999999999994,47.92,27.54,55.38,27.54,54.48,38.42,32.9575,39.04,45.378300000000024,41.49009999999999,45.49179999999997,47.90299999999998,45.690886088972455,48.15804972838334,48.87076923076922,51.41124116195368,46.33029729958476,45.378300000000024,41.49009999999999,45.49179999999997,47.90299999999998,50.25333333333333,2784492,5483855.7,68.4418441018218,2.7076994749930567,1.5,2.75,NaN,NaN,1.0800006581976094,0.5077617195507168,914.4197689107637,0.11254883665308224,1.4714867427768752,1.358937906123793,17.660814743143614,4.007436480066112,19.275874491610253,49.93546344894365,30.788662059446093,4997071263
1555421400,50.85,50.87,50.099,50.43,49.43408163265306,41.64999999999999,47.92,27.54,55.38,27.54,54.48,38.42,32.9575,39.04,45.408750000000026,41.5736,45.66659999999996,48.08149999999998,45.87673369332648,48.37442594472778,49.221538461538444,51.20629337613267,47.23678354694422,45.408750000000026,41.5736,45.66659999999996,48.08149999999998,50.46633333333333,2917991,5350169.4,68.76182192809759,2.6412742399957816,1.5,2.75,NaN,NaN,1.0579291826120658,0.5454016091527868,915.8654832982172,0.09181603457089915,1.4737079493374168,1.3818919147665176,17.62928911548843,3.6587872559095604,52.04428775815644,17.77345585160388,30.18225639023967,4999989254
1555507800,51.08,51.08,49.818,50.03,49.72571428571429,41.589999999999996,47.92,27.54,55.38,27.54,54.48,38.42,32.9575,39.04,45.43620000000003,41.67759999999999,45.822999999999965,48.26349999999998,46.03960688182348,48.53209966427752,49.4730769230769,50.89536943038029,48.050784415773514,45.43620000000003,41.67759999999999,45.822999999999965,48.26349999999998,50.309333333333335,3806086,5165276.15,65.202034216399,2.092830281463291,1.5,2.75,NaN,NaN,1.0725056695683468,0.7368601192793922,913.716188291349,0.03588245730184836,1.4267449863938282,1.3908625290919798,18.90641165607749,2.0812079167516897,22.023244747207062,46.2907771378704,31.685978114922538,4996183168
1555594200,50.37,50.45,49.5915,50.3,50.01734693877552,41.529999999999994,47.92,27.54,55.38,27.54,54.48,38.42,32.9575,39.04,45.464350000000024,41.78049999999999,45.987999999999964,48.38249999999998,46.20668112175197,48.70047112482251,49.62230769230767,50.95009715305475,48.294518231560595,45.464350000000024,41.78049999999999,45.987999999999964,48.38249999999998,50.11383333333333,3242529,4927568.85,66.46408082662302,1.8170544670297943,1.5,2.75,NaN,NaN,1.0572195503134647,0.6580382940768043,913.0868715158215,0.0034938980236713935,1.395229901621569,1.3917360035978976,18.76448595843557,1.2887635924285152,48.73918207958506,20.156288686160536,31.104529234254407,4999425697
1555939800,49.88,50.5087,49.805,50.39,50.30897959183674,41.46999999999999,50.45,27.54,55.38,27.54,54.48,38.42,32.9575,39.04,45.49545000000002,41.892399999999995,46.17939999999996,48.64299999999998,46.37073284246758,48.86137863674418,49.77461538461536,50.957561261122635,48.59166950810808,45.49545000000002,41.892399999999995,46.17939999999996,48.64299999999998,50.234566666666666,1768978,4496443.55,66.89508105028384,1.5904763852121342,1.5,2.75,NaN,NaN,1.0319681538625027,0.3934171485373146,910.8990854734969,-0.023934381111222702,1.3618180272088694,1.385752408320092,17.515021493908268,1.164424814294315,40.712475400285115,26.48430828977335,32.80321630994155,5001194675
1556026200,50.64,51.8983,50.51,51.75,50.60061224489796,41.41,50.45,27.54,55.38,27.54,54.48,38.42,32.9575,39.04,45.52790000000002,41.9999,46.39559999999996,48.97949999999999,46.581684495704145,49.13648543324473,50.0130769230769,51.42141221128908,48.60474163486472,45.52790000000002,41.9999,46.39559999999996,48.97949999999999,51.3861,3681465,4239895.4,72.6212262512075,3.6007568586267573,1.5,2.75,NaN,NaN,1.065991857158038,0.8682914677564922,914.9061017918167,0.03428716731084647,1.4286113674586502,1.3943242001478038,22.733618292596496,5.590695776372174,70.7663819708191,6.999787719720323,22.23383030946058,5004876140
1556112600,51.72,51.915,51.3483,51.48,50.89224489795919,41.349999999999994,50.45,27.54,55.38,27.54,54.48,38.42,32.9575,39.04,45.55345000000001,42.100699999999996,46.604599999999955,49.25199999999999,46.77377529979418,49.35967729674523,50.20307692307691,51.68345909027116,48.72269475588266,45.55345000000001,42.100699999999996,46.604599999999955,49.25199999999999,51.5811,2358493,3980470.7,70.03139110706832,2.9821877643514867,1.5,2.75,NaN,NaN,1.0303281530753208,0.5925161061981941,915.6825946613723,0.03903935914521206,1.4431233990793189,1.4040840399341068,19.903780582087773,3.978994142597453,46.373020650837226,21.837114800159647,31.789864549003116,5002517647
1556199000,51.37,51.69,50.63,51.34,51.183877551020416,41.28999999999999,50.45,27.54,55.38,27.54,54.48,38.42,32.9575,39.04,45.57175000000001,42.17139999999999,46.77919999999995,49.55199999999998,46.95284293509637,49.548279458959975,50.33230769230768,51.89169916821998,48.77291621639538,45.57175000000001,42.17139999999999,46.77919999999995,49.55199999999998,51.22,2976156,3740897.25,68.66401899974908,2.4547599395497928,1.5,2.75,NaN,NaN,1.0324475707127976,0.7955727733500298,913.1184183803806,0.018236194095349934,1.426879282553294,1.4086430884579442,20.035471554869176,3.780068728522346,50.84027954392589,18.51235466784934,30.647365788224757,4999541491
1556285400,51.35,52.04,50.87,52.02,51.47551020408164,41.23,50.45,27.54,55.38,27.54,54.48,38.42,32.9575,39.04,45.59115000000001,42.2519,46.95999999999995,49.85949999999998,47.1515549768573,49.783681415249504,50.502307692307674,52.26541951905307,48.73919586556228,45.59115000000001,42.2519,46.95999999999995,49.85949999999998,51.64333333333333,3122809,3608077.15,71.56783718764588,2.307517725509774,1.5,2.75,NaN,NaN,1.0422727442333122,0.8655050516311715,916.2321361092761,0.034794883082843286,1.4521366923114982,1.417341809228655,20.500039104270595,3.1119920713577804,50.789673008181616,18.548405970657786,30.661921021160605,5002664300
1556544600,52.06,52.556,52.01,52.2,51.76714285714286,41.169999999999995,50.45,27.54,55.38,27.54,54.48,38.42,32.9575,39.04,45.61630000000002,42.3253,47.15019999999995,50.13149999999998,47.349533213058976,50.01380699474955,50.74769230769229,52.49963459416977,48.99575002121481,45.61630000000002,42.3253,47.15019999999995,50.13149999999998,52.25533333333334,2178485,3415158.25,72.29958375982555,3.0769631805218673,1.5,2.75,NaN,NaN,1.00682469107379,0.6378869851785053,918.5832587725538,0.04191508803724364,1.4697356692752095,1.4278205812379658,18.273503306724,3.6742800397219493,52.86811026431243,17.106439380884886,30.025450354802675,5004842785
1556631000,52.03,52.4699,51.2,52.3,52.058775510204086,41.10999999999999,50.45,27.54,55.38,27.54,54.48,38.42,32.9575,39.04,45.63600000000001,42.3833,47.31479999999995,50.32849999999998,47.54366916548803,50.23153966191626,50.962307692307675,52.73858129989016,49.18603408472519,45.63600000000001,42.3833,47.31479999999995,50.32849999999998,51.98996666666667,3347447,3367030.05,72.71964536658221,2.277054230740752,1.5,2.75,NaN,NaN,1.0256157845685192,0.9941838802418768,920.2004738526791,0.037545235074623706,1.4747521250812454,1.4372068900066217,17.987861053809706,3.7081102518342206,51.720583874284934,17.900316819360746,30.379099306354327,5008190232
1556717400,52.71,52.81,51.14,51.15,52.350408163265314,52.81,50.45,27.54,55.38,27.54,54.48,38.42,32.9575,39.04,45.64950000000001,42.47379999999999,47.45179999999995,50.46549999999998,47.68509390409635,50.31901207506709,51.09153846153844,52.645230761613846,49.53784616146304,45.64950000000001,42.47379999999999,47.45179999999995,50.46549999999998,51.699999999999996,5548966,3505303.65,61.22182566267081,1.8514141094723626,1.5,2.75,NaN,NaN,1.0716432285279107,1.5830200616143484,917.6455819709212,-0.053654941635261855,1.3701382129625443,1.4237931545978062,23.418874985200603,2.238656805916445,35.55222497044565,31.196956954468902,33.25081807508544,5002641266
1556803800,51.03,51.5958,49.93,50.8,52.642040816326535,52.86643564356436,50.45,27.54,55.38,27.54,54.48,38.42,32.9575,39.04,45.661750000000005,42.563199999999995,47.57659999999996,50.572999999999986,47.80724708432786,50.364820448870226,51.11846153846151,52.63851915181996,49.59840392510306,45.661750000000005,42.563199999999995,47.57659999999996,50.572999999999986,50.775266666666674,6456964,3580739,58.20547078391576,0.5694694434997825,1.5,2.75,NaN,NaN,1.114082997918774,1.8032489941322167,916.1817318614984,-0.14332139760334983,1.244641407593619,1.3879628051969688,23.266390489879086,0.9940357852882704,24.791261522881623,42.71756575274054,32.491172724377826,4996184302
1556890200,51.61,52.41,51.5,52.25,52.933673469387756,52.922871287128714,50.45,27.54,55.38,27.54,54.48,38.42,32.9575,39.04,45.67835,42.696799999999996,47.74019999999995,50.73499999999998,47.981472688864024,50.54436135850163,51.264615384615354,52.82583020518821,49.7034005640425,45.67835,42.696799999999996,47.74019999999995,50.73499999999998,52.053333333333335,3004351,3506926.5,65.73704295891196,2.057417217580535,1.5,2.75,NaN,NaN,1.1495056409245759,0.8566906092842265,920.3572297490198,-0.11212763000707904,1.2478032676881199,1.359930897695199,27.84896594876569,3.691208573129588,24.436004916502732,43.145346445622835,32.41864863787443,4999188653
1557149400,49.71,51.8599,49.54,51.64,53.225306122448984,52.97930693069307,50.45,27.54,55.38,27.54,54.48,38.42,32.9575,39.04,45.69045,42.822399999999995,47.87479999999995,50.83399999999999,48.12494434812426,50.64870789578719,51.35769230769228,52.851601044399274,49.86378357098529,45.69045,42.822399999999995,47.87479999999995,50.83399999999999,51.013299999999994,4728673,3543620.55,60.77524116582664,0.9726753009455593,1.5,2.75,NaN,NaN,1.2609695237156777,1.334418551105874,918.3871140335849,-0.13802507048945256,1.1873995595833833,1.3254246300728358,29.250994567362763,-0.21256038647342884,10.749973092035846,63.307092954666956,25.942933953297214,4994459980
1557235800,50.21,50.55,47.91,49.06,53.51693877551021,53.035742574257426,52.3,27.54,55.38,27.54,54.48,38.42,32.9575,39.04,45.692550000000004,42.9221,47.95439999999995,50.796499999999995,48.16161319721743,50.497402381902695,51.28307692307689,53.09733472199819,49.468819124155594,45.692550000000004,42.9221,47.95439999999995,50.796499999999995,49.173333333333325,8582157,3800520.95,45.22645877477029,4.73448463417459,1.5,2.75,NaN,NaN,1.4373288434502725,2.2581527935005856,913.648369874788,-0.3237547981970048,0.9207311323265799,1.2444859305235847,38.38549039452959,-4.70085470085469,1.4867697833764497,87.19063457020307,11.322595646420478,4985877823
1557322200,48.8,49.78,48.47,48.83,53.80857142857143,53.09217821782178,52.3,27.54,55.38,27.54,54.48,38.42,32.9575,39.04,45.69415,43.0135,48.031599999999955,50.78749999999999,48.18782444438537,50.33860215505482,51.16999999999997,53.35965399444399,48.98034600555596,45.69415,43.0135,48.031599999999955,50.78749999999999,49.026666666666664,6251040,3833527.4,44.142240116098314,3.261879178729156,1.5,2.75,NaN,NaN,1.4282339260609673,1.6306235348676523,912.5064760230542,-0.4492186351956122,0.6829626365290693,1.1321812717246815,38.38724201095938,-4.888975457732772,1.441539783062878,87.39628058942102,11.1621796275161,4979626783
1557408600,47.615,48.68,46.64,48.45,54.100204081632654,53.14861386138614,52.3,27.54,55.38,27.54,54.48,38.42,32.9575,39.04,45.692550000000004,43.10190000000001,48.10319999999995,50.73449999999999,48.1981058387232,50.15873528314484,51.02076923076921,53.6274406896751,48.414097771863325,45.692550000000004,43.10190000000001,48.10319999999995,50.73449999999999,47.923333333333325,7327245,4034071.8,42.3364025271101,4.925053894886455,1.5,2.75,NaN,NaN,1.4826457884851838,1.816339758751939,910.2766279963442,-0.538880747223003,0.45858033769592765,0.9974610849189307,38.37410427079042,-6.862745098039215,1.3873877661974672,87.64643468027982,10.966177553522702,4972299538
1557495000,47.85,49.47,46.1216,48.97,54.39183673469388,53.205049504950495,52.3,27.54,55.38,27.54,54.48,38.42,32.9575,39.04,45.690349999999995,43.21720000000001,48.190999999999946,50.70949999999999,48.22837619798896,50.04552239903581,50.80692307692306,53.58941100200997,48.02443515183616,45.690349999999995,43.21720000000001,48.190999999999946,50.70949999999999,48.1872,7709477,4256893.65,45.615140860893106,3.9431522717800678,1.5,2.75,NaN,NaN,1.6159139464505277,1.8110569898780533,913.230352728935,-0.5427386798978253,0.3190377350466491,0.8617764149444744,37.95063389285647,-6.18773946360154,6.5752722532532095,71.81481087734312,21.609916869403676,4980009015
1557754200,46.14,46.68,44.89,45.36,54.68346938775511,53.26148514851485,52.3,27.54,55.38,27.54,54.48,38.42,32.9575,39.04,45.66325,43.3181,48.18919999999996,50.454999999999984,48.115890856891355,49.59928217055621,50.33615384615383,54.31676484263734,46.355542849670314,45.66325,43.3181,48.18919999999996,50.454999999999984,45.64333333333334,11209939,4650187.15,32.00832484397496,8.774367547269591,1.5,2.75,NaN,NaN,1.7919200931326327,2.4106425480101374,907.4008794576446,-0.7549439163826224,-0.08190348053380347,0.6730404358488189,54.67634869967302,-13.269598470363285,3.947134809214687,78.5347183026092,17.51814688817611,4968799076
1557840600,45.91,47.4,45.82,46.51,54.97510204081633,53.317920792079214,52.3,27.54,55.38,27.54,54.48,38.42,32.9575,39.04,45.644149999999996,43.4322,48.22159999999996,50.262999999999984,48.0529147448564,49.305064820979425,49.964615384615364,54.37907843505181,45.55015233417892,45.644149999999996,43.4322,48.22159999999996,50.262999999999984,46.57666666666666,5962140,4809069.55,38.32029717791949,5.253518153348578,1.5,2.75,NaN,NaN,1.8096400864803017,1.239769967560565,912.0546030052076,-0.7811203077214601,-0.3033599488030063,0.4777603589184538,58.60480904648961,-9.071358748778104,15.490972637552845,55.36904956883209,29.139977793615067,4974761216
1557927000,45.69,47.72,45.5515,47.33,55.26673469387755,53.37435643564357,52.3,27.54,55.38,27.54,54.48,38.42,32.9575,39.04,45.63415,43.5718,48.27339999999997,50.10799999999999,48.0245651470189,49.116963409457576,49.603846153846135,54.05387321313492,45.15381909455735,45.63415,43.5718,48.27339999999997,50.10799999999999,46.86716666666666,5612489,4943794.45,42.42466711893566,4.038604657893771,1.5,2.75,NaN,NaN,1.8352729374459946,1.1352593755187375,914.9191024628541,-0.7086047110861513,-0.40799552993923527,0.300609181146916,60.39984132533095,-6.830708661417321,33.600225064482956,33.17852495927641,33.22124997624062,4980373705
1558013400,47.74,49.43,47.73,48.62,55.55836734693878,53.430792079207926,52.3,27.54,55.38,27.54,54.48,38.42,32.9575,39.04,45.63485000000001,43.739200000000004,48.36819999999996,50.03749999999999,48.04791553341031,49.06963356093781,49.32846153846152,53.53837545063704,45.118547626285995,45.63485000000001,43.739200000000004,48.36819999999996,50.03749999999999,48.593333333333334,4826059,4994793.1,48.25789399873709,0.4197285908936325,1.5,2.75,NaN,NaN,1.8541820133427094,0.9662180001009452,918.3934986077156,-0.546422920305291,-0.38241946923469783,0.1640034510705932,63.59673340203471,-6.947368421052636,59.47454534152953,12.931733324038818,27.59372133443166,4985199764
1558099800,47.39,49.11,47.37,47.73,55.85000000000001,53.48722772277228,52.3,27.54,55.38,27.54,54.48,38.42,32.9575,39.04,45.62755,43.9174,48.46639999999996,49.90899999999999,48.035448257590296,48.942049412277065,48.976923076923065,52.88822728290295,45.065618870943176,45.62755,43.9174,48.46639999999996,49.90899999999999,48.06999999999999,6038225,5134577.9,44.879535424187964,1.1301229725420054,1.5,2.75,NaN,NaN,1.8460261552468018,1.175992480316639,915.1954878623815,-0.4744190323794226,-0.4290203394036851,0.04539869297573752,60.427095029629065,-7.571649883811006,30.6959105846231,36.15661303238121,33.1474763829957,4979161539
1558359000,46.82,47.49,46.35,46.74,56.14163265306123,53.54366336633664,52.3,27.54,55.38,27.54,54.48,38.42,32.9575,39.04,45.616099999999996,44.109399999999994,48.550599999999946,49.726499999999994,47.984646365135774,48.732330420631634,48.6376923076923,52.50093250887977,44.774452106504825,45.616099999999996,44.109399999999994,48.550599999999946,49.726499999999994,46.86000000000001,4861714,5289214.7,41.4070418215737,3.3671640275702104,1.5,2.75,NaN,NaN,1.8127385727291727,0.9191750147710963,912.4989741055691,-0.46801193915449046,-0.5396162309673755,-0.07160429181288509,60.806842708162456,-4.728903383611904,46.711006790919,21.573783177596457,31.71521003148455,4974299825
1558445400,47.7,48.23,47.55,47.99,56.43326530612245,53.600099009900994,52.3,27.54,55.38,27.54,54.48,38.42,32.9575,39.04,45.6074,44.273999999999994,48.62239999999994,49.538499999999985,47.984856311601035,48.66163228533338,48.421538461538454,52.08598591619366,44.75709100688325,45.6074,44.273999999999994,48.62239999999994,49.538499999999985,47.92333333333334,2976275,5253955.2,46.98472244341876,0.7682443910194275,1.5,2.75,NaN,NaN,1.7896858175342314,0.5664827518894717,916.4765053395107,-0.3590372556111025,-0.5204008613267632,-0.16136360571566072,57.775099141730685,-1.72025394224861,40.06223262622426,27.049451792743408,32.888315581032344,4977276100
1558531800,47.47,48.09,47.33,47.57,56.72489795918368,53.65653465346535,52.3,27.54,55.38,27.54,54.48,38.42,32.9575,39.04,45.593199999999996,44.427699999999994,48.67639999999995,49.34299999999998,47.96858743663629,48.55766730577782,48.06153846153846,50.9980339778231,45.125042945253824,45.593199999999996,44.427699999999994,48.67639999999995,49.34299999999998,47.663333333333334,3591732,5315617.15,45.420202007357084,1.1047627755091876,1.5,2.75,NaN,NaN,1.716136830567501,0.675694260637262,913.7243301842732,-0.2972450065481977,-0.5329198639009078,-0.23567485735271015,57.88703659042223,-1.8163054695562488,15.780905041416016,54.830870580021056,29.388224378562924,4973684368
1558618200,46.35,46.36,45.04,45.89,57.01653061224491,53.712970297029706,52.3,27.54,55.38,27.54,54.48,38.42,32.9575,39.04,45.56785,44.5665,48.678999999999945,49.07049999999999,47.88707420382703,48.3036037528466,47.61923076923077,49.932516298694956,45.30594523976658,45.56785,44.5665,48.678999999999945,49.07049999999999,45.76333333333334,7805417,5557080.2,39.722430108486535,5.1611578124396,1.5,2.75,NaN,NaN,1.774269914098394,1.4045895900512646,909.5653996370407,-0.3479978200585854,-0.6706721324259419,-0.3226743123673565,60.97438563724899,-6.289565039820295,1.5456254713224358,86.8772678949584,11.577106633719167,4965878951
1558704600,46.59,46.789,45.75,46.06,57.30816326530613,53.76940594059406,52.3,27.54,55.38,27.54,54.48,38.42,32.9575,39.04,45.540949999999995,44.698100000000004,48.68719999999994,48.772499999999994,47.8154242350495,48.089927204956446,47.388461538461534,49.67923025262173,45.09769282430134,45.540949999999995,44.698100000000004,48.68719999999994,48.772499999999994,46.199666666666666,3730757,5587477.6,40.535334188087475,3.096141205465495,1.5,2.75,NaN,NaN,1.7217506345199374,0.6676996790107937,912.57738769679,-0.3477753165931443,-0.7573934581087869,-0.4096181415156426,60.43044906038386,1.543209876543216,10.48950527279484,63.68785496097268,25.822639766232488,4969609708
1559050200,46.25,46.75,44.8,44.8,57.59979591836735,53.82584158415842,52.3,27.54,55.38,27.54,54.48,38.42,32.9575,39.04,45.50805,44.8168,48.65659999999994,48.40249999999999,47.69717230426324,47.7766008044844,47.078461538461525,49.585532721567375,44.571390355355675,45.50805,44.8168,48.65659999999994,48.40249999999999,45.44999999999999,3667835,5661945.1,36.59599452406265,3.970821495307,1.5,2.75,NaN,NaN,1.7380541606256563,0.647804762359847,909.2143020856902,-0.4060807449676199,-0.9172190727251675,-0.5111383277575475,43.85904832053781,-3.676628682003872,12.404232371177148,60.25650099296283,27.339266635860028,4965941873
1559136600,44.19,44.41,43.1481,43.88,57.89142857142858,53.882277227722774,52.3,27.54,55.38,27.54,54.48,38.42,32.9575,39.04,45.47164999999999,44.950700000000005,48.59859999999994,47.98149999999999,47.54747927272351,47.40549596596208,46.726923076923065,49.61829362886535,43.83555252498078,45.47164999999999,44.950700000000005,48.59859999999994,47.98149999999999,43.81269999999999,6781443,5833644.9,33.99796234924315,6.7597421041864125,1.5,2.75,NaN,NaN,1.7319002920095379,1.162470996477691,905.9461449499591,-0.4753903343868633,-1.1053762457411267,-0.6299859113542634,41.64048910801757,-7.289245721529676,2.497546286110646,83.09631431652029,14.406139397369063,4959160430
1559223000,44.28,44.7199,43.66,44.25,58.183061224489805,53.93871287128713,52.3,27.54,55.38,27.54,54.48,38.42,32.9575,39.04,45.44239999999999,45.05750000000001,48.54639999999994,47.63649999999999,47.41816636006768,47.10497254063236,46.36384615384614,49.2225767862077,43.505115521484576,45.44239999999999,45.05750000000001,48.54639999999994,47.63649999999999,44.209966666666666,4629491,5787671.15,35.966821336828005,5.144703001198601,1.5,2.75,NaN,NaN,1.6839002711517141,0.7998883972528397,907.2397713982645,-0.4645554984984963,-1.2106802844773839,-0.7461247859788875,40.08220855051265,-8.98807075277663,12.627080200541473,59.876320700950366,27.49659909850817,4963789921
1559309400,42.88,43.31,42.43,42.52,58.474693877551026,53.995148514851486,52.3,27.54,55.38,27.54,54.48,38.42,32.9575,39.04,45.40739999999999,45.138900000000014,48.468999999999944,47.22249999999999,47.22608140477091,46.66830848914356,46.1453846153846,49.64074959366096,42.65001963710824,45.40739999999999,45.138900000000014,48.468999999999944,47.22249999999999,42.75333333333334,5222390,5725942.45,31.26990435332371,7.385785220677238,1.5,2.75,NaN,NaN,1.6936216803551631,0.9120577172409408,903.5604372193674,-0.537013947549927,-1.4173922204162963,-0.8803782728663693,37.847783590788524,-10.915566729520204,16.354973926047546,53.94265891555011,29.702367158402346,4958567531
1559568600,42.45,43.03,41.42,42.1,41.42,54.05158415841584,52.3,27.54,55.38,27.54,54.48,38.42,32.9575,39.04,45.36564999999999,45.206800000000015,48.35259999999994,46.71499999999999,47.02505860458381,46.23323149017751,45.80615384615383,49.89904854089599,41.71325915141168,45.36564999999999,45.206800000000015,48.35259999999994,46.71499999999999,42.18333333333334,7024881,5926968.95,30.23751206473129,8.060586575121771,1.5,2.75,NaN,NaN,1.6876487031869372,1.185240054277659,906.9670870631134,-0.5730555192970119,-1.5966976719876342,-1.0236421526906223,37.746896783893014,-9.927257167308516,3.236833321520994,80.65069276220365,16.11247391627536,4951542650
1559655000,43.28,44.9099,43.05,44.83,41.41762711864407,54.1080198019802,52.3,27.54,55.38,27.54,54.48,38.42,32.9575,39.04,45.34299999999998,45.29680000000001,48.34559999999994,46.3745,46.93897787499229,46.09959039587489,45.61384615384614,49.636600957835284,41.591091349856995,45.34299999999998,45.29680000000001,48.34559999999994,46.3745,44.263299999999994,5976836,5989377.1,43.33360684572511,2.1466328909345407,1.5,2.75,NaN,NaN,1.7678095101021558,0.9979061094683787,912.5183631926773,-0.3820505886436858,-1.5012053884952294,-1.1191547998515436,56.71689840298647,-6.584705146905613,16.56939575337972,53.6874119979904,29.74319224862988,4957519486
1559741400,45.72,46.025,44.73,45.99,41.41525423728814,54.164455445544554,52.3,27.54,52.3,27.54,55.38,38.42,54.48,39.04,45.32039999999998,45.39440000000001,48.36499999999994,46.22099999999999,46.90176305636514,46.08915321531538,45.41153846153845,49.055955444806,41.767121478270894,45.32039999999998,45.39440000000001,48.36499999999994,46.22099999999999,45.58166666666667,4596306,5790084.55,47.81625942779402,0.8777456216939915,1.5,2.75,NaN,NaN,1.734037402237716,0.7938236411418207,912.9609423253302,-0.15807306461433623,-1.3167461306194639,-1.1586730660051276,56.55234470225698,-3.321421063695603,41.46339524964988,25.87347391180974,32.66313083854038,4962115792
1559827800,46.18,47.26,45.81,46.89,41.41288135593221,54.22089108910892,52.3,27.54,52.3,27.54,55.38,38.42,54.48,39.04,45.29984999999998,45.50090000000002,48.382199999999926,46.12399999999999,46.90130176003709,46.165424337666295,45.34692307692306,48.851736335333754,41.84210981851237,45.29984999999998,45.50090000000002,48.382199999999926,46.12399999999999,46.65333333333333,4725976,5713831.35,51.05158050901929,2.548598664613223,1.5,2.75,NaN,NaN,1.7137490163635931,0.8271115667423401,915.1118171767017,0.05859745813944439,-1.0854262433308222,-1.1440237014702666,58.01408210941618,2.1791239921551537,42.31040585953975,25.15552903954176,32.5340651009185,4966841768
1559914200,47.44,48.88,47.345,48.26,41.410508474576275,54.277326732673274,52.3,27.54,52.3,27.54,55.38,38.42,54.48,39.04,45.28444999999998,45.627700000000026,48.44059999999993,46.114499999999985,46.954584043957205,46.364907734079026,45.463846153846134,49.23783436027293,41.68985794741934,45.28444999999998,45.627700000000026,48.44059999999993,46.114499999999985,48.16166666666666,5322830,5613610.6,55.56749510112336,5.152609447774237,1.5,2.75,NaN,NaN,1.7334812294804796,0.9482007889895321,919.3159817786174,0.28919061375417465,-0.7825354342775483,-1.071726048031723,55.780849479569355,4.776378636560998,70.16230823380911,7.287724507145045,22.549967259045854,4972164598
1560173400,49.15,49.88,48.8801,48.91,41.408135593220344,54.33376237623763,52.3,42.1,52.3,27.54,55.38,38.42,54.48,39.04,45.27069999999998,45.748700000000014,48.50139999999993,46.111499999999985,47.03126702262555,46.607297473690544,45.534615384615364,49.52379779851435,41.54543297071638,45.27069999999998,45.748700000000014,48.50139999999993,46.111499999999985,49.223366666666664,5061256,5481199.55,57.56772905327746,5.840091781987649,1.5,2.75,NaN,NaN,1.7253754273747313,0.9233847361021549,921.7003444157145,0.46981428981076934,-0.4844581857682613,-0.9542724755790306,55.97174582949776,9.174107142857142,100,0,0,4977225854
1560259800,49.96,50.175,48.52,48.88,41.405762711864405,54.390198019801986,52.3,42.1,52.3,27.54,55.38,38.42,54.48,39.04,45.25704999999997,45.867300000000014,48.543799999999926,46.28749999999998,47.103766355071606,46.82374533333906,45.63538461538459,49.8829512699772,41.38781796079198,45.25704999999997,45.867300000000014,48.543799999999926,46.28749999999998,49.19166666666666,3699342,5105669.7,57.439206008189124,5.044365212207036,1.5,2.75,NaN,NaN,1.7203486111336785,0.7245556836549767,922.3211637667875,0.565182659388511,-0.2477941513433919,-0.8129768107319029,52.02349934800368,11.394712853236097,82.03197973463034,2.8136227971240433,15.154397468245609,4973526512
1560346200,48.75,49.07,48.35,48.63,41.40338983050847,54.44663366336634,52.3,42.1,52.3,27.54,55.38,38.42,54.48,39.04,45.243349999999964,45.97450000000001,48.54919999999993,46.39349999999998,47.16361865487272,46.99576958730677,45.84615384615382,50.38525940671757,41.307048285590064,45.243349999999964,45.97450000000001,48.54919999999993,46.39349999999998,48.683333333333344,3015996,4958362.5,56.31097407863319,3.465658361297911,1.5,2.75,NaN,NaN,1.6488951389098443,0.6082645228137313,921.1779530718283,0.5867872353676994,-0.07949276652227866,-0.666280001889978,49.50342823182514,9.898305084745768,61.74562617311015,11.580648354083618,26.673725472806236,4970510516
1560432600,49.15,49.42,48.75,49.24,41.40101694915254,54.5030693069307,52.3,42.1,52.3,27.54,55.38,38.42,54.48,39.04,45.22829999999996,46.073400000000014,48.565799999999925,46.48899999999998,47.245045374289475,47.20950581708708,46.0907692307692,50.97893051187063,41.202607949667765,45.22829999999996,46.073400000000014,48.565799999999925,46.48899999999998,49.13666666666666,3005159,4827996,58.45524976137775,3.6929223143964287,1.5,2.75,NaN,NaN,1.5875454861305696,0.6224443847923652,925.1288714584266,0.6145713310677121,0.1019341619446621,-0.51263716912305,49.50191496289132,15.804327375352772,58.37634340121708,13.559422930788477,28.064233667994447,4973515675
1560519000,49.03,49.36,48.6,49.01,41.39864406779661,54.559504950495054,52.3,42.1,52.3,27.54,55.38,38.42,54.48,39.04,45.205949999999966,46.18540000000001,48.57299999999993,46.508499999999984,47.314259281180085,47.38098145355497,46.41461538461536,51.472688081629904,41.356542687600815,45.205949999999966,46.18540000000001,48.57299999999993,46.508499999999984,48.99,2055726,4689479.35,57.31304381500732,3.0751554686490032,1.5,2.75,NaN,NaN,1.5284350942641003,0.4383697733949932,922.9255681532628,0.5897645718185661,0.2245685456501576,-0.3651960261684085,39.47325777281582,16.41330166270783,32.07638139206151,34.66250440392955,33.26111420400892,4971459949
1560778200,49.16,49.5,48.983,49.11,41.39627118644068,54.61594059405941,52.3,42.1,52.3,27.54,55.38,38.42,54.48,39.04,45.183349999999976,46.29690000000001,48.574999999999925,46.57749999999998,47.38468048583969,47.54564988654974,46.816923076923054,51.836425869433846,41.79742028441226,45.183349999999976,46.29690000000001,48.574999999999925,46.57749999999998,49.19766666666667,1840321,4479584.15,57.700049727933504,2.9674811221231208,1.5,2.75,NaN,NaN,1.4561897303880933,0.4108240716942442,924.3525802892882,0.5530109311560719,0.32606763777668135,-0.22694329337939054,37.34149559130599,9.547178228864603,16.672789140448735,53.46983798950223,29.857372870049055,4973300270
1560864600,50.11,51.21,49.9,50.54,41.39389830508475,54.672376237623766,52.3,42.1,52.3,27.54,55.38,38.42,54.48,39.04,45.16379999999997,46.4217,48.592599999999926,46.76749999999998,47.50841850600284,47.830826087830715,47.300769230769205,52.448252329189316,42.153286132349095,45.16379999999997,46.4217,48.592599999999926,46.76749999999998,50.550000000000004,4199078,4446452.35,62.8823608068105,4.843088195327733,1.5,2.75,NaN,NaN,1.5021761782175154,0.9443659055516473,928.0928158035476,0.5943129723520642,0.5159479220606897,-0.07836505029137447,24.400873360852923,9.893455098934544,54.145236636081094,16.22010276894807,29.63466059497083,4977499348
1560951000,50.7,51.27,50.13,50.99,41.391525423728815,54.72881188118812,52.3,42.1,52.3,27.54,55.38,38.42,54.48,39.04,45.14999999999997,46.5406,48.61619999999993,46.917499999999976,47.644951113610574,48.1316997937516,47.95230769230766,52.637801862755616,43.26681352185971,45.14999999999997,46.5406,48.61619999999993,46.917499999999976,50.796666666666674,3775111,4486394.15,64.36200745398094,4.526166351041044,1.5,2.75,NaN,NaN,1.4763064512019786,0.8414577216761037,930.2372236118912,0.6184778114767767,0.6947322140545964,0.07625440257781971,22.841129407272295,8.743868628705483,84.70663069525027,2.0656852961278425,13.22768400862189,4981274459
1561037400,52.53,52.63,51.255,52.41,41.389152542372884,54.78524752475248,52.3,42.1,52.3,27.54,55.38,38.42,54.48,39.04,45.143299999999975,46.68329999999999,48.68419999999992,47.15949999999997,47.83181577582192,48.539156956251446,48.74538461538459,52.62015202585029,44.87061720491889,45.143299999999975,46.68329999999999,48.68419999999992,47.15949999999997,52.098333333333336,4128554,4513235.25,68.61384185313354,5.936742949246677,1.5,2.75,NaN,NaN,1.4879988475446946,0.914765965279563,933.8539635915978,0.6911281214141388,0.9401645543454933,0.24903643293135444,24.427263909136553,8.599254040613342,86.12762664586948,1.7158836489201523,12.156489705210358,4985403013
1561123800,52.18,52.95,52.0201,52.16,41.38677966101695,54.841683168316834,52.3,42.1,52.3,27.54,55.38,38.42,54.48,39.04,45.13659999999997,46.82549999999999,48.73719999999991,47.47299999999997,48.00154849049557,48.88399915089416,49.30923076923073,52.860667848138895,45.757793690322565,45.13659999999997,46.82549999999999,48.73719999999991,47.47299999999997,52.3767,3595224,4302725.6,67.09610402177825,5.493690762862479,1.5,2.75,NaN,NaN,1.4481346441486451,0.8355689705148756,931.1797318979117,0.6822090164763044,1.101797703526735,0.41958868705043056,23.107985579622877,6.644857902269475,75.09022510750813,5.182698844482914,19.727076048008957,4981807789
1561383000,52.25,52.45,51.88,51.96,41.38440677966102,54.89811881188119,52.3,42.1,52.3,27.54,55.38,38.42,54.48,39.04,45.13094999999996,46.9477,48.786999999999914,47.76799999999997,48.15678188302516,49.176951612713765,49.7684615384615,53.01518624218603,46.52173683473697,45.13094999999996,46.9477,48.786999999999914,47.76799999999997,52.09666666666667,2137934,4223084.45,65.84135050084058,4.224411986447849,1.5,2.75,NaN,NaN,1.3854107409951706,0.5062494073496446,928.593088967493,0.6242673276214626,1.199922846577259,0.5756555189557963,23.68337978256035,6.301145662847786,60.12420364107634,12.534297057179767,27.34149930174389,4979669855
1561469400,51.68,51.7,50.05,50.11,41.38203389830509,54.954554455445546,52.3,42.1,52.3,27.54,55.38,38.42,54.48,39.04,45.11849999999997,47.04079999999999,48.78019999999992,48.033499999999975,48.23337867192613,49.26581336388388,50.01615384615381,52.805833049784866,47.22647464252276,45.11849999999997,47.04079999999999,48.78019999999992,48.033499999999975,50.620000000000005,3304209,4204903.15,55.50194158229211,1.374127436482542,1.5,2.75,NaN,NaN,1.4228814023526586,0.7857990736362144,925.6562539363754,0.4319146551514923,1.1155488378951617,0.6836341827436694,33.93397601706869,3.0433888546164853,30.900290183300935,35.918718254623464,33.1809915620756,4976365646
1561555800,50.65,50.93,49.91,50,41.37966101694916,55.0109900990099,52.3,42.1,52.3,27.54,55.38,38.42,54.48,39.04,45.10754999999997,47.13249999999999,48.773199999999925,48.33949999999997,48.30265793969374,49.33573590065684,50.14999999999997,52.750343172618656,47.549656827381284,45.10754999999997,47.13249999999999,48.773199999999925,48.33949999999997,50.28,3243848,4028023.4,54.949399232567174,0.6775575858652587,1.5,2.75,NaN,NaN,1.394104159327469,0.8053200485379505,926.9869805549313,0.2754575412399257,1.0279561092935765,0.7524985680536508,33.73501459392673,1.5434606011372827,8.852811775483078,66.90756365460071,24.239624569916202,4973121798
1561642200,50.4,50.77,50.2,50.47,41.37728813559322,55.06742574257426,52.41,42.1,52.3,27.54,55.38,38.42,54.48,39.04,45.09744999999996,47.220299999999995,48.77399999999992,48.65049999999998,48.38765174598026,49.44376105297524,50.269999999999975,52.77251565737049,47.76748434262946,45.09744999999996,47.220299999999995,48.77399999999992,48.65049999999998,50.48,2230393,3908068.5,56.92271060260581,1.1510918943412762,1.5,2.75,NaN,NaN,1.3495252908040787,0.5707149196591615,930.6301559930247,0.1860872300230274,0.985107605582435,0.7990203755594076,33.45500267986823,2.9789838808406466,2.9250177295160986,81.68030487957377,15.394677390910124,4975352191
1561728600,51.04,51.54,50.745,51.35,41.37491525423729,55.123861386138614,52.41,42.1,52.3,27.54,55.38,38.42,54.48,39.04,45.08894999999997,47.3117,48.80039999999992,49.09199999999997,48.50382226574574,49.62530761935855,50.45999999999997,52.8854040107546,48.03459598924535,45.08894999999997,47.3117,48.80039999999992,49.09199999999997,51.211666666666666,2845834,3789240.7,60.4185851792056,1.9560719039898735,1.5,2.75,NaN,NaN,1.3295591986037874,0.7510301470159971,934.6943991315632,0.16919167816566905,1.010509973266494,0.8413182951008249,34.104508012244054,4.561189167175732,19.23161543465242,49.9112946269812,30.857089938366386,4978198025
1561987800,53.19,53.3099,51.95,52.56,41.372542372881355,55.18029702970297,52.41,42.1,52.3,27.54,55.38,38.42,54.48,39.04,45.08639999999997,47.4168,48.84559999999991,49.61499999999997,48.66288805924591,49.904802131800594,50.76230769230767,53.17964448302661,48.34497090158874,45.08639999999997,47.4168,48.84559999999991,49.61499999999997,52.60663333333334,4326115,3654302.4,64.66480391431605,3.9256063463595914,1.5,2.75,NaN,NaN,1.3745835415606595,1.1838415452426707,936.8378996784711,0.21928180115373408,1.1154205465429925,0.8961387453892584,35.647573611768046,3.9968341907400142,48.291319719470756,20.392229802922433,31.3164504776068,4982524140
1562074200,52.6,53.06,52.1,53.04,41.370169491525424,55.23673267326733,52.41,42.1,52.3,27.54,55.38,38.42,54.48,39.04,45.08189999999997,47.53900000000001,48.89859999999992,50.02549999999997,48.83453950790293,50.20339240496244,51.05461538461536,53.58146341066393,48.52776735856679,45.08189999999997,47.53900000000001,48.89859999999992,50.02549999999997,52.73333333333333,2124059,3461663.55,66.21325657487057,3.4565087015763933,1.5,2.75,NaN,NaN,1.344970431449184,0.6135948711711166,938.6034084653639,0.26164475822182565,1.2231946931665405,0.9615499349447149,32.91469282500084,4.020396156109035,75.26327445353485,5.129212125270341,19.607513421194806,4984648199
1562160600,53.42,54.27,53.3436,54.23,41.36779661016949,55.29316831683169,52.41,42.1,52.3,27.54,55.38,38.42,54.48,39.04,45.08324999999997,47.67190000000001,48.948199999999915,50.437499999999964,49.04612619386752,50.586878842585065,51.456153846153825,54.20501138183647,48.70729631047118,45.08324999999997,47.67190000000001,48.948199999999915,50.437499999999964,53.94786666666667,1488443,3306270.4,69.75220734764807,4.769887371826405,1.5,2.75,NaN,NaN,1.3367582577742425,0.4501879217138441,940.7780541066901,0.3416579411616443,1.38862236139677,1.0469644202351258,34.36493048995882,3.472619729059341,100,0,0,4986136642
1562333400,53.53,54.16,52.75,53.99,41.36542372881356,55.349603960396045,52.41,42.1,52.3,27.54,55.38,38.42,54.48,39.04,45.08774999999997,47.801500000000004,48.99839999999991,50.79249999999997,49.24000359802958,50.91098561948173,51.83153846153844,54.528646270385615,49.13443065269127,45.08774999999997,47.801500000000004,48.99839999999991,50.79249999999997,53.63333333333333,3417525,3240847.85,68.20065756974124,4.023363944186718,1.5,2.75,NaN,NaN,1.3469898107903677,1.054515718780195,940.002205057214,0.34903716618909053,1.4832608779714889,1.1342237117823983,31.92280680663488,3.5084355828220963,70.85128188501707,6.9707994483952875,22.177918666587637,4982719117
1562592600,53.27,53.47,52.85,53.23,41.36305084745763,55.4060396039604,52.41,42.1,52.3,27.54,55.38,38.42,54.48,39.04,45.08429999999996,47.907700000000006,49.03619999999991,51.04099999999996,49.396474045165675,51.13184413191204,52.03846153846152,54.72018137874595,49.35674169817709,45.08429999999996,47.907700000000006,49.03619999999991,51.04099999999996,53.18333333333333,2254424,3087427.55,63.39194448564368,2.2968321741538347,1.5,2.75,NaN,NaN,1.3322048243053415,0.7301949482182991,937.5446920707295,0.2765232908912414,1.47987782539645,1.2033545345052086,33.18473776539988,2.444187836797529,45.194114283152494,22.755639837376435,32.05024587947107,4980464693
1562679000,52.48,53.5399,52.451,53.38,41.3606779661017,55.46247524752476,52.41,42.1,52.3,42.1,55.38,27.54,54.48,38.42,45.08059999999996,48.01170000000001,49.06339999999991,51.26449999999996,49.55269074927683,51.34595421458708,52.22230769230767,54.918962644094066,49.52565274052128,45.08059999999996,48.01170000000001,49.06339999999991,51.26449999999996,53.12363333333334,2006490,2934689.25,63.93247350263458,1.9378311247546447,1.5,2.75,NaN,NaN,1.3148259082835314,0.683714638611226,938.4870295898806,0.21517908682188858,1.4723283930325692,1.2571493062106807,32.97342984965856,6.525643584114954,33.553900204112566,33.12622411597282,33.31987567991461,4982471183
1562765400,54.01,54.69,53.69,54.15,41.358305084745766,55.518910891089114,52.41,42.1,52.3,42.1,55.38,27.54,54.48,38.42,45.07444999999996,48.12630000000001,49.10239999999992,51.52799999999996,49.73297738656009,51.613006194150216,52.35615384615383,55.24281855409874,49.46948913820892,45.07444999999996,48.12630000000001,49.10239999999992,51.52799999999996,54.17666666666667,4260718,2962758.05,66.65433419839263,3.1937136922585374,1.5,2.75,NaN,NaN,1.3144812005489932,1.4380917807311333,941.1544974182499,0.20312809573170876,1.5110594258753167,1.307931330143608,22.124188178801642,8.299999999999997,45.008964278848865,22.90306673910388,32.087968982047244,4986731901
1562851800,54.53,54.66,53.9,54.47,41.355932203389834,55.57534653465347,52.41,42.1,52.3,42.1,55.38,27.54,54.48,38.42,45.070549999999955,48.230300000000014,49.14579999999991,51.81999999999996,49.91874297924401,51.88510084232639,52.53384615384614,55.627318571313786,49.4403737363785,45.070549999999955,48.230300000000014,49.14579999999991,51.81999999999996,54.343333333333334,3822290,3003072.75,67.74378318913962,2.9504338218891926,1.5,2.75,NaN,NaN,1.2748754005097793,1.2727930084277845,941.2428857658982,0.1934239496981962,1.5497112672663533,1.3562873175681571,21.265240724240076,7.925500297206261,54.18700808737167,16.20111488453021,29.61187702809814,4990554191
1562938200,54.77,55.2201,54.58,55.16,41.3535593220339,55.631782178217826,52.41,42.1,52.3,42.1,55.38,27.54,54.48,38.42,45.07269999999996,48.33890000000001,49.22599999999991,52.115999999999964,50.124282470254045,52.196996000200066,52.77999999999998,56.148670132491205,49.411329867508755,45.07269999999996,48.33890000000001,49.22599999999991,52.115999999999964,54.986700000000006,2427182,2974173.9,70.01838960460604,3.5192741894089954,1.5,2.75,NaN,NaN,1.2373914433305095,0.8160861071371786,944.2300377411209,0.20887115135621137,1.6173762567634213,1.40850510540721,21.389563803485906,7.4196689386562715,83.13282673353643,2.489503155574041,14.37767011088953,4992981373
1563197400,55.46,55.46,54.95,55.23,41.35118644067797,55.68821782178218,52.41,42.1,52.3,42.1,55.38,27.54,54.48,38.42,45.076799999999956,48.445600000000006,49.3145999999999,52.426999999999964,50.324506687106826,52.485853523990535,53.173846153846135,56.39578573654414,49.95190657114813,45.076799999999956,48.445600000000006,49.3145999999999,52.426999999999964,55.21333333333333,1810503,2961912.75,70.24760741455138,3.3026630836362534,1.5,2.75,NaN,NaN,1.1854349116640444,0.6112614222009072,943.7707584143491,0.19922995147730793,1.657542544753845,1.458312593276537,21.061228458789248,5.079908675799076,100,0,0,4994791876
1563283800,55.19,55.291,54.51,54.64,41.34881355932203,55.74465346534654,52.41,42.1,52.3,42.1,55.38,27.54,54.48,38.42,45.08049999999996,48.55130000000001,49.362399999999894,52.70349999999998,50.49374171898499,52.691010331229535,53.53076923076921,56.25716963635853,50.804368825179886,45.08049999999996,48.55130000000001,49.362399999999894,52.70349999999998,54.813666666666656,2263329,2983063.15,65.68907346337062,2.2798660304382987,1.5,2.75,NaN,NaN,1.156546703688041,0.7587264788544621,944.5442508825029,0.13179549170800553,1.623056957911544,1.4912614662035384,20.648733754448244,3.016591251885372,82.51029058268044,2.6668452196605603,14.822864197659008,4992528547
1563370200,54.7,54.77,53.58,53.61,41.3464406779661,55.801089108910894,52.41,42.1,52.3,42.1,55.38,27.54,54.48,38.42,45.07684999999996,48.63830000000001,49.4017999999999,52.85699999999997,50.61594792608362,52.778533156826725,53.77230769230767,55.85059328527057,51.69402209934477,45.07684999999996,48.63830000000001,49.4017999999999,52.85699999999997,53.98666666666666,2837020,2914960.25,58.54635672223806,0.7698402379235165,1.5,2.75,NaN,NaN,1.1589362248531814,0.9732619853049455,942.0601131707525,0.003292201427303576,1.4953767179876678,1.4920845165603642,24.066636448071318,-1.1432786280656417,50.45714024401118,18.78149646167874,30.76136329431008,4989691527
1563456600,53.26,54.36,52.99,54.17,41.34406779661017,55.85752475247525,52.41,42.1,52.3,42.1,55.38,27.54,54.48,38.42,45.07609999999996,48.72920000000001,49.503999999999905,53.01599999999998,50.7553225172176,52.91105380855751,53.989230769230744,55.530108871302346,52.44835266715914,45.07609999999996,48.72920000000001,49.503999999999905,53.01599999999998,53.839999999999996,2741047,2863257.05,61.02756552143208,0.5694538348284989,1.5,2.75,NaN,NaN,1.1740122087922396,0.9573178209759408,943.7842004841506,-0.05528891202286834,1.422973376531779,1.4782622885546473,21.048820885720176,0.3333950731616961,45.40405712678671,22.591984898766768,32.003957974446514,4992432574
1563543000,54.8,54.8,53.1,53.18,41.34169491525424,55.913960396039606,52.41,42.1,52.3,42.1,55.38,27.54,54.48,38.42,45.06754999999996,48.81130000000001,49.5909999999999,53.054499999999976,50.85040790869926,52.936667731552035,54.036923076923046,55.429107516856526,52.644738636989565,45.06754999999996,48.81130000000001,49.5909999999999,53.054499999999976,53.693333333333335,2998605,2806759.6,54.78459978803777,0.19306559889641536,1.5,2.75,NaN,NaN,1.2115827653070792,1.068351204713079,942.0985938155384,-0.165764605188657,1.271056532068826,1.436821137257483,23.489448767617,-0.09393199323689115,17.709014930125715,51.97489554763652,30.316089522237764,4989433969
1563802200,53.44,53.9048,53.1319,53.58,41.339322033898306,55.97039603960396,55.23,42.1,52.3,42.1,55.38,27.54,54.48,38.42,45.061449999999965,48.89840000000001,49.693599999999904,53.12549999999997,50.95745073580909,52.99793747140422,54.07846153846151,55.378351383589724,52.7785716933333,45.061449999999965,48.89840000000001,49.693599999999904,53.12549999999997,53.53889999999999,2546432,2754320,56.71144774601888,0.11054024747745779,1.5,2.75,NaN,NaN,1.1802482820708593,0.9245229312498184,941.237776068135,-0.21389113339443022,1.1694572205144453,1.3833483539088756,22.487003376308706,0.37467216185836594,19.937100007639014,48.87552421485969,31.187375777501323,4991980401
1563888600,54.25,54.73,53.77,54.73,41.336949152542374,56.02683168316832,55.23,42.1,52.3,42.1,55.38,27.54,54.48,38.42,45.06049999999996,48.999900000000004,49.80879999999991,53.26399999999997,51.105393844208734,53.16289580746096,54.11692307692305,55.46129904575101,52.77254710809509,45.06049999999996,48.999900000000004,49.80879999999991,53.26399999999997,54.41,2622704,2778558.5,61.75727553977046,1.428999941427836,1.5,2.75,NaN,NaN,1.1780876904943693,0.9439081451767166,944.2096203451925,-0.17206479175146994,1.1682673642195383,1.3403321559710082,25.420064643120323,1.0710987996306525,43.47496895998956,24.15133268987303,32.3736983501374,4994603105
1563975000,54.28,55.5,54.23,55.5,41.33457627118644,56.083267326732674,55.23,42.1,52.3,42.1,55.38,27.54,54.48,38.42,45.06994999999996,49.10040000000001,50.01159999999991,53.53349999999997,51.27773134051427,53.38547715913135,54.233076923076894,55.76180459144156,52.70434925471223,45.06994999999996,49.10040000000001,50.01159999999991,53.53349999999997,55.07666666666666,2461640,2736430.05,64.7223561372644,2.216340533240566,1.5,2.75,NaN,NaN,1.1846528554590574,0.8995808242933161,947.8630253899491,-0.09990888169286016,1.215446053854933,1.3153549355477931,25.361230171009833,1.8909491463190768,72.85144614154608,6.095308364319701,21.053245494134227,4997064745
1564061400,55.25,55.25,54.2,54.66,41.33220338983051,56.13970297029704,55.23,42.1,52.3,42.1,55.38,27.54,54.48,38.42,45.07929999999996,49.198100000000004,50.1745999999999,53.76649999999997,51.41036932716077,53.506860286833124,54.34307692307689,55.76964644178812,52.91650740436567,45.07929999999996,49.198100000000004,50.1745999999999,53.76649999999997,54.70333333333334,3708855,2759680.4,59.31910090537054,1.1114001128420803,1.5,2.75,NaN,NaN,1.1928919372119817,1.3439436682595565,944.2322134010237,-0.1150442439655408,1.1715496305908673,1.286593874556408,27.149690980727318,-0.9064539521392314,37.251783732679286,29.58231809343383,33.16589817388688,4993355890
1564147800,55.09,55.87,55.02,55.74,41.32983050847458,55.87,55.23,42.1,52.3,42.1,55.38,27.54,54.48,38.42,45.09469999999996,49.3081,50.3427999999999,54.02999999999997,51.58015876531133,53.71954025951568,54.52461538461535,56.014016201353215,53.03521456787749,45.09469999999996,49.3081,50.3427999999999,54.02999999999997,55.54333333333333,1860796,2741200.55,63.534271977473274,2.520550549831496,1.5,2.75,NaN,NaN,1.19411394169684,0.6788251957705175,947.3074201504512,-0.06130654028919946,1.2099606991949088,1.2712672394841082,28.556052682149392,0.9234111895708947,64.16518872516656,10.233454164909192,25.601357109924233,4995216686
1564407000,55.68,55.7,55.1148,55.46,41.32745762711865,55.921,55.23,42.1,52.3,42.1,55.38,27.54,54.48,38.42,45.109699999999954,49.4239,50.4795999999999,54.23549999999998,51.732309401965786,53.885298330038,54.62538461538459,56.17578139605552,53.07498783471366,45.109699999999954,49.4239,50.4795999999999,54.23549999999998,55.424933333333335,1802805,2689049.1,61.74792432016796,1.777839734598309,1.5,2.75,NaN,NaN,1.1534772315756372,0.6704247237434229,948.02419170952,-0.053869845178750486,1.20392993301067,1.2577997781894206,28.765969739852583,1.5007320644216695,43.38700763144114,24.286989299591824,32.32600306896704,4993413881
1564493400,54.61,55.28,54.37,55.1,41.325084745762716,55.971999999999994,55.23,42.1,52.3,42.1,55.38,27.54,54.48,38.42,45.14774999999996,49.54670000000001,50.626999999999896,54.362499999999976,51.86437569992791,54.000984203367715,54.67384615384613,56.241078667380506,53.10661364031175,45.14774999999996,49.54670000000001,50.626999999999896,54.362499999999976,54.916666666666664,2480110,2596748.85,59.434139030740646,0.8330938135073377,1.5,2.75,NaN,NaN,1.1489431436059492,0.9550827374006539,950.1118538788695,-0.08082620191556034,1.15676702579497,1.2375932277105304,28.26523340481496,2.7793322141391568,17.434513553058665,52.45144920116652,30.114037245774814,4990933771
1564579800,55.2,55.29,51.971,53.19,41.322711864406784,56.022999999999996,55.23,42.1,52.3,42.1,55.38,27.54,54.48,38.42,45.19234999999996,49.65330000000001,50.7559999999999,54.36999999999998,51.9163609665974,53.923747612570786,54.52230769230766,56.24542032930018,52.799195055315145,45.19234999999996,49.65330000000001,50.7559999999999,54.36999999999998,53.48366666666667,5429544,2762023.1,48.953256971139375,1.6860631614347488,1.5,2.75,NaN,NaN,1.3039472047769531,1.9657851521951426,947.2986744507804,-0.22665952013642565,0.9542688275399982,1.1809283476764239,33.48627864783064,-1.8091194388037732,1.9229869249476437,85.32136897907391,12.755644095978443,4985504227
1564666200,53.32,55.0568,51.36,51.82,41.320338983050846,56.074,55.23,42.1,52.3,42.1,55.38,27.54,54.48,38.42,45.22059999999996,49.727500000000006,50.832599999999914,54.249499999999976,51.91258210516221,53.72339069708785,54.25999999999998,56.447854586645924,52.07214541335403,45.22059999999996,49.727500000000006,50.832599999999914,54.249499999999976,52.745599999999996,8602170,3117709.45,43.08439684697304,3.3006169751808248,1.5,2.75,NaN,NaN,1.4748652615785995,2.7591313873074346,943.8978231641634,-0.4043796499103418,0.6754537852884965,1.0798334351988383,35.50928827323431,-2.5573523881158318,1.1264118726133032,88.90796923083127,9.965618896555421,4976902057
1564752600,51.29,51.39,49.73,50.67,41.317966101694914,56.125,55.74,42.1,52.3,42.1,55.38,27.54,54.48,38.42,45.24719999999996,49.78550000000001,50.89459999999991,54.08349999999998,51.86385339515585,53.432591583079486,53.95461538461536,56.8416219832555,51.06760878597522,45.24719999999996,49.78550000000001,50.89459999999991,54.08349999999998,50.59666666666667,6836196,3288643,38.87163479652609,5.906936966055406,1.5,2.75,NaN,NaN,1.5188034571801283,2.0787285211559903,941.3564980505006,-0.577807883484555,0.3575735808431446,0.9353814643276996,36.15299753019246,-5.431131019036948,0,100,0,4970065861
1565011800,48.28,48.33,45,46.13,45,56.175999999999995,55.74,42.1,52.3,42.1,55.38,27.54,54.48,38.42,45.23674999999996,49.78920000000001,50.899399999999915,53.72849999999998,51.638996399267384,52.73710667040525,53.37923076923074,58.459814996922915,48.29864654153856,45.23674999999996,49.78920000000001,50.899399999999915,53.72849999999998,46.48666666666667,9030510,3627447.3,27.45735885022468,13.897067932029666,1.5,2.75,NaN,NaN,1.8153174959529765,2.4894944717735803,934.1438883195895,-0.9544795843850084,-0.2577180161535608,0.6967615682314475,61.400510389221665,-15.713502649369623,0,100,0,4961035351
1565098200,47.1,48.0954,46.2801,48,45.08136363636363,56.227,55.74,42.1,52.3,42.1,55.38,27.54,54.48,38.42,45.235349999999954,49.812700000000014,50.93819999999992,53.45949999999998,51.49629065811964,52.285953654176176,52.904615384615354,58.70309059736736,47.10614017186335,45.235349999999954,49.812700000000014,50.93819999999992,53.45949999999998,47.458499999999994,5088705,3781558.05,35.81731296825268,9.12590962641871,1.5,2.75,NaN,NaN,1.826037674813478,1.3456635949301374,937.6699815306849,-1.0275479230281828,-0.5876733355537809,0.43987458747440183,66.11720947528032,-13.513513513513514,2.1209336469425555,84.50824492843081,13.370821424626646,4966124056
1565184600,46.28,48.48,45.11,48.09,45.162727272727274,56.278,55.74,42.1,52.3,42.1,55.38,27.54,54.48,38.42,45.244549999999954,49.830300000000015,51.00399999999991,53.15649999999997,51.36271063231103,51.886339020445114,52.5130769230769,58.84697296368685,46.17918088246695,45.244549999999954,49.830300000000015,51.00399999999991,53.15649999999997,47.22666666666667,8132269,3975135.6,36.198403067448034,8.477245954733439,1.5,2.75,NaN,NaN,1.9363206980410865,2.0457840482221537,936.2627174627635,-1.0177466449589492,-0.8323087187242848,0.18543792623466449,64.65526107363775,-12.019758507135005,14.72091076741026,56.48100728406964,28.7980819485201,4974256325
1565271000,48.89,50.84,48.56,50.84,45.24409090909091,56.32899999999999,55.74,42.1,52.3,42.1,55.38,27.54,54.48,38.42,45.26844999999996,49.87090000000002,51.143199999999915,52.974999999999966,51.34221217614197,51.78668768516463,52.30230769230767,58.66246324844188,45.94215213617346,45.26844999999996,49.87090000000002,51.143199999999915,52.974999999999966,50.080000000000005,5007275,4034384.85,46.62660569853478,2.2761170837888636,1.5,2.75,NaN,NaN,1.9944406481810089,1.2411495645984294,941.2244128436421,-0.784443459550046,-0.795116398202893,-0.01067293865284702,76.04052130229216,-8.790814495873697,37.58311090147298,29.284133438269848,33.13275566025717,4979263600
1565357400,50.3,50.64,48.79,49.73,45.32545454545455,56.379999999999995,55.74,42.1,52.3,42.1,55.38,27.54,54.48,38.42,45.289499999999954,49.89960000000002,51.252799999999915,52.70349999999996,51.278988169234445,51.5908126675299,51.917692307692285,58.24875445625741,45.58663015912716,45.289499999999954,49.89960000000002,51.252799999999915,52.70349999999996,49.72,6514156,4238733.55,43.533621657413,2.617870084855246,1.5,2.75,NaN,NaN,1.9984091733109373,1.5368165805090532,938.331426606314,-0.667832024081763,-0.8454629687550508,-0.17763094467328777,74.40954289399627,-10.331770645510286,38.614844425320655,28.34412049848212,33.04103507619722,4972749444
1565616600,48.91,49.2309,47.43,47.96,45.40681818181818,56.431,55.74,42.1,52.3,42.1,55.38,27.54,54.48,38.42,45.30559999999995,49.915300000000016,51.36159999999992,52.33999999999996,51.148831770440935,51.24502098490801,51.337692307692286,57.63115242408981,45.04423219129476,45.30559999999995,49.915300000000016,51.36159999999992,52.33999999999996,48.206966666666666,4609576,4378687.2,39.08165598816576,5.469133818887884,1.5,2.75,NaN,NaN,2.019951375217299,1.0527301424956776,934.5631378700307,-0.6710712147681377,-1.01646996313346,-0.34539874836532225,75.5743624007032,-12.958257713248639,50.339261570398925,18.853645399754324,30.807093029846754,4968139868
1565703000,47.78,50.9783,47.59,50.21,45.488181818181815,56.482,55.74,42.1,52.3,42.1,55.38,27.54,54.48,38.42,45.353199999999944,49.938200000000016,51.523799999999916,52.11849999999996,51.11201483826678,51.14644755777391,50.9953846153846,57.00654150075964,44.984227730009565,45.353199999999944,49.938200000000016,51.523799999999916,52.11849999999996,49.59276666666668,6166381,4573839.8,46.56274895924655,1.8685454921362639,1.5,2.75,NaN,NaN,2.1176905627017772,1.3481847352852192,938.4242317535061,-0.49118413671828076,-0.9593789192631732,-0.46819478254489244,83.17749471248257,-5.602556871592398,52.766125281621356,17.15090320165472,30.08297151672392,4974306249
1565789400,47.88,48.24,45.69,45.73,45.569545454545455,56.532999999999994,55.74,42.1,52.3,42.1,55.38,27.54,54.48,38.42,45.36724999999994,49.94370000000001,51.541799999999924,51.72449999999996,50.900955432844555,50.63059540941449,50.225384615384606,56.17234823822282,44.278420992546394,45.36724999999994,49.94370000000001,51.541799999999924,51.72449999999996,46.553333333333335,10357587,4949868.15,36.85721102598402,8.08129635177888,1.5,2.75,NaN,NaN,2.289284093937365,2.0924975547075935,931.7775951771783,-0.6343204085395705,-1.2610952932193555,-0.626774884679785,95.57254676591793,-11.752219220378239,16.50320620499057,53.721403082285015,29.775390712724413,4963948662
1565875800,46.22,46.57,45.01,46.1,45.65090909090909,56.583999999999996,55.74,42.1,52.3,42.1,55.38,27.54,54.48,38.42,45.394949999999945,49.95450000000001,51.543999999999926,51.320999999999955,50.71268267077222,50.1991101323274,49.5053846153846,54.991566504091566,44.019202726677634,45.394949999999945,49.95450000000001,51.543999999999926,51.320999999999955,45.89333333333334,7233953,5174513.45,38.00651639102136,7.411631659848826,1.5,2.75,NaN,NaN,2.237192372941839,1.3979967527188473,933.380149955706,-0.6614566041309599,-1.4535956398434848,-0.792139035712525,96.14292514391495,-9.019143477402801,19.653517774936436,49.238481202667295,31.10800102239628,4971182615
1565962200,46.98,48.3399,46.94,48.08,45.73227272727273,56.635,55.74,42.1,52.3,42.1,55.38,27.54,54.48,38.42,45.43599999999994,49.97500000000001,51.56779999999993,51.06599999999996,50.60944021309488,49.99729011972479,48.9653846153846,53.42926781887883,44.501501411890374,45.43599999999994,49.97500000000001,51.56779999999993,51.06599999999996,47.78663333333333,4104839,5229825.15,43.892030134603864,2.803107867188201,1.5,2.75,NaN,NaN,2.2373857748745647,0.7848902940856445,938.055508162194,-0.5102096428768775,-1.429901089308622,-0.9196914464317444,100.51856095784807,4.227184045089953,39.868722970785456,27.20039323865945,32.93088379055509,4975287454
1566221400,49.8,50.22,49.4,49.81,45.81363636363636,56.68599999999999,55.74,42.1,52.3,42.1,55.38,27.54,54.48,38.42,45.47644999999994,50.019700000000014,51.59879999999992,50.877499999999955,50.57808961650292,49.979452965465285,48.7053846153846,52.4979896903216,44.9127795404476,45.47644999999994,50.019700000000014,51.59879999999992,50.877499999999955,49.81,4132041,5309105.6,48.493202287663244,1.4778001065613249,1.5,2.75,NaN,NaN,2.23042964809781,0.7782932402022669,941.8410196319136,-0.269875735374277,-1.2570361156495906,-0.9871603802753136,85.02517106745965,3.770833333333338,59.569407922359424,12.820327465481027,27.610264612159547,4979419495
1566307800,49.58,49.85,48.63,48.68,45.894999999999996,56.736999999999995,55.74,42.1,52.3,42.1,55.38,27.54,54.48,38.42,45.50479999999994,50.04780000000002,51.594199999999915,50.57499999999995,50.503654729581235,49.85569554018288,48.463846153846134,51.80537540726878,45.12231690042349,45.50479999999994,50.04780000000002,51.594199999999915,50.57499999999995,49.053333333333335,3982999,5377120.35,45.848446499568,0.20926222714009374,1.5,2.75,NaN,NaN,2.1582561018051094,0.7407308635002005,939.5108212366255,-0.16820597355564293,-1.1974178472198673,-1.0292118736642244,83.98165892649162,1.2268662923684681,35.840876491033015,30.90661566364802,33.25250784531896,4975436496
1566394200,49.89,50.1,49.51,49.88,45.97636363636364,56.788,55.74,42.1,52.3,42.1,55.38,27.54,54.48,38.42,45.53224999999994,50.079000000000015,51.61419999999992,50.29399999999996,50.479197681362365,49.858010250641655,48.40307692307691,51.60784629786227,45.19830754829155,45.53224999999994,50.079000000000015,51.61419999999992,50.29399999999996,49.83,3300439,5419060.3,49.02770875485794,1.1504380150289448,1.5,2.75,NaN,NaN,2.1055235231047447,0.6090426784880029,943.130789008121,-0.009699376663194759,-1.041336094493218,-1.0316367178300232,85.00918404854008,-1.8882769472856034,78.81100196597585,3.830275043195136,17.35872299082904,4978736935
1566480600,50.27,50.6361,48.81,49.77,46.05772727272727,56.839,55.74,42.1,52.3,42.1,55.38,27.54,54.48,38.42,45.56369999999995,50.09310000000002,51.636999999999915,50.04949999999996,50.45138600758345,49.84962832200912,48.683076923076904,51.67340373429166,45.692750111862146,45.56369999999995,50.09310000000002,51.636999999999915,50.04949999999996,49.7387,3745534,5420894.25,48.74519256097756,1.1454688923396672,1.5,2.75,NaN,NaN,2.085564700025834,0.6909439342042136,941.6880025883551,0.0925432368524679,-0.9159576717644384,-1.0085009086169063,78.30616599550999,0.08043434546552636,46.36349312514724,21.842358019644045,31.794148855208704,4974991401
1566567000,49.07,49.9999,45.2799,45.98,46.13909090909091,56.88999999999999,55.74,42.1,52.3,42.1,55.38,27.54,54.48,38.42,45.572399999999945,50.06880000000002,51.57179999999992,49.56149999999995,50.27603753669783,49.48109229134158,48.52769230769229,51.836786107382466,45.21859850800212,45.572399999999945,50.06880000000002,51.57179999999992,49.56149999999995,47.0866,7906817,5723195.3,40.1587520427367,5.44069632421177,1.5,2.75,NaN,NaN,2.2737386500239887,1.3815389106151943,936.7127552156355,-0.08089897875171026,-1.1096246320565442,-1.028725653304834,89.64371561846788,-4.128440366972486,13.716801231690214,58.082574635453774,28.200624132856,4967084584
1566826200,47.14,47.47,46.32,47.47,46.220454545454544,56.940999999999995,55.74,42.1,52.3,42.1,55.38,27.54,54.48,38.42,45.584349999999944,50.05700000000002,51.54099999999991,49.161999999999956,50.165996848984186,49.28955969216619,48.47999999999998,51.83056367244033,45.12943632755964,45.584349999999944,50.05700000000002,51.54099999999991,49.161999999999956,47.086666666666666,4527070,5859408.55,44.31188322092176,3.4112342379646945,1.5,2.75,NaN,NaN,2.217757317879418,0.7726155227731987,940.0731324015271,-0.08090132670986772,-1.1298523116921686,-1.0489509849823009,90.26814720120952,-5.457080262895842,13.832447198281594,57.937905471457,28.229647330261397,4971611654
1566912600,48.24,48.42,46.5,46.9,46.301818181818184,56.992,55.74,42.1,52.3,42.1,55.38,27.54,54.48,38.42,45.57939999999994,50.03590000000002,51.496799999999915,48.75199999999996,50.037918541180886,49.061982578626555,48.17692307692305,51.32545518536182,45.02839096848429,45.57939999999994,50.03590000000002,51.496799999999915,48.75199999999996,47.27333333333333,3904037,5930604.9,43.080125654475914,2.8154106317931737,1.5,2.75,NaN,NaN,2.1964889380308885,0.6582864759714476,937.1176808493018,-0.10347479960841266,-1.1782944844928167,-1.074819684884404,85.25545917895717,2.5584955171659782,14.126085563604052,57.46329380717834,28.410620629217608,4967707617
1566999000,46.52,47.9762,46.12,47.89,46.38318181818182,57.04299999999999,55.74,42.1,52.3,42.1,55.38,27.54,54.48,38.42,45.58054999999994,50.01820000000002,51.44379999999991,48.48699999999995,49.953686441526735,48.950365190185934,48.035384615384594,51.05470308544844,45.01606614532075,45.58054999999994,50.01820000000002,51.44379999999991,48.48699999999995,47.32873333333333,2717672,5795011.3,45.893327413252756,2.0905712259144718,1.5,2.75,NaN,NaN,2.1721825853143963,0.4689675065862253,940.4519149618255,-0.03922068203933615,-1.1238455374335743,-1.0846248553942381,65.81488928450494,3.8828633405639894,12.294710464054788,60.507259905837934,27.198029630107275,4970425289
1567085400,49.33,49.99,48.741,49.68,46.46454545454545,57.093999999999994,55.74,42.1,52.3,42.1,55.38,27.54,54.48,38.42,45.59729999999994,50.01690000000002,51.41759999999991,48.37999999999995,49.942953639898235,49.019854219692036,48.16769230769228,51.3104216834092,45.02496293197535,45.59729999999994,50.01690000000002,51.41759999999991,48.37999999999995,49.47033333333333,3411910,5535498.3,50.643244917889746,2.4460430669683872,1.5,2.75,NaN,NaN,2.1670266863633683,0.6163690809913175,944.6999706360716,0.12723050300904726,-0.925586726632929,-1.0528172296419762,68.35921188301155,3.327787021630619,29.96848659319664,36.88005006397542,33.15146334282795,4973837199
1567171800,50.51,50.5299,49.1,49.64,46.54590909090909,57.144999999999996,55.74,42.1,55.74,42.1,52.3,27.54,55.38,38.42,45.62729999999994,50.023200000000024,51.36219999999991,48.32849999999995,49.931073105000266,49.07891572257851,48.12384615384612,51.165662801954625,45.08202950573761,45.62729999999994,50.023200000000024,51.36219999999991,48.32849999999995,49.75663333333334,2951009,5341238.95,50.53647918987361,2.164085463092546,1.5,2.75,NaN,NaN,2.1143747801945563,0.5524952221057251,946.3639139893722,0.23193487506070665,-0.762898635816093,-0.9948335108767996,64.76626861734951,-0.34129692832764846,47.29703930293339,21.158048263393976,31.54491243367262,4970886190
1567517400,48.66,49.18,47.99,48.78,46.627272727272725,57.196,55.74,42.1,55.74,42.1,52.3,27.54,55.38,38.42,45.654199999999946,50.015900000000016,51.29459999999992,48.46099999999995,49.88593298323555,49.05044755852341,48.3584615384615,51.07907058966078,45.637852487262215,45.654199999999946,50.015900000000016,51.29459999999992,48.46099999999995,48.65,2798929,5029659.9,48.18446196416929,0.2783950785056578,1.5,2.75,NaN,NaN,2.081205153037802,0.5564847436304788,943.6392281279419,0.2395896539355059,-0.6953464434574173,-0.9349360973929232,62.22001809119485,0.2054231717337745,18.71687937355673,50.64119220353178,30.64192842291148,4968087261
1567603800,49.96,50.41,49.534,50.36,46.708636363636366,57.24699999999999,55.74,42.1,55.74,42.1,52.3,27.54,55.38,38.42,45.69339999999995,50.02480000000001,51.26259999999992,48.57899999999995,49.90452384663808,49.17516683866403,48.68615384615381,51.26208430939992,46.1102233829077,45.69339999999995,50.02480000000001,51.26259999999992,48.57899999999995,50.10133333333332,2429108,4896680.05,52.55347412308342,2.5594104530355235,1.5,2.75,NaN,NaN,2.0489762135351017,0.4960724358537577,947.8555983414998,0.3411833782423419,-0.5084568745899958,-0.8496402528323377,63.43447642503579,0.9623095429029608,45.27220146933896,22.771388904003,31.95640962665805,4970516369
1567690200,51.8,52.86,51.74,52.32,46.79,57.297999999999995,55.74,42.1,55.74,42.1,52.3,27.54,55.38,38.42,45.73564999999994,50.043500000000016,51.306799999999924,48.79049999999995,49.99924840167188,49.47467475879127,49.01230769230766,52.19976536112972,45.824850023485595,45.73564999999994,50.043500000000016,51.306799999999924,48.79049999999995,52.306666666666665,3355114,4657822.3,57.35694557255924,5.669621403306702,1.5,2.75,NaN,NaN,2.0811921982825945,0.7203181624168016,951.3791738573053,0.5198035890597399,-0.19988576650766277,-0.7196893555674027,65.56184509825458,5.123568414707649,48.84353009580405,20.02751793988723,31.12895196430871,4973871483
1567776600,52.53,52.81,52.1161,52.44,46.87136363636363,57.349,55.74,42.1,55.74,42.1,52.3,27.54,55.38,38.42,45.77724999999994,50.064400000000006,51.355599999999924,48.87049999999995,50.09496415062592,49.75708668652543,49.21461538461535,52.87733077400457,45.55189999522613,45.77724999999994,50.064400000000006,51.355599999999924,48.87049999999995,52.45536666666667,2455196,4530218.35,57.63970664020145,5.2566678518553,1.5,2.75,NaN,NaN,1.9820998984052662,0.5419597490262252,952.9542530035516,0.6187297038145735,0.05372277420081417,-0.5650069296137593,65.43752290416681,14.049586776859508,45.65555675475793,22.467717271190875,31.876725974051187,4976326679
1568035800,53.03,53.0499,51.96,52.46,46.95272727272727,57.39999999999999,55.74,42.1,55.74,42.1,52.3,27.54,55.38,38.42,45.829149999999935,50.084700000000005,51.395399999999924,49.00699999999995,50.187710654522945,50.01450700209444,49.505384615384585,53.53404818752793,45.47672104324124,45.829149999999935,50.084700000000005,51.395399999999924,49.00699999999995,52.48996666666667,2289334,4318977.25,57.69006216521329,4.322470150666223,1.5,2.75,NaN,NaN,1.9183713342334614,0.5300639173313543,955.542103404361,0.6547272561525749,0.2534021405769593,-0.40132511557561557,38.17677597212125,10.511902254055197,76.51245030104467,4.643587911696535,18.843961787258802,4978616013
1568122200,52.08,52.52,51.37,52.52,47.03409090909091,57.45099999999999,55.74,42.1,55.74,42.1,52.3,27.54,55.38,38.42,45.89359999999994,50.10960000000001,51.418799999999926,49.23499999999994,50.279172981796556,50.25312538284735,49.708461538461506,54.04646424196704,45.370458834955976,45.89359999999994,50.10960000000001,51.418799999999926,49.23499999999994,52.13666666666666,2827867,4229891.8,57.85193417428147,3.019876431537273,1.5,2.75,NaN,NaN,1.8634876675025003,0.6685435783487417,957.506064416485,0.6504558042180852,0.41174463969699104,-0.23871116452109423,36.71713454101455,11.982942430703634,100,0,0,4981443880
1568208600,52.65,53.63,52.28,53.62,47.11545454545455,57.501999999999995,55.74,42.1,55.74,42.1,52.3,27.54,55.38,38.42,45.96164999999994,50.14280000000001,51.43999999999993,49.40549999999994,50.41018580603983,50.57378010829046,50.004615384615356,54.81855421893718,45.19067655029353,45.96164999999994,50.14280000000001,51.43999999999993,49.40549999999994,53.17666666666667,2772936,4060219.55,60.81204574360393,4.316931192230141,1.5,2.75,NaN,NaN,1.8268099769666075,0.6829522309945038,960.9961865319635,0.6860562871333757,0.6188591943956254,-0.06719709273775029,34.20952854319981,11.964919607433695,100,0,0,4984216816
1568295000,54.1,54.75,53.6791,54.1,47.19681818181818,57.553,55.74,42.1,55.74,42.1,52.3,27.54,55.38,38.42,46.03614999999994,50.1799,51.46119999999993,49.823999999999934,50.5548844018814,50.90961057416756,50.62923076923074,55.29723288865852,45.961228649802955,46.03614999999994,50.1799,51.46119999999993,49.823999999999934,54.17636666666667,3661253,3725402.85,62.064074628993076,5.5129973114371476,1.5,2.75,NaN,NaN,1.777037835754707,0.982780426014867,961.8169692136316,0.703650877603093,0.8123665042661159,0.10871562666302295,33.93895809086665,8.896940418679552,100,0,0,4987878069
1568381400,54.37,54.57,53.76,53.96,47.278181818181814,57.60399999999999,55.74,42.1,55.74,42.1,52.3,27.54,55.38,38.42,46.10094999999994,50.202000000000005,51.455799999999925,50.216999999999935,50.688418346905664,51.200123852818265,51.12846153846151,55.72583768748622,46.5310853894368,46.10094999999994,50.202000000000005,51.455799999999925,50.216999999999935,54.09666666666667,2551391,3491274.75,61.447427176973484,4.2665288868811055,1.5,2.75,NaN,NaN,1.707963704629371,0.7307906660740464,959.9504561631169,0.6678666717629745,0.9435489663667411,0.2756822946037666,30.92164158539153,8.70265914585012,78.78081761681277,3.8372309156023934,17.38195146758485,4985326678
1568640600,53.29,53.74,53.09,53.5,47.359545454545454,57.654999999999994,55.74,42.1,55.74,42.1,52.3,27.54,55.38,38.42,46.16144999999994,50.222200000000015,51.445999999999934,50.487999999999936,50.79867645094858,51.419159676359385,51.63615384615382,55.67767327452984,47.5946344177778,46.16144999999994,50.222200000000015,51.445999999999934,50.487999999999936,53.443333333333335,2274735,3399769.55,59.360493538379295,2.652941125600479,1.5,2.75,NaN,NaN,1.6481091542987014,0.6690850560738743,961.5622995846956,0.5785576820535783,0.9988793971707395,0.4203217151171612,32.05087315875176,9.676096760967607,56.2176320794554,14.87674612366172,28.90562179688286,4983051943
1568727000,53.34,53.93,53.26,53.85,47.44090909090909,57.705999999999996,55.74,42.1,55.74,42.1,52.3,27.54,55.38,38.42,46.209349999999944,50.24730000000002,51.458399999999926,50.68999999999994,50.9183361979702,51.65066827861087,52.09461538461536,55.6559514812088,48.533279288021916,46.209349999999944,50.24730000000002,51.458399999999926,50.68999999999994,53.68,2238115,3305073.25,60.46083462427156,2.568354406419857,1.5,2.75,NaN,NaN,1.578244214705937,0.677175611765942,962.8375125960388,0.5107557772837028,1.0587664367217897,0.5480106594380869,27.912248496664887,6.930103256552824,54.280912466656936,16.137063359872876,29.582024173470202,4985290058
1568813400,53.65,54.04,52.44,53.97,47.52227272727273,57.757,55.74,42.1,55.74,42.1,52.3,27.54,55.38,38.42,46.25934999999994,50.26680000000001,51.47019999999992,50.954499999999946,51.038009288245874,51.87155701398127,52.424615384615365,55.82104441780814,49.02818635142259,46.25934999999994,50.26680000000001,51.47019999999992,50.954499999999946,53.48333333333333,4231869,3317516.75,60.8522015610222,1.75538961340318,1.5,2.75,NaN,NaN,1.5797981993697987,1.27561345394865,961.5977396180153,0.444146206168049,1.1031934171481481,0.6590472109800991,24.330141843258247,3.1536697247706393,59.43460519940547,12.894782560817488,27.670612239777046,4989521927
1568899800,54.19,54.78,53.7617,53.95,47.60363636363636,54.78,55.74,42.1,55.74,42.1,52.3,27.54,55.38,38.42,46.30479999999994,50.28430000000001,51.466199999999915,51.157999999999944,51.15220500243231,52.06950396503067,52.75615384615383,55.826353423345346,49.68595426896231,46.30479999999994,50.28430000000001,51.466199999999915,51.157999999999944,54.16389999999999,3376703,3321329.95,60.74428316551596,2.643082919666921,1.5,2.75,NaN,NaN,1.539691185129099,1.0166719509454336,962.9168302138427,0.3718289784926293,1.1238334340958858,0.7520044556032565,14.159378621564272,2.879481311975601,26.40110066023095,40.796019259061595,32.80288008070745,4986145224
1568986200,54.28,54.44,52.74,53.06,47.685,54.751315789473686,55.74,42.1,55.74,42.1,52.3,27.54,55.38,38.42,46.33759999999994,50.29190000000001,51.43799999999992,51.32249999999995,51.22702049253301,52.163836920742035,53.085384615384605,55.12411144862924,51.04665778213997,46.33759999999994,50.29190000000001,51.43799999999992,51.32249999999995,53.413333333333334,4024582,3335282.35,55.98607032801547,1.1861484961217041,1.5,2.75,NaN,NaN,1.5511418147627347,1.2066690545704473,963.9727867696666,0.2433564498579126,1.0562000179256472,0.8128435680677346,18.135039859602205,1.1437285550895948,21.844149307487122,46.35122754221118,31.8046231503017,4982120642
1569245400,52.75,53.52,52.62,53.14,47.766363636363636,54.72263157894737,55.74,42.1,55.74,42.1,52.3,27.54,55.38,38.42,46.39279999999994,50.31180000000002,51.39759999999992,51.68049999999995,51.3020392967474,52.25680483305232,53.29923076923076,54.598827429464215,51.999634108997306,46.39279999999994,50.31180000000002,51.39759999999992,51.68049999999995,53.093333333333334,2272554,3053569.2,56.31730254045224,0.9182613236865533,1.5,2.75,NaN,NaN,1.5046316851368255,0.7442287536827394,965.7714791051279,0.1477700840606413,0.9975561731435363,0.849786089082895,18.128523276482817,1.1805026656511755,38.5198483254596,28.4147741554265,33.06537751911391,4984393196
1569331800,53.76,53.98,51.28,51.83,47.84772727272727,54.69394736842106,55.74,42.1,55.74,42.1,52.3,27.54,55.38,38.42,46.44264999999993,50.32210000000002,51.32959999999992,51.89849999999994,51.32274363805143,52.216156753714,53.26153846153845,54.694165873594756,51.828911049482144,46.44264999999993,50.32210000000002,51.32959999999992,51.89849999999994,52.363333333333316,6005724,3127501.9,49.719019143567294,1.6848887302656979,1.5,2.75,NaN,NaN,1.5900151361984807,1.920294277039448,962.7814672422467,-0.011236427355826528,0.8357405548881118,0.8469769822439384,23.56368241935804,-3.3383066020141725,13.654268499493282,58.1769118874797,28.16881961302702,4978387472
1569418200,51.9,53.03,51.05,52.78,47.92909090909091,54.665263157894735,55.74,42.1,55.74,42.1,52.3,27.54,55.38,38.42,46.51209999999994,50.32740000000002,51.29239999999992,52.19249999999994,51.37989094636313,52.26985611050315,53.28769230769229,54.670936072763894,51.904448542620685,46.51209999999994,50.32740000000002,51.29239999999992,52.19249999999994,52.28666666666667,3978470,3131223.55,53.934097893793606,0.7906151429622224,1.5,2.75,NaN,NaN,1.6178711978985894,1.2705799942006697,965.2772652375957,-0.05740454300099673,0.7752213034926925,0.8326258464936892,22.71830693066299,-2.439926062846581,12.616580978698067,59.9065578203729,27.476861200929036,4982365942
1569504600,52.76,52.88,51.6096,52.4,48.01045454545454,54.63657894736842,55.74,42.1,55.74,42.1,52.3,27.54,55.38,38.42,46.578699999999934,50.33500000000001,51.26819999999992,52.417999999999935,51.41989522297634,52.2822507666457,53.283076923076905,54.67769039840336,51.88846344775045,46.578699999999934,50.33500000000001,51.26819999999992,52.417999999999935,52.296533333333336,3771104,3183895.15,52.054333091772776,0.6946528629769363,1.5,2.75,NaN,NaN,1.5930518266201188,1.1844309634379764,963.4506197702522,-0.11517418562065529,0.6886581144678701,0.8038323000885254,21.865078024804152,-2.891030392883622,12.220196272143076,60.58526515789109,27.194538569965847,4978594838
1569591000,52.85,52.89,50.67,51.52,48.091818181818184,54.607894736842105,55.74,42.1,55.74,42.1,52.3,27.54,55.38,38.42,46.640849999999936,50.35960000000001,51.215199999999925,52.509999999999934,51.42382090050668,52.20965545553659,53.206153846153825,54.848882129534175,51.563425562773475,46.640849999999936,50.35960000000001,51.215199999999925,52.509999999999934,51.693333333333335,4960883,3261343.8,47.89155913285628,2.4360865744490185,1.5,2.75,NaN,NaN,1.6378338390043958,1.5211162343571385,962.1397244266257,-0.20883338710552468,0.5427905662066195,0.7516239533121442,23.2246274482351,-3.7009345794392465,11.227771742427961,62.33219008782773,26.440038169744312,4973633955
1569850200,51.84,52.67,51.82,52.31,48.17318181818182,54.57921052631579,55.74,42.1,55.74,42.1,52.3,27.54,55.38,38.42,46.703949999999935,50.39440000000001,51.19779999999992,52.643499999999925,51.45857302205544,52.21921207881882,53.1053846153846,54.794273469670216,51.416495761098986,46.703949999999935,50.39440000000001,51.19779999999992,52.643499999999925,52.26666666666667,3103649,3268975.8,51.6311237537145,0.3902350173233416,1.5,2.75,NaN,NaN,1.602988564789796,0.9494255050771561,964.2118194972369,-0.2130262265771108,0.4853411700907557,0.6983673966678665,25.62885722629847,-2.8597957288765072,13.43599906544808,58.53192269941407,28.03207823513785,4976737604
1569936600,52.77,53.16,50.2813,50.39,48.25454545454545,54.550526315789476,55.74,42.1,55.74,42.1,52.3,27.54,55.38,38.42,46.75784999999993,50.413800000000016,51.13399999999992,52.72399999999993,51.41666819766111,52.045001404645596,52.81999999999998,54.93917255259977,50.70082744740019,46.75784999999993,50.413800000000016,51.13399999999992,52.72399999999993,51.277100000000004,6249718,3441515.25,43.46665384289257,3.061716727616176,1.5,2.75,NaN,NaN,1.694110810161953,1.815978586757679,960.7566707164541,-0.33338382710152015,0.28163761279096633,0.6150214398924865,31.76820512341635,-6.633314804521027,13.343467507214712,58.68471062796141,27.971821864823884,4970487886
1570023000,49.48,49.5,47.01,47.78,48.33590909090909,54.52184210526316,55.74,42.1,55.74,42.1,52.3,27.54,55.38,38.42,46.80954999999992,50.40190000000001,50.994999999999926,52.594999999999935,51.27405375853714,51.63881079467935,52.34461538461536,55.66168188643814,49.02754888279258,46.80954999999992,50.40190000000001,50.994999999999926,52.594999999999935,48.096666666666664,8201031,3730111.4,35.29586164328357,7.909775036761362,1.5,2.75,NaN,NaN,1.8145314665789567,2.1986021650720673,955.9037618323227,-0.5635162439230548,-0.08937386501133204,0.47414237891172273,40.73313117747004,-11.436515291936983,1.6389984870533378,86.46160742402756,11.899394088919086,4962286855
1570109400,47.6,48.87,46.12,48.86,46.12,54.49315789473685,55.74,42.1,55.74,42.1,52.3,27.54,55.38,38.42,46.87749999999993,50.436900000000016,50.86219999999993,52.42199999999993,51.17938498369255,51.374162147567034,51.987692307692285,55.70505410044596,48.27033051493861,46.87749999999993,50.436900000000016,50.86219999999993,52.42199999999993,47.949999999999996,7220451,3923378.25,40.29703372034101,6.574281361475216,1.5,2.75,NaN,NaN,1.8813506475376027,1.8403657613180682,958.551278743391,-0.6136179203477587,-0.29288002152297565,0.32073789882478304,44.99688921968112,-7.915567282321905,15.373208595203199,55.44364754858517,29.183143856211633,4969507306
1570195800,49.27,50.96,49.214,50.82,46.14666666666666,54.46447368421053,55.74,42.1,55.74,42.1,52.3,27.54,55.38,38.42,46.95609999999992,50.48000000000001,50.78539999999994,52.34099999999993,51.16529145492029,51.3213848001797,51.75461538461536,55.35376584321926,48.15546492601147,46.95609999999992,50.48000000000001,50.78539999999994,52.34099999999993,50.33133333333333,5332804,4067258.65,48.13229950680693,1.538716451893909,1.5,2.75,NaN,NaN,1.896968458427774,1.3111543815881983,962.3760487991435,-0.4906953002773222,-0.2926312265218698,0.19806407375545246,52.71519609622933,-4.365826119683854,36.37974034143892,30.38577864452977,33.23448101403131,4974840110
1570455000,50.41,51.3,50.01,50.14,46.17333333333333,54.43578947368421,55.74,42.1,55.74,42.1,52.3,27.54,55.38,38.42,47.03994999999992,50.50810000000001,50.67339999999994,52.22499999999993,51.1250839468842,51.20887196206735,51.45999999999997,54.90945034640412,48.010549653595824,47.03994999999992,50.50810000000001,50.67339999999994,52.22499999999993,50.48333333333333,4406078,4173095.85,45.88250689007068,0.9791215658389661,1.5,2.75,NaN,NaN,1.8536135685400759,1.055829570749016,960.0007011566364,-0.43312844869731076,-0.343346487116186,0.08978196158112477,52.810510994239664,-3.2606598495080026,20.847743548792614,47.6476428560168,31.5046135951906,4970434032
1570541400,49.12,49.53,47.8299,47.88,46.199999999999996,54.407105263157895,55.74,42.1,55.74,42.1,52.3,27.54,55.38,38.42,47.11994999999992,50.500700000000016,50.52179999999994,51.99299999999994,50.997825752888744,50.89183653710855,50.99307692307689,54.60727443686042,47.37887940929336,47.11994999999992,50.500700000000016,50.52179999999994,51.99299999999994,48.41329999999999,6468719,4355138.45,39.30660116153416,4.425495082548622,1.5,2.75,NaN,NaN,1.8862197422157847,1.4853073155458467,956.2749545041099,-0.5193877976244554,-0.5594527854494444,-0.04006498782498906,56.8493422096425,-9.283819628647212,20.99669345861386,47.45149372059191,31.551812820794236,4963965313
1570627800,48.95,49.695,48.6,49.13,46.22666666666667,54.37842105263158,55.74,42.1,55.74,42.1,52.3,27.54,55.38,38.42,47.21604999999991,50.51470000000002,50.40239999999994,51.768499999999946,50.92457768414801,50.72404258119345,50.6907692307692,54.21927696972987,47.16226149180853,47.21604999999991,50.51470000000002,50.40239999999994,51.768499999999946,49.14166666666667,4783076,4455645.45,44.08034570708929,2.422638366572335,1.5,2.75,NaN,NaN,1.8811326177717997,1.0734866707134427,958.8609746123071,-0.4660889751932373,-0.6226762068165357,-0.1565872316232984,58.273336565818035,-6.240458015267168,49.44568857619784,19.50861714717911,31.04569427662305,4968748389
1570714200,49.12,50.65,49.03,50.21,46.25333333333333,54.349736842105266,55.74,42.1,55.74,42.1,52.3,27.54,55.38,38.42,47.32939999999991,50.54940000000002,50.34279999999994,51.573999999999955,50.8965550298677,50.67508614488931,50.465384615384586,53.70151350303952,47.22925572772965,47.32939999999991,50.54940000000002,50.34279999999994,51.573999999999955,49.96333333333334,5025468,4523856.2,47.89369362709128,0.6993826055278174,1.5,2.75,NaN,NaN,1.8624802879309568,1.1108814643577751,961.2535484249238,-0.3378984987840681,-0.5789603551033835,-0.24106185631931543,60.582363776086986,-2.5427018633540417,45.10473332668432,22.823360457739085,32.07190621557661,4973773857
1570800600,51.7,52.96,51.64,51.73,46.279999999999994,54.32105263157895,55.74,42.1,55.74,42.1,52.3,27.54,55.38,38.42,47.4303999999999,50.58680000000002,50.34099999999994,51.462499999999956,50.92923914634348,50.77555413109033,50.45769230769228,53.68126084005517,47.23412377532939,47.4303999999999,50.58680000000002,50.34099999999994,51.462499999999956,52.109999999999985,6788832,4735728.25,52.77482039886616,3.7612020742640384,1.5,2.75,NaN,NaN,1.9258745530787456,1.4335349584301,965.8493749688245,-0.14063743004370843,-0.416858643873951,-0.27622121383024256,62.897507318958645,-1.108774612884736,48.615945733523425,20.120730014182246,31.263324252294318,4980562689
1571059800,51.51,51.9,51.34,51.59,46.306666666666665,54.292368421052636,55.74,42.1,55.74,42.1,52.3,27.54,55.38,38.42,47.5273499999999,50.627000000000024,50.359399999999944,51.36699999999995,50.955151336682945,50.853120404319824,50.36615384615382,53.381606749619195,47.35070094268845,47.5273499999999,50.627000000000024,50.359399999999944,51.36699999999995,51.610000000000014,2678496,4755916.3,52.2889628472401,1.89211180896942,1.5,2.75,NaN,NaN,1.8283120850016918,0.563192417831239,964.3208009727292,-0.016041784117951874,-0.2962734439776824,-0.28023165985973053,62.1920098708777,2.381424885890063,55.364149979027786,15.421946317783508,29.213903703188706,4977884193
1571146200,52.11,53.49,52.06,53.09,46.33333333333333,54.26368421052632,55.74,42.1,55.74,42.1,52.3,27.54,55.38,38.42,47.632749999999895,50.69900000000003,50.49859999999994,51.32899999999995,51.03887089210714,51.066156556289364,50.419230769230744,53.59598733033528,47.24247420812621,47.632749999999895,50.69900000000003,50.49859999999994,51.32899999999995,52.88,3171779,4802599.5,56.87043620919969,4.156084322927382,1.5,2.75,NaN,NaN,1.833432650358714,0.6604296277463902,967.5765650919492,0.16117460403871214,-0.07876340481134037,-0.2399380088500525,59.706243032327734,11.11343658434492,86.65865568688226,1.5933296817270284,11.748014631390705,4981055972
1571232600,52.8,53.19,52.53,52.81,46.36,54.235,55.74,42.1,55.74,42.1,52.3,27.54,55.38,38.42,47.732299999999896,50.76650000000002,50.59479999999994,51.270999999999944,51.10832693555392,51.23223688426181,50.51846153846152,53.90051231507936,47.136410761843685,47.732299999999896,50.76650000000002,50.59479999999994,51.270999999999944,52.843333333333334,2992079,4740610,55.79342363022229,2.9753193043674395,1.5,2.75,NaN,NaN,1.7496160324759484,0.6311590702462342,968.7083741463118,0.24811988696883333,0.07021184986098916,-0.17790803710784417,47.71081684284658,8.0843225542366,65.66893831074464,9.43930150316362,24.891760186091734,4978063893
1571319000,53.45,53.7361,52.84,53.19,46.38666666666666,54.206315789473685,55.74,42.1,55.74,42.1,52.3,27.54,55.38,38.42,47.8335999999999,50.850400000000015,50.69679999999994,51.23299999999995,51.18996117337533,51.41869051433211,50.586153846153834,54.13980019418341,47.03250749812426,47.8335999999999,50.850400000000015,50.69679999999994,51.23299999999995,53.25536666666667,3372833,4740416.5,56.98404596269121,3.224746512614099,1.5,2.75,NaN,NaN,1.6907934587276663,0.7115056240311374,971.599679927928,0.3154813172911842,0.21644360950613617,-0.09903770778504808,47.06642127663142,4.663518299881932,62.73930468031553,10.998190333307734,26.262504986376744,4981436726
1571405400,52.93,53.27,51.98,52.5,46.41333333333333,54.17763157894737,55.74,42.1,55.74,42.1,52.3,27.54,55.38,38.42,47.9436499999999,50.93660000000002,50.72999999999993,51.20499999999995,51.24133524500767,51.521672370110004,50.748461538461534,54.441455705416004,47.05546737150706,47.9436499999999,50.93660000000002,50.72999999999993,51.20499999999995,52.583333333333336,2721441,4675259.45,54.13302995139198,2.0652402175146345,1.5,2.75,NaN,NaN,1.6621653545328334,0.58209411244546,971.0250594625378,0.2980328246919588,0.27350332307990044,-0.024529501612058385,44.01597295407031,4.706820901475866,26.295030707847985,40.91269344059618,32.79227585155584,4978715285
1571664600,53.32,53.68,53.03,53.64,46.44,54.148947368421055,55.74,42.1,55.74,42.1,52.3,27.54,55.38,38.42,48.0439999999999,51.03050000000002,50.808199999999935,51.22999999999995,51.33540052951717,51.723417858670956,51.199230769230766,54.7610752485244,47.63738628993713,48.0439999999999,51.03050000000002,50.808199999999935,51.22999999999995,53.45,2539074,4688585.45,57.88233759959086,2.9441465058524323,1.5,2.75,NaN,NaN,1.6277249720662024,0.5415437186923829,974.3842395573066,0.34444884195405656,0.40603155083051234,0.061582708876455755,43.72678592210584,12.030075187969919,49.95384179531633,19.132245067909373,30.913913136774305,4981254359
1571751000,53.93,54.04,52.98,53.03,46.46666666666666,54.12026315789474,55.74,42.1,55.74,42.1,52.3,27.54,55.38,38.42,48.1372499999999,51.13560000000001,50.909599999999934,51.28999999999995,51.40185541071258,51.84785425308325,51.51999999999999,54.92921827267911,48.11078172732087,48.1372499999999,51.13560000000001,50.909599999999934,51.28999999999995,53.35,3524166,4564507.55,55.278482542457496,2.5307121681690616,1.5,2.75,NaN,NaN,1.5871731883471882,0.7720802214468897,976.5408441562599,0.31599471214580177,0.456576099058708,0.1405813869129062,31.122488324523793,7.9381233462243,20.384576756603256,48.25354690997752,31.36187633341922,4977730193
1571837400,52.91,53.54,52.77,53.53,46.49333333333333,54.091578947368426,55.74,42.1,55.74,42.1,52.3,27.54,55.38,38.42,48.22834999999991,51.249900000000004,50.97599999999994,51.32749999999995,51.48531206127287,52.00805860993246,51.728461538461524,55.26982890718179,48.18709416974126,48.22834999999991,51.249900000000004,50.97599999999994,51.32749999999995,53.28,2922347,4511701.4,56.98653053992777,1.7994085227573091,1.5,2.75,NaN,NaN,1.5288036748938174,0.6477261549268308,979.2001809292302,0.3122224281018703,0.5308594220402441,0.21863699393837377,29.508199213807927,6.612228639713204,45.89149321680488,22.19475598550904,31.91375079768607,4980652540
1571923800,54.03,54.13,53.27,53.73,46.519999999999996,54.06289473684211,55.74,42.1,55.74,42.1,52.3,27.54,55.38,38.42,48.31784999999991,51.3389,51.13599999999994,51.39399999999995,51.57333903926217,52.172053028034135,52.00461538461537,55.56727312533574,48.441957643895,48.31784999999991,51.3389,51.13599999999994,51.39399999999995,53.71,3839458,4515119.1,57.68274920040685,2.217260985720112,1.5,2.75,NaN,NaN,1.4810319838299733,0.8503558632595096,977.591234168949,0.30426107896414123,0.5989633426435503,0.2947022636794091,28.358161524574367,3.8662284941040017,47.82776816643124,20.70476520371529,31.467466629853458,4984491998
1572010200,53.38,54.7,53.38,54.46,46.54666666666666,54.034210526315796,55.74,42.1,55.74,42.1,52.3,27.54,55.38,38.42,48.40899999999991,51.42360000000001,51.30319999999994,51.540999999999954,51.68654142987934,52.389952739649935,52.51076923076922,55.389694901527584,49.63184356001086,48.40899999999991,51.42360000000001,51.30319999999994,51.540999999999954,54.18000000000001,3881005,4461125.2,60.21407580631215,2.9435491818756248,1.5,2.75,NaN,NaN,1.4695296992706894,0.8699610134232503,979.4186054268727,0.3272213413373229,0.7037289403510627,0.3765075990137398,24.840325979489712,5.563093622795111,75.1586111547369,5.156180793524584,19.685208051738506,4988373003
1572269400,55.1,55.59,55.1,55.33,46.57333333333333,54.005526315789474,55.74,42.1,55.74,42.1,52.3,27.54,55.38,38.42,48.504449999999906,51.508,51.44819999999994,51.69199999999995,51.829422158119364,52.669957240635654,52.9876923076923,55.49909588517523,50.47628873020937,48.504449999999906,51.508,51.44819999999994,51.69199999999995,55.339999999999996,3545232,4483204.35,63.05079843162685,4.029540823004214,1.5,2.75,NaN,NaN,1.4452775778942117,0.7907808172964501,981.0574203296956,0.3765477251682301,0.8471922554740274,0.47064453030579734,24.975916109085105,4.219250329628922,77.76107866513827,4.205099397116026,18.033821937745696,4991918235
1572355800,55.15,55.78,55.0599,55.24,46.599999999999994,53.97684210526316,55.74,42.1,55.74,42.1,52.3,27.54,55.38,38.42,48.60274999999991,51.577799999999996,51.55679999999994,51.93449999999994,51.96317030878135,52.91472321771797,53.374615384615375,55.587119922771386,51.16211084645936,48.60274999999991,51.577799999999996,51.55679999999994,51.93449999999994,55.35996666666667,3363956,4338916.25,62.55392028730291,3.447752935160173,1.5,2.75,NaN,NaN,1.3934791794731967,0.7752986704917386,982.3437116864827,0.3776909268854014,0.9427581889125491,0.5650672620271477,21.123469993092453,4.601401249763302,77.87795587702261,4.163710428754231,17.958333694223146,4988554279
1572442200,55.38,55.95,54.5701,55.74,46.626666666666665,53.948157894736845,55.74,42.1,55.74,42.1,52.3,27.54,55.38,38.42,48.69739999999991,51.6461,51.69799999999994,52.332499999999946,52.111281277064435,53.18379719698292,53.68307692307691,56.00770605300624,51.35844779314758,48.69739999999991,51.6461,51.69799999999994,52.332499999999946,55.420033333333336,3092509,4083490.15,64.23996622191217,3.0048580543011894,1.5,2.75,NaN,NaN,1.3925092380822546,0.7573200586757874,983.5810368059754,0.38536550262500224,1.0467741403084005,0.6614086376833983,20.41395114376312,4.79413423575861,78.29396331492008,4.017898455722352,17.688138229357573,4991646788
1572528600,55.73,55.73,54.42,55.24,46.65333333333333,53.91947368421053,55.74,42.1,55.74,42.1,52.3,27.54,55.38,38.42,48.78849999999991,51.70969999999999,51.80519999999993,52.651499999999956,52.23397612894426,53.379626035365504,53.96384615384614,56.08196634309289,51.845725964599396,48.78849999999991,51.70969999999999,51.80519999999993,52.651499999999956,55.13,3960697,3920502.45,61.26905998478868,2.063522217328795,1.5,2.75,NaN,NaN,1.3873300067906649,1.0102523976231668,981.1981884890037,0.33203551337663484,1.0764530294041919,0.744417516027557,21.95053274906634,5.219047619047624,47.30122660670464,21.153020260995653,31.5457531322997,4987686091
1572615000,56.13,56.8,56.0196,56.8,46.67999999999999,53.890789473684215,55.74,42.1,55.74,42.1,52.3,27.54,55.38,38.42,48.8829499999999,51.791399999999996,51.945799999999934,52.950499999999955,52.413035888593505,53.70537593675927,54.24923076923075,56.77919229570576,51.719269242755736,48.8829499999999,51.791399999999996,51.945799999999934,52.950499999999955,56.53986666666666,3668727,3837298.6,66.47803617260229,3.9216782431400374,1.5,2.75,NaN,NaN,1.3996635777341884,0.9560702417059751,985.0971944124425,0.3739723021741923,1.2118828937452975,0.8379105915711051,22.992932342986695,5.891126025354207,47.12145696686957,21.290580564169403,31.587962468961017,4991354818
1572877800,57.77,57.83,57.25,57.45,46.70666666666666,53.8621052631579,55.74,42.1,55.74,42.1,52.3,27.54,55.38,38.42,48.9734499999999,51.87349999999999,52.17519999999993,53.31599999999995,52.61056389296239,54.06200679992505,54.60615384615384,57.50547512971754,51.70683256259014,48.9734499999999,51.87349999999999,52.17519999999993,53.31599999999995,57.51,2765356,3755262.5,68.38590507468948,4.667626799619452,1.5,2.75,NaN,NaN,1.3732590364674608,0.736394859214236,987.6642939430412,0.41449563346316487,1.3560301334000613,0.9415344999368964,21.49025945293242,8.334904770884409,45.982258600080776,22.27950027920456,31.73824112071466,4994120174
1572964200,57.65,57.78,57.1005,57.26,46.73333333333333,53.833421052631586,55.74,42.1,55.74,42.1,52.3,27.54,55.38,38.42,49.0706999999999,51.955999999999996,52.37099999999994,53.78499999999995,52.792894720689354,54.36657758088457,54.91923076923076,58.01179715718516,51.82666438127636,49.0706999999999,51.955999999999996,52.37099999999994,53.78499999999995,57.38016666666667,2370794,3550366.25,67.18225953709408,3.898398533835598,1.5,2.75,NaN,NaN,1.3237048195769283,0.6677604035921646,986.3682956210957,0.3974571799818334,1.438355974914188,1.0408987949323547,19.364487990745456,6.968055296095641,50.58609781449268,18.819008763910848,30.59489342159648,4991749380
1573050600,57.29,57.5,56.7455,57.33,46.76,53.80473684210527,55.74,42.1,55.74,42.1,52.3,27.54,55.38,38.42,49.16754999999991,52.038199999999996,52.579599999999935,54.194999999999936,52.970820417917224,54.64880828746699,55.29076923076922,58.29064062840727,52.290897833131176,49.16754999999991,52.038199999999996,52.579599999999935,54.194999999999936,57.19183333333332,2527574,3437591.15,67.40984658279405,3.115782108143127,1.5,2.75,NaN,NaN,1.2830473324642906,0.7352747577326059,984.727470312811,0.3609200061318618,1.492048802597182,1.1311287964653203,19.664225236164818,6.700167504187607,48.77463574846816,20.14380675000229,31.081557501529556,4994276954
1573137000,58.15,58.63,57.61,57.95,46.78666666666666,53.77605263157895,55.74,42.1,55.74,42.1,52.3,27.54,55.38,38.42,49.26699999999992,52.1123,52.780799999999935,54.58199999999994,53.16608236231263,54.963207498184424,55.622307692307686,58.768246748357356,52.476368636258016,49.26699999999992,52.1123,52.780799999999935,54.58199999999994,58.06333333333333,3925437,3382589.6,69.43186950138588,3.843710035300923,1.5,2.75,NaN,NaN,1.2842582372882703,1.1604827851418924,983.430414823953,0.3483538565349693,1.566571117134032,1.2182172605990627,19.668574611290612,6.40837311788469,83.4732904396336,2.4233978191983474,14.103311741168046,4998202391
1573223400,57.7,58.3159,57.25,58.29,46.81333333333333,53.747368421052634,55.74,42.1,55.74,42.1,52.3,27.54,55.38,38.42,49.36294999999992,52.1853,52.95299999999994,54.90999999999993,53.367020308888605,55.28004487930972,56.02692307692307,59.087002358102005,52.96684379574413,49.36294999999992,52.1853,52.95299999999994,54.90999999999993,57.951966666666664,1817634,3134029.7,70.51233754455272,3.166524093240607,1.5,2.75,NaN,NaN,1.268661220339108,0.5799670628520208,984.7744578340175,0.3328081040977102,1.6342273907212004,1.3014192866234902,19.311529161793178,5.34971986264233,80.95639621907856,3.1667186131725025,15.876885167748934,5000020025
1573482600,57.46,58.085,57.36,57.96,46.839999999999996,53.71868421052632,55.74,42.1,55.74,42.1,52.3,27.54,55.38,38.42,49.46204999999992,52.2408,53.11939999999994,55.22849999999994,53.547137159520425,55.535278700327844,56.36769230769231,59.21918750356254,53.51619711182208,49.46204999999992,52.2408,53.11939999999994,55.22849999999994,57.80166666666667,1833722,3091791,68.00003526863688,2.6496906314322026,1.5,2.75,NaN,NaN,1.2444711331720288,0.5930937763904481,983.0479673965203,0.2726933566082794,1.6422859823838394,1.36959262577556,19.567949654244664,4.923968139029687,57.211381565364576,14.24703505593208,28.541583378703336,4998186303
1573569000,58.2,58.8963,57.86,58.29,46.86666666666666,53.690000000000005,55.74,42.1,55.74,42.1,52.3,27.54,55.38,38.42,49.56379999999992,52.3021,53.30959999999994,55.488499999999945,53.7331317807157,55.79763310982043,56.71846153846153,59.29433595195355,54.142587124969516,49.56379999999992,52.3021,53.30959999999994,55.488499999999945,58.34876666666667,2836629,3075033.5,69.18250176069952,2.8214303930501115,1.5,2.75,NaN,NaN,1.2296017665168837,0.922470925926498,982.0200550590203,0.22929307566312795,1.65620897035447,1.426915894691342,19.1569733971074,4.574811625403655,84.08217520521286,2.2296548598715926,13.688169934915543,5001022932
1573655400,57.69,58.64,57.57,58.37,46.89333333333333,53.66131578947369,55.74,42.1,55.74,42.1,52.3,27.54,55.38,38.42,49.656949999999924,52.3662,53.469799999999935,55.76649999999994,53.9149697500994,56.042620432694676,57.01923076923076,59.37361079918425,54.66485073927727,49.656949999999924,52.3662,53.469799999999935,55.76649999999994,58.193333333333335,3572165,3104037.8,69.47696278592747,2.4679688375434217,1.5,2.75,NaN,NaN,1.2182016403371063,1.1508123386899478,980.5354400811041,0.1821671917225376,1.6546248843445142,1.4724576926219766,19.128025253576446,5.666183924692244,85.46139989789212,1.8769790452571307,12.661621056850759,5004595097
1573741800,58.23,58.69,57.81,58.64,46.919999999999995,53.632631578947375,55.74,42.1,55.74,42.1,52.3,27.54,55.38,38.42,49.74614999999992,52.4515,53.596199999999925,56.038999999999945,54.10026505401707,56.28998991529518,57.273846153846144,59.557278637044504,54.99041367064778,49.74614999999992,52.4515,53.596199999999925,56.038999999999945,58.379999999999995,2686041,3069698.2,70.50141130506533,2.203740851201017,1.5,2.75,NaN,NaN,1.194044380313027,0.8750179415031745,982.7636020775382,0.14688674895611165,1.6560661288171161,1.5091793798610045,17.06999622357453,3.239436619718316,83.92979549377374,2.2703139700353145,13.799890536190938,5007281138
1573828200,59.44,59.9,59.03,59.9,46.946666666666665,53.60394736842106,55.74,42.1,55.74,42.1,52.3,27.54,55.38,38.42,49.841499999999925,52.5505,53.745399999999925,56.40899999999995,54.32770564013405,56.63380039955278,57.63230769230768,59.988016357149206,55.27659902746615,49.841499999999925,52.5505,53.745399999999925,56.40899999999995,59.61000000000001,2335399,3050396.1,74.75897240140091,3.462022676697454,1.5,2.75,NaN,NaN,1.1987554960049533,0.7656051619001217,985.2273746803968,0.18372496090778867,1.7388355809957403,1.5551106200879516,14.156876564783866,4.264577893820706,84.71043969434785,2.065566355986852,13.223993949665278,5009616537
1574087400,59.71,60.16,59.43,59.95,46.97333333333333,53.57526315789474,55.74,42.1,55.74,42.1,52.3,27.54,55.38,38.42,49.93279999999992,52.6453,53.895199999999925,56.72449999999994,54.548187771893495,56.94962893292871,57.95615384615383,60.339616594878095,55.57269109742957,49.93279999999992,52.6453,53.895199999999925,56.72449999999994,59.84666666666667,2410188,3043951.8,74.91370446841752,3.4386640766820986,1.5,2.75,NaN,NaN,1.1652729605760277,0.791795717658867,983.2323809460707,0.1861965089544697,1.7878562562810387,1.601659747326569,13.793432642486101,4.697869367796026,100,0,0,5012026725
1574173800,60.38,60.38,59.525,59.9,46.99999999999999,53.546578947368424,55.74,42.1,55.74,42.1,52.3,27.54,55.38,38.42,50.021249999999924,52.73079999999999,54.04279999999992,57.06799999999995,54.758062761231,57.23061665360217,58.31461538461537,60.329446782556694,56.29978398667405,50.021249999999924,52.73079999999999,54.04279999999992,57.06799999999995,59.935,2687331,3002110.05,74.42238770941813,3.0857497717550904,1.5,2.75,NaN,NaN,1.143110606249169,0.8951473980775622,982.2768478601648,0.16019198933641077,1.8018997339970824,1.6417077446606716,13.363264212305898,4.482818768533054,77.46363544301987,4.31526704382431,18.221097513155808,5009339394
1574260200,59.58,59.87,58.271,59.27,47.026666666666664,53.51789473684211,55.74,42.1,55.74,42.1,52.3,27.54,55.38,38.42,50.10734999999993,52.79789999999999,54.15579999999993,57.35499999999995,54.93500147647685,57.42484363897339,58.50461538461537,60.37280439473046,56.63642637450028,50.10734999999993,52.79789999999999,54.15579999999993,57.35499999999995,59.137,4137608,3062873.1,68.34056059567789,1.3285160677119279,1.5,2.75,NaN,NaN,1.1778169915170853,1.3508910963369654,980.626790565514,0.08032306710656445,1.7421115785438772,1.6617885114373128,15.892418787914103,2.2778257118205354,37.848032998343314,29.085796829104765,33.06617017255191,5005201786
1574346600,59.29,59.4,58.4554,58.99,47.05333333333333,53.489210526315794,55.74,42.1,55.74,42.1,52.3,27.54,55.38,38.42,50.198199999999936,52.85739999999999,54.25359999999992,57.61799999999995,55.094021026418936,57.573906149547355,58.62307692307691,60.40191638252377,56.844237463630044,50.198199999999936,52.85739999999999,54.25359999999992,57.61799999999995,58.948466666666675,2751350,3008467.7,65.76810455636942,1.0647847761366196,1.5,2.75,NaN,NaN,1.1611586349801506,0.9145353297294831,978.5531464301813,-0.006967048454479485,1.6530797008692133,1.6600467493236928,15.728883131991926,1.2008920912678038,15.303465923951716,55.620556679202316,29.07597739684597,5002450436
1574433000,59.4,59.485,58.69,59.33,47.08,53.46052631578948,55.74,42.1,55.74,42.1,52.3,27.54,55.38,38.42,50.29014999999993,52.90839999999999,54.36099999999992,57.86149999999994,55.26013784891231,57.741153182923796,58.78230769230768,60.408632550501366,57.155982834114,50.29014999999993,52.90839999999999,54.36099999999992,57.86149999999994,59.16833333333332,2318076,2930321.25,67.37407598399648,1.213071110011155,1.5,2.75,NaN,NaN,1.1350044467672828,0.7910654847143466,980.8105015581824,-0.05474990124565293,1.5916093727666265,1.6463592740122794,15.719274708037155,2.3636991028295333,15.125355507537407,55.896696797686225,28.97794769477636,5004768512
1574692200,59.9,60.71,59.9,60.69,47.10666666666666,53.431842105263165,55.74,42.1,55.74,42.1,52.3,27.54,55.38,38.42,50.38844999999993,52.97539999999999,54.504799999999925,58.12949999999995,55.4730736195432,58.02199573693105,59.04076923076922,60.72852534764724,57.3530131138912,50.38844999999993,52.97539999999999,54.504799999999925,58.12949999999995,60.43333333333334,2177492,2861934.25,72.85907114387463,2.7578515600289495,1.5,2.75,NaN,NaN,1.1525041291410485,0.7608462703152596,984.3617901250883,-0.010046707821092182,1.6338008892359142,1.6438475970570063,18.891989482051496,4.117344312918165,13.409463181428478,58.569055066963664,28.021481751607862,5006946004
1574778600,60.76,61.24,60.55,61.09,47.133333333333326,53.40315789473685,55.74,42.1,55.74,42.1,52.3,27.54,55.38,38.42,50.480849999999926,53.053999999999995,54.64959999999993,58.42199999999995,55.693345242306215,58.314186619128094,59.28230769230768,61.16410967397973,57.400505710635635,50.480849999999926,53.053999999999995,54.64959999999993,58.42199999999995,60.96000000000001,1754501,2781461.5,74.23125547090032,2.9305361461695996,1.5,2.75,NaN,NaN,1.1194681199166883,0.6307838523021081,985.8439241647336,0.02903947356560166,1.6801469390140085,1.6511074654484068,18.9174069493995,4.659928045228724,31.043267709954932,35.67964691211397,33.2770853779311,5008700505
1574865000,61.49,61.9035,61.28,61.88,47.16,53.374473684210535,55.74,42.1,55.74,42.1,52.3,27.54,55.38,38.42,50.57534999999993,53.138999999999996,54.807799999999936,58.72899999999995,55.93595915437264,58.65378789349685,59.55846153846153,61.79664550221904,57.320277574704015,50.57534999999993,53.138999999999996,54.807799999999936,58.72899999999995,61.68783333333334,1762032,2714937.65,76.73319225620614,3.6420978714296512,1.5,2.75,NaN,NaN,1.0976132542083532,0.6490137996355091,988.4055456750089,0.0873787604659737,1.760330916030874,1.6729521555649003,19.3215605366528,5.525238744884042,69.4073419470553,7.611137031945745,22.981521020998954,5010462537
1575037800,61.56,61.71,61.08,61.22,47.18666666666666,53.34578947368421,55.74,42.1,55.74,42.1,52.3,27.54,55.38,38.42,50.66799999999992,53.209700000000005,54.95319999999993,59.02799999999995,56.143176442436456,58.898189046497144,59.80923076923076,62.004953345772726,57.61350819268879,50.66799999999992,53.209700000000005,54.95319999999993,59.02799999999995,61.336666666666666,1221646,2577985.1,70.56870775615396,2.5615304021380654,1.5,2.75,NaN,NaN,1.0763551646220426,0.4738762842345365,986.6332846640657,0.06199251268164385,1.750442796416955,1.6884502837353113,21.547972134106402,2.203672787979967,85.04403734890313,1.9802358991252997,12.975726751971546,5009240891
1575297000,61.38,61.41,59.38,59.61,47.21333333333333,53.3171052631579,55.74,42.1,55.74,42.1,52.3,27.54,55.38,38.42,50.74569999999992,53.2611,55.08419999999994,59.16849999999995,56.27913030743895,58.96598056587837,59.910769230769226,61.93116464581453,57.89037381572392,50.74569999999992,53.2611,55.08419999999994,59.16849999999995,60.133333333333326,4052133,2597155.4,58.27080299124024,0.5931585573667423,1.5,2.75,NaN,NaN,1.144472652863325,1.560219692668371,982.9392579541822,-0.07530856325524615,1.5943145796662535,1.6696231429214996,25.007965165116975,-0.5671392827356186,36.751038122335196,30.029360581649634,33.219601296015185,5005188758
1575383400,57.88,58.49,57.05,58.38,57.05,53.288421052631584,55.74,42.1,55.74,42.1,52.3,27.54,55.38,38.42,50.81609999999992,53.2933,55.18899999999994,59.214999999999954,56.36151735420605,58.910172892937574,59.911538461538456,61.92959306404509,57.89348385903182,50.81609999999992,53.2933,55.18899999999994,59.214999999999954,57.97333333333333,5068584,2712316.8,50.96372057977038,2.751719221452744,1.5,2.75,NaN,NaN,1.2455817490873733,1.8687286086934978,980.377401830955,-0.25113578034803186,1.3557034174864597,1.6068391978344916,27.54945659935853,-2.537562604340561,8.500380808018274,67.5397012504926,23.95991794148911,5000120174
1575469800,59.06,59.86,58.88,59.46,57.31023809523809,53.25973684210527,55.74,42.1,55.74,42.1,52.3,27.54,55.38,38.42,50.89059999999992,53.33560000000001,55.34159999999994,59.32499999999995,56.48302647757052,58.96253737932447,59.97461538461538,61.87774018968431,58.071490579546456,50.89059999999992,53.33560000000001,55.34159999999994,59.32499999999995,59.40000000000001,3095595,2748556.85,56.1618656251693,0.44889332291913114,1.5,2.75,NaN,NaN,1.2623259098668462,1.1262619508852436,983.1772519767951,-0.293902090419484,1.2394615848101367,1.5333636752296207,30.084567282718993,0.3205668972498696,13.50767072970423,58.40544999292026,28.08687927737552,5003215769
1575556200,59.95,59.95,58.99,59.86,57.570476190476185,53.231052631578955,61.88,42.1,55.74,42.1,52.3,27.54,55.38,38.42,50.96954999999993,53.3878,55.48319999999994,59.45149999999995,56.61545681178344,59.048010009865,59.97153846153846,61.875265108914334,58.06781181416258,50.96954999999993,53.3878,55.48319999999994,59.45149999999995,59.599999999999994,2650056,2754680.95,57.94022192809951,0.19495580266819162,1.5,2.75,NaN,NaN,1.2407312020192143,0.9620192131506191,984.6604916742142,-0.29375267022784723,1.1661728374448117,1.459925507672659,29.649406737949732,1.474826241735883,16.83144521827234,53.23566678483975,29.932887996887928,5005865825
1575642600,61,61.689,61,61.41,57.83071428571428,53.20236842105264,61.88,42.1,55.74,42.1,52.3,27.54,55.38,38.42,51.05204999999992,53.4658,55.66339999999994,59.624499999999955,56.803478113282125,59.27296143749691,60.083846153846146,62.1357351666122,58.03195714108009,51.05204999999992,53.4658,55.66339999999994,59.624499999999955,61.36633333333334,3136786,2715248.4,64.02954524195451,2.6509512943956626,1.5,2.75,NaN,NaN,1.2827504018749847,1.1552482638420853,988.3615878912217,-0.19265249943069396,1.2191098833842915,1.4117623828149855,32.46570632070732,3.505814933423223,33.352972396915135,33.314385302156545,33.33264230092831,5009002611
1575901800,61.18,61.62,60.8101,60.88,58.09095238095238,53.173684210526325,61.88,42.1,55.74,42.1,52.3,27.54,55.38,38.42,51.131049999999924,53.5329,55.85059999999994,59.75399999999996,56.96334171668283,59.42601272916387,60.15923076923077,62.25019979800425,58.06826174045728,51.131049999999924,53.5329,55.85059999999994,59.75399999999996,61.103366666666666,2407307,2744732.05,60.78873206102407,1.7987737502765684,1.5,2.75,NaN,NaN,1.2489753731696285,0.8770644843091333,988.8175712155651,-0.1658798386332827,1.2044125845233822,1.3702924231566649,33.22819827969171,0.31306640303180894,40.89646211470408,26.331305421618058,32.77223246367786,5006595304
1575988200,60.83,61.24,60.23,60.66,58.351190476190474,53.14500000000001,61.88,42.1,55.74,42.1,52.3,27.54,55.38,38.42,51.20949999999993,53.607699999999994,56.01759999999994,59.88899999999997,57.10830870818546,59.54353532638636,60.26615384615384,62.30583011702156,58.226477575286125,51.20949999999993,53.607699999999994,56.01759999999994,59.88899999999997,60.71,2707119,2788401.9,59.443765805459044,1.0865379515820985,1.5,2.75,NaN,NaN,1.2319057036575125,0.9708496468891376,989.6937428697954,-0.1669361387695194,1.1616222496947657,1.328558388464285,30.75193973798252,-0.7038795220167078,53.17826248131259,16.89084301578637,29.930894502901022,5003888185
1576074600,60.92,61.33,60.68,61.17,58.61142857142857,53.11631578947369,61.88,42.1,55.74,42.1,52.3,27.54,55.38,38.42,51.29099999999992,53.6836,56.23319999999994,60.03299999999997,57.26759071962917,59.69843672387338,60.43384615384615,62.38270836173193,58.484983945960366,51.29099999999992,53.6836,56.23319999999994,60.03299999999997,61.059999999999995,2427136,2767927.25,61.56666120687275,1.3243086438231517,1.5,2.75,NaN,NaN,1.1917695819676903,0.8768785379023238,992.3919596571895,-0.13841234366894728,1.155542958878101,1.2939553025470483,30.910546579593806,-1.1473820297349722,50.82797837904454,18.52618900426758,30.645832616687887,5006315321
1576161000,61.15,63.24,60.9987,62.74,58.87166666666666,53.087631578947374,61.88,42.1,55.74,42.1,52.3,27.54,55.38,38.42,51.38179999999992,53.7637,56.53239999999993,60.25149999999998,57.48219500513391,59.988109416837816,60.696153846153834,62.883467456133516,58.50884023617415,51.38179999999992,53.7637,56.53239999999993,60.25149999999998,62.32623333333334,6283911,2903514.55,67.24992074003379,3.088962282199264,1.5,2.75,NaN,NaN,1.2667360403985697,2.1642429861424324,995.7716837896104,-0.024881389032243018,1.2628535662567444,1.2877349552889874,33.50712780395043,2.482848742241103,63.3684217487045,10.666911496579383,25.964666754716127,5012599232
1576247400,62.51,63.61,62.0501,62.8,59.13190476190476,53.05894736842106,61.88,42.1,55.74,42.1,52.3,27.54,55.38,38.42,51.468549999999915,53.8367,56.811199999999936,60.45949999999997,57.6907363774816,60.25590851999612,60.858461538461526,63.316276029224795,58.40064704769826,51.468549999999915,53.8367,56.811199999999936,60.45949999999997,62.82003333333334,4768179,3007621.45,67.44802916441948,3.0221072671521925,1.5,2.75,NaN,NaN,1.2876763232272432,1.585365405609805,996.6845547187856,0.039670963450216146,1.3373236596017577,1.2976526961515416,32.62431479285622,5.351451098808921,67.28958162539818,8.63596783523348,24.074450539368346,5017367411
1576506600,63.94,64.5,63.93,64.11,59.39214285714286,53.030263157894744,61.88,42.1,55.74,42.1,52.3,27.54,55.38,38.42,51.56464999999992,53.9312,57.076999999999934,60.66999999999996,57.942472205815655,60.62296485142506,61.09076923076922,64.101012886008,58.08052557553044,51.56464999999992,53.9312,57.076999999999934,60.66999999999996,64.18,2639754,3022839.2,71.50142046463618,4.495964888830843,1.5,2.75,NaN,NaN,1.3171280144252975,0.8732697392570534,1000.0484497043171,0.14982219761253335,1.4849304431672081,1.3351082455546748,28.12567171716161,9.81500513874614,83.72817594308451,2.3272971108358433,13.944526946079662,5020007165
1576593000,64.34,64.55,64.11,64.13,59.65238095238095,53.00157894736843,61.88,42.1,55.74,42.1,52.3,27.54,55.38,38.42,51.661599999999915,54.015100000000004,57.356799999999936,60.87899999999996,58.1851203546072,60.956968198908385,61.26384615384614,64.6685807619293,57.859111545762964,51.661599999999915,54.015100000000004,57.356799999999936,60.87899999999996,64.26333333333334,1786410,2991650.3,71.55964682071361,3.89950140658681,1.5,2.75,NaN,NaN,1.2544760133949189,0.5971319575687039,1002.8052594547352,0.200113356284513,1.585249940910316,1.385136584625803,22.441983211827043,7.854019508913546,100.00000000000001,0,0,5021793575
1576679400,64.39,64.54,64.1295,64.13,59.912619047619046,52.972894736842115,61.88,42.1,55.74,42.1,52.3,27.54,55.38,38.42,51.762849999999915,54.101800000000004,57.68179999999994,61.09049999999995,58.41825288972064,61.259161703774254,61.48769230769229,65.21848850109208,57.7568961142925,51.762849999999915,54.101800000000004,57.68179999999994,61.09049999999995,64.2665,1707118,2942639.65,71.55964682071361,3.492369881324464,1.5,2.75,NaN,NaN,1.19419201243814,0.5801315155934911,1005.5692303090897,0.20851658158763509,1.645782311610347,1.4372657300227119,22.23596693628398,7.1333110591379825,100.00000000000001,0,0,5021793575
1576765800,64.24,64.96,64.22,64.94,60.17285714285714,52.9442105263158,61.88,42.1,55.74,42.1,52.3,27.54,55.38,38.42,51.87344999999992,54.200199999999995,57.99799999999994,61.37399999999995,58.67400767835905,61.60971773198623,61.89769230769229,65.87623594418235,57.91914867120222,51.87344999999992,54.200199999999995,57.99799999999994,61.37399999999995,64.70666666666666,2185702,2845044.35,74.04998538965334,3.5443644966186993,1.5,2.75,NaN,NaN,1.1681782972639871,0.7682488323951786,1008.1043995999523,0.24144180702752793,1.7390679888071219,1.497626181779594,22.40566479084539,5.748249470770235,100.00000000000001,0,0,5023979277
1576852200,65.59,66.165,65.55,65.89,60.433095238095234,52.91552631578948,61.88,42.1,55.74,42.1,52.3,27.54,55.38,38.42,51.99024999999992,54.327200000000005,58.311599999999935,61.71899999999996,58.95698776940379,62.017363662273254,62.47538461538459,66.42388084625617,58.52688838451301,51.99024999999992,54.327200000000005,58.311599999999935,61.71899999999996,65.86833333333334,2964490,2855701.35,76.63419333893322,4.505543267996156,1.5,2.75,NaN,NaN,1.1722369903165604,1.0380952476000336,1010.5605365455749,0.2963951305767414,1.8681200950005206,1.5717249644237792,20.04157019419323,8.229303547963202,100.00000000000001,0,0,5026943767
1577111400,65.99,66.03,65.68,65.76,60.69333333333333,52.88684210526316,61.88,42.1,55.74,42.1,52.3,27.54,55.38,38.42,52.09704999999992,54.46660000000001,58.59219999999994,62.040499999999966,59.2237725627605,62.37380521824723,62.95999999999997,66.85526734542155,59.06473265457839,52.09704999999992,54.46660000000001,58.59219999999994,62.040499999999966,65.82333333333334,1919729,2835784,75.52581079339934,3.7385331408214575,1.5,2.75,NaN,NaN,1.1135057767225198,0.6769658761033985,1012.1701666555409,0.29267587385896876,1.93756980674749,1.6448939328885213,18.428932171915022,8.407517309594475,75.06980700710928,5.2245966317615915,19.705596361129135,5025024038
1577197800,65.91,65.9272,65.5501,65.78,60.95357142857142,52.85815789473685,61.88,42.1,55.74,42.1,52.3,27.54,55.38,38.42,52.201599999999914,54.617700000000006,58.87599999999994,62.29499999999996,59.48087952108362,62.6982047212713,63.41538461538459,67.13473621631734,59.69603301445185,52.201599999999914,54.617700000000006,58.87599999999994,62.29499999999996,65.75243333333334,941862,2774002.5,75.58431771923375,3.072467801308129,1.5,2.75,NaN,NaN,1.0609053640994826,0.3395317776389892,1014.0638238314838,0.26128233214341234,1.9714968480677868,1.7102145159243745,17.66987159788729,7.536374039561876,72.13791940455766,6.430860424759595,21.431220170682757,5025965900
1577370600,66.02,66.82,66,66.78,61.21380952380952,52.829473684210534,61.88,42.1,55.74,42.1,52.3,27.54,55.38,38.42,52.30669999999992,54.8242,59.14979999999994,62.57949999999996,59.76711953986466,63.086947128769275,63.82846153846151,67.75235165025968,59.90457142666334,52.30669999999992,54.8242,59.14979999999994,62.57949999999996,66.53333333333333,2144744,2793514.65,78.36874210701707,3.5436506335378732,1.5,2.75,NaN,NaN,1.0594121238066618,0.7677582789837885,1016.5191947105662,0.2761345813177196,2.055382742571524,1.7792481612538045,18.120666791862515,6.439273190946762,78.93087091223025,3.81124641924908,17.257882668520686,5028110644
1577457000,67.3,67.31,66.371,66.74,61.47404761904762,52.80078947368422,61.88,42.1,55.74,42.1,52.3,27.54,55.38,38.42,52.41214999999992,55.0116,59.42839999999994,62.822499999999955,60.040565832418984,63.43485692602934,64.27923076923074,68.08942326619271,60.46903827226876,52.41214999999992,55.0116,59.42839999999994,62.822499999999955,66.807,2231724,2816999.25,77.98563004652107,3.4050471677853404,1.5,2.75,NaN,NaN,1.0508112578204722,0.792234502724841,1015.1195460427061,0.25219447991057065,2.094491261142018,1.8422967812314472,15.35186655144414,6.273885350318468,48.393186767392024,20.367905245139298,31.238907987468675,5025878920
1577716200,66.76,66.84,65.26,65.57,61.73428571428571,52.772105263157904,61.88,42.1,55.74,42.1,52.3,27.54,55.38,38.42,52.50834999999992,55.18639999999999,59.67599999999994,63.03999999999995,60.257406388010395,63.63820388545512,64.65692307692305,67.88634917135658,61.42749698248951,52.50834999999992,55.18639999999999,59.67599999999994,63.03999999999995,65.89,3652045,2938519.2,67.57910077014809,1.8416895528616375,1.5,2.75,NaN,NaN,1.0886104536904384,1.2428181514008825,1013.0992996842544,0.13250630201920854,2.007929658755458,1.8754233567362495,20.516900027956755,2.277335829043821,10.76647196213475,63.19625697509372,26.03727106277154,5022226875
1577802600,65.22,66.22,64.9911,66.08,61.994523809523805,52.74342105263159,61.88,42.1,55.74,42.1,52.3,27.54,55.38,38.42,52.604849999999914,55.33879999999999,59.94759999999994,63.36349999999995,60.48574339240214,63.87075589636416,65.03461538461536,67.63088033950274,62.43835042972799,52.604849999999914,55.33879999999999,59.94759999999994,63.36349999999995,65.76369999999999,2687573,2870291.2,69.49026810593392,1.3341998959849861,1.5,2.75,NaN,NaN,1.0986311355696925,0.9363415809517863,1016.0622285339606,0.06599100334453811,1.9579121109169222,1.891921107572384,17.940119019094638,3.0406985810073337,34.02537995072821,32.68601691188712,33.28860313738466,5024914448
1577975400,67.1,67.91,66.46,67.91,62.2547619047619,52.714736842105275,61.88,42.1,55.74,42.1,52.3,27.54,55.38,38.42,52.71009999999991,55.520599999999995,60.23299999999994,63.839999999999954,60.77689071034715,64.25544581099615,65.43230769230766,68.08406651468782,62.7805488699275,52.71009999999991,55.520599999999995,60.23299999999994,63.839999999999954,67.42666666666666,3676799,2800701.95,75.15074081407326,3.1100621440705045,1.5,2.75,NaN,NaN,1.150871768743286,1.312813382373658,1019.4119059785888,0.12037918649496837,2.0423950906910946,1.9220159041961262,22.536663305380813,5.894277249337286,47.87345329268574,20.702099238321775,31.42444746899249,5028591247
1578061800,65.57,67.12,65.51,66.28,62.515,52.68605263157895,61.88,42.1,55.74,42.1,52.3,27.54,55.38,38.42,52.809549999999916,55.703799999999994,60.49799999999994,64.18099999999995,60.99269891778452,64.44826049566318,65.69999999999997,67.89869891596753,63.50130108403241,52.809549999999916,55.703799999999994,60.49799999999994,64.18099999999995,66.30333333333333,4674758,2879660.1,63.79707127107126,1.7590923717380125,1.5,2.75,NaN,NaN,1.2400952138330505,1.6233714527627756,1018.094472039483,0.026612726005393217,1.9552818117028679,1.9286690856974746,28.34381160384546,2.0634431783184533,19.735313047397245,49.170054158911846,31.094632793690906,5023916489
1578321000,65.11,67.11,65.0661,67.05,62.775238095238095,52.65736842105264,61.88,42.1,55.74,42.1,52.3,27.54,55.38,38.42,52.905199999999915,55.87219999999999,60.768399999999936,64.54049999999995,61.23024013669493,64.69604521036192,65.92615384615382,68.02676970400326,63.82553798830439,52.905199999999915,55.87219999999999,60.768399999999936,64.54049999999995,66.40870000000001,2954504,2894882.5,66.38097264135293,1.5680582101583365,1.5,2.75,NaN,NaN,1.2975098414164035,1.0205954818546177,1019.4373341651402,-0.001997064708106233,1.9261727548123417,1.928169819520448,28.23009466051427,1.7605099408104365,38.93053886375731,28.06947638036602,32.99998475587666,5026870993
1578407400,66.75,67.0153,66.21,66.54,63.03547619047619,52.62868421052632,61.88,42.1,55.74,42.1,52.3,27.54,55.38,38.42,53.011999999999915,56.080299999999994,61.024599999999936,64.79699999999994,61.43846601368729,64.8716599522322,66.11153846153843,67.95501087319649,64.26806604988037,53.011999999999915,56.080299999999994,61.024599999999936,64.79699999999994,66.58843333333334,3150493,2895567.85,63.16527820314602,1.3171168083011058,1.5,2.75,NaN,NaN,1.264830567029518,1.0880397777589637,1016.6976217538851,-0.0699502025679517,1.8407320663105082,1.91068226887846,27.83941543122183,1.1861313868613155,40.8753952695121,26.357667633440848,32.766937097047055,5023720500
1578493800,66.67,68.38,66.49,67.56,63.29571428571428,52.60000000000001,61.88,42.1,55.74,42.1,52.3,27.54,55.38,38.42,53.12469999999991,56.2949,61.286599999999936,65.13099999999994,61.67852617001328,65.1276923377339,66.37538461538458,67.97455007821661,64.77621915255254,53.12469999999991,56.2949,61.286599999999936,65.13099999999994,67.47666666666667,3888194,2969612.2,66.64545177443745,2.7632953450137507,1.5,2.75,NaN,NaN,1.3094855265274095,1.309327190937591,1019.4188463479124,-0.061200316135841204,1.8341818737086584,1.8953821898444996,28.896048557991886,2.7059896625114033,45.346495429433276,22.65605403867451,31.997450531892223,5027608694
1578580200,68.65,68.98,68.235,68.93,63.55595238095238,52.571315789473694,61.88,42.1,55.74,42.1,52.3,27.54,55.38,38.42,53.23919999999991,56.5034,61.558599999999934,65.54449999999994,61.962897692757856,65.48981687699734,66.68230769230765,68.56767080928014,64.79694457533515,53.23919999999991,56.5034,61.558599999999934,65.54449999999994,68.715,2939056,2981209.05,70.65570883845939,3.2968439409842327,1.5,2.75,NaN,NaN,1.3173794174897375,0.9858604179401643,1021.4235577796472,0.017642526668894654,1.917435348180618,1.8997928215117232,30.47634003797664,3.219526804432473,42.94032924974065,24.608668292594665,32.45100245766471,5030547750
1578666600,69.37,69.41,68,68.28,63.81619047619047,52.54263157894738,61.88,42.1,55.74,42.1,52.3,27.54,55.38,38.42,53.35389999999991,56.68809999999999,61.819399999999945,65.89999999999993,62.210627195002644,65.75554860299759,66.86615384615381,68.86906769984932,64.86323999245829,53.35389999999991,56.68809999999999,61.819399999999945,65.89999999999993,68.56333333333333,3886974,3054200.95,66.56640193517975,2.693114472845035,1.5,2.75,NaN,NaN,1.3239951733833275,1.2726647865131466,1020.1299313313419,0.007333312701656158,1.9089594623887933,1.9016261496871372,30.664864726448265,2.307461792028778,46.07652415205295,22.08126533042813,31.84221051751891,5026660776
1578925800,68.74,69.76,68.45,69.76,64.07642857142856,52.513947368421064,61.88,42.1,55.74,42.1,52.3,27.54,55.38,38.42,53.47334999999991,56.8989,62.09979999999995,66.25099999999993,62.506681030492736,66.13692492652163,67.17384615384611,69.58904849875718,64.75864380893505,53.47334999999991,56.8989,62.09979999999995,66.25099999999993,69.32333333333334,2886434,2884327.1,70.72152542969077,3.2969244010180074,1.5,2.75,NaN,NaN,1.3351383752845187,1.0007304650016984,1023.7497998753449,0.07760065257201232,1.9986269654021527,1.9210263128301404,32.4740669726724,6.390117431752345,46.20679225253084,21.977447412917268,31.815760334551893,5029547210
1579012200,69.42,70.1388,69.0103,69.38,64.33666666666666,52.48526315789475,61.88,42.1,55.74,42.1,52.3,27.54,55.38,38.42,53.58644999999991,57.09389999999999,62.382599999999954,66.57999999999994,62.77622295086557,66.44578921923386,67.45076923076918,69.98577293628566,64.91576552525271,53.58644999999991,57.09389999999999,62.382599999999954,66.57999999999994,69.5097,3779429,2834889.6,68.37197114178913,2.9319220452317922,1.5,2.75,NaN,NaN,1.3203784913356247,1.3331838389755988,1026.044220895143,0.07581056300819822,2.015789516590388,1.9399789535821899,30.105409407139213,4.993946731234862,42.52555421631893,24.952215572647727,32.52223021103336,5025767781
1579098600,69.33,70.3835,69.26,69.87,64.59690476190475,52.45657894736843,61.88,42.1,55.74,42.1,52.3,27.54,55.38,38.42,53.6939999999999,57.29489999999999,62.64399999999995,66.86799999999995,63.05441028612574,66.77190453168778,67.6884615384615,70.49250089025215,64.88442218667085,53.6939999999999,57.29489999999999,62.64399999999995,66.86799999999995,69.83783333333334,3346910,2870247.4,69.76678226799156,2.8914184348942453,1.5,2.75,NaN,NaN,1.3063157419545082,1.1660702140170913,1027.7542997669789,0.08429869202570428,2.04535231861432,1.9610536265886158,30.090078173809072,2.8861728758651273,40.977460151197945,26.267289632689323,32.75525021611272,5029114691
1579185000,70.8,71.54,70.645,71.51,64.85714285714285,52.42789473684211,61.88,42.1,55.74,42.1,52.3,27.54,55.38,38.42,53.80949999999991,57.5502,62.92519999999996,67.23699999999994,63.386002039611,67.22315171914609,68.05538461538457,71.45257454358759,64.65819468718155,53.80949999999991,57.5502,62.92519999999996,67.23699999999994,71.23166666666667,3158137,2938833.75,73.91339346267061,4.036612467672916,1.5,2.75,NaN,NaN,1.3322931889577576,1.074622543721638,1030.9087273256876,0.17198222719804868,2.1760314105861767,2.004049183388128,29.080108330627038,7.890766445383229,42.23052051289293,25.19984323049045,32.56963625661663,5032272828
1579271400,72.08,72.34,71.61,72.25,65.11738095238096,52.3992105263158,61.88,42.1,55.74,42.1,52.3,27.54,55.38,38.42,53.92749999999991,57.797999999999995,63.22499999999995,67.64299999999994,63.73360980276351,67.70189917446551,68.56923076923073,72.31060412085083,64.82785741761063,53.92749999999991,57.797999999999995,63.22499999999995,67.64299999999994,72.06666666666666,3368948,3021925.25,75.54335859737097,4.3788741711248695,1.5,2.75,NaN,NaN,1.2964151040322034,1.1148349880593507,1031.753881580416,0.2468795131542647,2.312648574830959,2.0657690616766944,22.24397038827488,7.755406413124538,73.590649418838,5.79381877086177,20.615531810300244,5035641776
1579617000,71.49,72.31,71.45,71.73,65.37761904761905,52.37052631578948,61.88,42.1,55.74,42.1,52.3,27.54,55.38,38.42,54.04109999999991,58.046299999999995,63.512999999999955,67.98249999999993,64.0471937320669,68.08552782451642,69.00384615384611,72.79986462232301,65.20782768536921,54.04109999999991,58.046299999999995,63.512999999999955,67.98249999999993,71.83,3736309,3099455.6,72.13261771021872,3.5176394678110916,1.5,2.75,NaN,NaN,1.2652425966013319,1.2054726642962719,1029.1058814365517,0.22886344156156246,2.3518483636286476,2.122984922067085,23.884599118870053,7.799819657348959,46.64619957743531,21.870482996564576,31.483317426000106,5031905467
1579703400,72.38,72.82,71.69,71.84,65.63785714285714,52.34184210526317,61.88,42.1,55.74,42.1,52.3,27.54,55.38,38.42,54.15199999999991,58.28579999999999,63.79079999999996,68.27999999999993,64.3527939778682,68.44309660313391,69.3061538461538,73.32499055852594,65.28731713378167,54.15199999999991,58.28579999999999,63.79079999999996,68.27999999999993,72.11666666666666,2433089,3072885.55,72.41633023448038,3.4075491982644035,1.5,2.75,NaN,NaN,1.255582411129808,0.7917929126908095,1029.0010529528795,0.19323901185860404,2.36453368689034,2.171294675031736,22.401573124113483,6.335109532267616,74.07060380151746,5.691263199245155,20.238132999237386,5034338556
1579789800,71.3,72.12,70.5,72.03,65.89809523809524,52.313157894736854,61.88,42.1,55.74,42.1,52.3,27.54,55.38,38.42,54.263099999999916,58.50929999999998,64.06559999999996,68.59349999999992,64.6538608806969,68.7847064504545,69.7484615384615,73.59990958705386,65.89701348986914,54.263099999999916,58.50929999999998,64.06559999999996,68.59349999999992,71.55,3439735,3148885.85,72.92899365664024,2.556395272626432,1.5,2.75,NaN,NaN,1.2816122389062505,1.0923657331052505,1029.589658672282,0.15311047820345802,2.3626827727860586,2.2095722945826006,22.010654329550025,4.497316117800659,74.43684577799502,5.542307220563223,20.020847001441766,5037778291
1579876200,72.5,72.5,69.16,70.05,66.15833333333333,52.28447368421054,61.88,42.1,55.74,42.1,52.3,27.54,55.38,38.42,54.368299999999905,58.713399999999986,64.30739999999997,68.80699999999993,64.86547417949309,68.90521059803025,69.97923076923072,73.50174264867533,66.45671888978612,54.368299999999905,58.713399999999986,64.30739999999997,68.80699999999993,70.57,6223394,3412962.45,60.34261754847211,0.8776038606711632,1.5,2.75,NaN,NaN,1.4286399361272328,1.8234580928366204,1025.6184787128404,-0.026570836741655945,2.176358748655531,2.202929585397187,27.591264467229387,2.592267135325126,34.87700621961028,32.12767060013795,32.995323180251795,5031554897
1580135400,66.39,67.71,66.15,66.7,66.41857142857143,52.25578947368422,72.25,42.1,55.74,42.1,52.3,27.54,55.38,38.42,54.45424999999991,58.89259999999999,64.47559999999997,68.80299999999993,64.93741636853258,68.695190541075,69.99153846153843,73.46669730597746,66.51637961709939,54.45424999999991,58.89259999999999,64.47559999999997,68.80299999999993,66.85333333333334,5682760,3589863.25,45.90678935761748,4.026655466824177,1.5,2.75,NaN,NaN,1.605165654975287,1.5830018037595164,1020.834245348038,-0.3716715790925158,1.7383401115315422,2.110011690624058,39.931288392106886,-4.38646788990826,9.510345983323967,65.54431807362458,24.945335943051454,5025872137
1580221800,67.63,69.3515,67.3211,68.74,66.67880952380952,52.2271052631579,72.25,42.1,55.74,42.1,52.3,27.54,55.38,38.42,54.55059999999991,59.076399999999985,64.68299999999996,68.90299999999993,65.08653729525679,68.69945810859166,70.08230769230765,73.3543915152527,66.8102238693626,54.55059999999991,59.076399999999985,64.68299999999996,68.90299999999993,68.47086666666667,3635669,3660060.5,53.24245172485517,1.3879646933712293,1.5,2.75,NaN,NaN,1.6799038224770524,0.9933357658978588,1024.3682417309992,-0.4575389399810734,1.5380880156477161,1.9956269556287896,42.07167380995937,-0.9224560392043826,26.445677243382193,40.753567878021,32.800754878596805,5029507806
1580308200,69.72,69.85,68.46,68.62,66.93904761904761,52.19842105263159,72.25,42.1,55.74,42.1,52.3,27.54,55.38,38.42,54.641449999999914,59.23939999999999,64.88259999999997,69.05549999999992,65.22510446014869,68.69189066967816,70.0584615384615,73.3680917400106,66.7488313369124,54.641449999999914,59.23939999999999,64.88259999999997,69.05549999999992,68.97666666666667,3486374,3651776.95,52.78895370911236,0.4857090633038197,1.5,2.75,NaN,NaN,1.6591964065858344,0.9547061739354042,1025.1251543195235,-0.5132258606586984,1.3540946298054166,1.867320490464115,41.99691665427548,-1.78903678259625,12.697234968043434,59.77669543573195,27.52606959622461,5026021432
1580394600,67.17,69.39,66.64,69.26,67.19928571428571,52.16973684210527,72.25,42.1,55.74,42.1,52.3,27.54,55.38,38.42,54.73599999999991,59.407599999999995,65.06979999999997,69.21449999999993,65.38333565778991,68.745996320185,70.13384615384612,73.32036138053826,66.94733092715398,54.73599999999991,59.407599999999995,65.06979999999997,69.21449999999993,68.43,4689593,3751877.95,54.990872757332994,1.4813785318514399,1.5,2.75,NaN,NaN,1.7371109489725605,1.249932183961368,1026.2018585664725,-0.49740589565140425,1.2455631208998597,1.742969016551264,42.17512638254105,-3.1464130890784503,15.60642950798554,55.09579330339066,29.297777188623787,5030711025
1580481000,68.81,68.9147,64.86,65.5,64.86,52.14105263157896,72.25,42.1,55.74,42.1,52.3,27.54,55.38,38.42,54.81134999999991,59.53799999999999,65.18079999999998,69.09399999999992,65.38791073003344,68.43685381350072,69.80615384615382,73.8420278890274,65.77027980328023,54.81134999999991,59.53799999999999,65.18079999999998,69.09399999999992,66.4249,8799324,4008004.2,42.4611373449612,4.729403344265762,1.5,2.75,NaN,NaN,1.9273173097602352,2.195437819151986,1021.3520001396148,-0.71726014086899,0.8463938404650264,1.5636539813340165,49.406189197917925,-9.342560553633218,13.053741756358287,59.17682518884734,27.76943305479438,5021911701
1580740200,66.42,68.15,66.38,66.89,65.05525,52.11236842105264,72.25,42.1,55.74,42.1,52.3,27.54,55.38,38.42,54.895649999999904,59.68169999999999,65.32059999999997,69.12449999999993,65.44681619160076,68.28953440269113,69.61461538461535,73.93922556987343,65.29000519935727,54.895649999999904,59.68169999999999,65.32059999999997,69.12449999999993,67.14,4547856,4001659.1,47.24649342556532,2.0677718824667726,1.5,2.75,NaN,NaN,1.9789375019202189,1.1364926112771574,1024.4411024673936,-0.7430095428523169,0.6348920527686204,1.3779015956209373,51.26067505885617,-6.747525442632097,35.07933577242739,31.63480232848318,33.28586189908944,5026459557
1580826600,69.35,70.55,69.125,70.01,65.2505,52.08368421052633,72.25,42.1,55.74,42.1,52.3,27.54,55.38,38.42,54.99419999999991,59.8456,65.53539999999997,69.27249999999994,65.62576457624387,68.4533882691015,69.62538461538458,73.95318110842894,65.29758812234022,54.99419999999991,59.8456,65.53539999999997,69.27249999999994,69.895,4015427,4054705.25,56.07672643283581,2.2059042606263923,1.5,2.75,NaN,NaN,2.099013394640203,0.9903129210193515,1025.7373257526322,-0.5336499358832016,0.7108391757669352,1.2444891116501369,59.687293987406974,-2.5473273942093515,36.26643199735411,30.501142859073077,33.23242514357282,5030474984
1580913000,72.02,72.52,71,72.35,65.44575,52.05500000000001,72.25,42.1,55.74,42.1,52.3,27.54,55.38,38.42,55.103999999999914,60.028099999999995,65.80259999999997,69.56299999999993,65.88946008305783,68.82449414823469,69.68999999999997,74.15143819515977,65.22856180484017,55.103999999999914,60.028099999999995,65.80259999999997,69.56299999999993,71.95666666666666,4014219,4097891.55,61.30779335502881,4.041729374142352,1.5,2.75,NaN,NaN,2.128369580737331,0.979581560668681,1029.9870599753638,-0.23646501509636897,0.9489078427796755,1.1853728578760445,63.0549530539103,0.4442593363876068,57.72756200873294,13.933832842722293,28.33860514854477,5034489203
1580999400,73.04,73.23,72.33,73.13,65.641,52.02631578947369,72.25,42.1,55.74,42.1,52.3,27.54,55.38,38.42,55.21089999999991,60.21979999999999,66.07859999999998,69.84149999999993,66.1734028248987,69.23454232459329,69.75769230769228,74.39565707251784,65.11972754286673,55.21089999999991,60.21979999999999,66.07859999999998,69.84149999999993,72.89666666666666,3119178,4059440.75,62.89415195100811,4.395983032954103,1.5,2.75,NaN,NaN,2.0406288963989505,0.7683762843440934,1029.29395669528,0.001171582355688816,1.1868373358206554,1.1856657534649666,63.315034171690584,4.396859386152745,54.96268378180585,15.692492881238218,29.344823336955912,5037608381
1581085800,72.31,72.85,71.55,71.91,65.83625,51.99763157894738,72.25,42.1,55.74,42.1,52.3,27.54,55.38,38.42,55.31304999999991,60.40389999999999,66.30299999999997,69.99049999999993,66.39836742000071,69.48934781748918,69.77153846153843,74.43398315638944,65.10909376668741,55.31304999999991,60.40389999999999,66.30299999999997,69.99049999999993,72.10333333333332,3236737,4074324.8,58.83125425871781,2.79986729008937,1.5,2.75,NaN,NaN,2.007726832370454,0.7944229188600772,1026.3455364711292,0.061389143361447296,1.2624021826667757,1.2010130393053284,61.740071820997684,7.811094452773602,79.22845006643692,3.689073885522925,17.08247604804014,5034371644
1581345000,71.26,73.53,71.25,73.47,66.0315,51.96894736842106,72.25,42.1,55.74,42.1,52.3,27.54,55.38,38.42,55.42369999999991,60.60009999999999,66.55059999999997,70.24999999999993,66.67568634470656,69.86845754915687,69.89692307692304,74.85351858727634,64.94032756656975,55.42369999999991,60.60009999999999,66.55059999999997,70.24999999999993,72.75,2504081,4005180.15,62.19429702378302,3.2610951312599945,1.5,2.75,NaN,NaN,2.0271749157725645,0.6252105788549861,1028.6896219734317,0.18452037258548026,1.4316635050371787,1.2471431324516984,52.79578457618644,6.88100087285424,77.48404559740847,4.2883551138053875,18.22759928878614,5036875725
1581431400,74.49,75.045,73.53,73.92,66.22675,51.94026315789475,72.25,42.1,55.74,42.1,52.3,27.54,55.38,38.42,55.53319999999991,60.79959999999999,66.79139999999997,70.45799999999994,66.9597770762867,70.25431873495145,70.04230769230766,75.339791297226,64.74482408738932,55.53319999999991,60.79959999999999,66.79139999999997,70.45799999999994,74.165,3879457,4054831.3,63.129942175603,4.212685651860766,1.5,2.75,NaN,NaN,1.9948767075030958,0.956749298053411,1032.264223738353,0.2693717616164566,1.5838578344722691,1.3144860728558125,51.168196241400416,7.723695715534825,77.60272345148152,4.246009850444315,18.151266698074163,5040755182
1581517800,74.93,75.48,74.67,75.3,66.422,51.91157894736843,72.25,42.1,55.74,42.1,52.3,27.54,55.38,38.42,55.6486999999999,61.013099999999994,67.07299999999998,70.75399999999993,67.28684464192251,70.73485980781322,70.4461538461538,76.4391987302047,64.45310896210292,55.6486999999999,61.013099999999994,67.07299999999998,70.75399999999993,75.14999999999999,2869570,4009338.35,65.91579564797775,4.6603431827788455,1.5,2.75,NaN,NaN,1.963814085538589,0.7157215853334005,1034.5598717950027,0.3845185130122801,1.7951342141211626,1.4106157011088825,51.182248576200216,8.720762344787744,75.93729589395159,4.8576039962136015,19.205100109834817,5043624752
1581604200,74.28,75.77,74.04,75.07,66.61725,51.88289473684212,72.25,42.1,55.74,42.1,52.3,27.54,55.38,38.42,55.7625499999999,61.23319999999999,67.38219999999997,71.01399999999992,67.59206642067065,71.1477303023072,71.08999999999995,77.1330812313943,65.0469187686056,55.7625499999999,61.23319999999999,67.38219999999997,71.01399999999992,74.96,4065353,4045260.5,65.03381888818491,4.166662049433665,1.5,2.75,NaN,NaN,1.947113079428689,1.0049669236381686,1034.2487862865835,0.40899479342283374,1.9218591928874247,1.512864399464591,51.6693470219902,14.610687022900754,41.92871455711024,25.42360650507697,32.64767893781279,5039559399
1581690600,75.3,75.44,74.44,75.38,66.8125,51.8542105263158,72.25,42.1,55.74,42.1,52.3,27.54,55.38,38.42,55.8836999999999,61.45559999999998,67.72219999999997,71.20749999999992,67.89747558064435,71.55080360684937,71.60076923076919,77.88080578891099,65.32073267262739,55.8836999999999,61.45559999999998,67.72219999999997,71.20749999999992,75.08666666666666,2484075,4011557.4,65.6999819272925,3.2888926975218573,1.5,2.75,NaN,NaN,1.8794621451837827,0.6192295790158705,1035.287179694481,0.4088868487306845,2.0239729603779466,1.6150861116472621,32.482928669989626,12.692480191358941,68.13798223553326,8.210536167717793,23.65148159674897,5042043474
1582036200,74.67,75.05,73.76,74.7,67.00775,51.82552631578949,72.25,42.1,55.74,42.1,52.3,27.54,55.38,38.42,56.00319999999991,61.684299999999986,68.02699999999997,71.32999999999993,68.1642412441485,71.85072707286372,72.06846153846149,78.2962644410976,65.84065863582538,56.00319999999991,61.684299999999986,68.02699999999997,71.32999999999993,74.50333333333333,3846835,4035451.75,62.870473675163744,2.4178719534969355,1.5,2.75,NaN,NaN,1.860929134813512,0.9532600656171889,1033.2847772912125,0.32926422364182306,2.026666391199541,1.6974021675577178,34.63350656039712,6.699042993858017,40.108082815724245,27.05131394635574,32.840603237920014,5038196639
1582122600,75.45,76.33,75.27,75.83,67.203,76.33,72.25,42.1,55.74,42.1,52.3,27.54,55.38,38.42,56.121099999999906,61.914799999999985,68.34639999999996,71.53499999999993,68.46485923457405,72.2297054468767,72.57384615384612,78.87389029758175,66.27380201011049,56.121099999999906,61.914799999999985,68.34639999999996,71.53499999999993,75.81,2099693,3953620.95,65.52736851697857,3.56055146180985,1.5,2.75,NaN,NaN,1.8444341966125464,0.5310810081578509,1034.7417060847486,0.31873679865395377,2.09582316587516,1.7770863672212063,27.120566385877336,4.809951624049764,33.11875790967269,33.61495764958951,33.26628444073781,5040296332
1582209000,75.44,76.04,72.71,74.93,67.39825,76.53721153846153,72.25,42.1,55.74,42.1,52.3,27.54,55.38,38.42,56.23754999999991,62.14009999999999,68.61679999999997,71.68949999999992,68.71839416655153,72.48687635669796,73.29923076923072,78.18771306659026,68.41074847187117,56.23754999999991,62.14009999999999,68.61679999999997,71.68949999999992,74.56,5317156,4097824.3,61.73808697454107,1.4838326655766325,1.5,2.75,NaN,NaN,1.9505460397116512,1.29755587617556,1037.2142355712979,0.22179244831871392,2.0543269276195986,1.8325344793008846,24.10329630535634,2.461370162723932,8.919662633839593,66.75224080612118,24.32809656003925,5034979176
1582295400,73.91,74.1,71.9604,72.51,67.5935,76.74442307692307,72.25,42.1,55.74,42.1,52.3,27.54,55.38,38.42,56.35479999999991,62.349999999999994,68.84939999999997,71.71349999999993,68.86708459139265,72.48907860844102,73.73153846153842,77.0029140475652,70.46016287551164,56.35479999999991,62.349999999999994,68.84939999999997,71.71349999999993,72.8568,4789306,4165302.85,52.882739072474486,1.4010886214833123,1.5,2.75,NaN,NaN,2.023335608303676,1.1498097911415972,1033.7012725639622,-0.021742732469268278,1.8053560637142994,1.8270987961835676,31.21796477397262,0.8343763037129864,8.349896410195898,67.90879988598405,23.741303703820048,5030189870
1582554600,65.79,67.51,64.56,65.31,67.78875,76.95163461538462,72.25,42.1,55.74,42.1,52.3,27.54,55.38,38.42,56.43719999999991,62.47999999999999,68.94239999999996,71.47649999999993,68.7275910780047,71.80535683620855,73.36999999999996,78.6368601068013,68.10313989319863,56.43719999999991,62.47999999999999,68.94239999999996,71.47649999999993,65.79333333333334,8863321,4297299.2,36.231656776157784,9.883244416161851,1.5,2.75,NaN,NaN,2.4466687791391277,2.062532904387947,1026.5568006967862,-0.6493905662120292,1.015360588418531,1.6647511546305602,67.28720229269396,-11.106574111882397,0.8407220547706291,90.44684435600358,8.71243358922579,5021326549
1582641000,66.31,66.64,58.7804,59.41,67.984,77.15884615384616,72.25,42.1,55.74,42.1,52.3,27.54,55.38,38.42,56.491999999999905,62.570199999999986,68.90719999999996,71.11199999999994,68.3621953494555,70.62484666133155,72.37461538461534,81.50807581362493,63.24115495560575,56.491999999999905,62.570199999999986,68.90719999999996,71.11199999999994,61.61013333333333,11042840,4565303.2,28.353290157891053,17.426562481799724,1.5,2.75,NaN,NaN,2.833306723486333,2.4188623441264534,1019.5761727403151,-1.400447377322924,-0.08580806702309474,1.3146393102998293,79.51727265669923,-19.62932900432901,0.567667249096718,92.2039965636101,7.228336187293188,5010283709
1582727400,60.2,62.4655,58.24,58.67,68.17925,77.36605769230769,75.83,42.1,55.74,42.1,52.3,27.54,55.38,38.42,56.54049999999991,62.67909999999999,68.82579999999997,70.60849999999994,67.98210925731999,69.48628983644282,71.26230769230764,82.92786819213568,59.59674719247962,56.54049999999991,62.67909999999999,68.82579999999997,70.60849999999994,59.79183333333332,12054172,4986228.35,27.544298395925637,16.317613160218244,1.5,2.75,NaN,NaN,2.9327491003801662,2.417492973421484,1016.3348729861447,-1.8569918573645547,-1.006600511405864,0.8503913459586907,77.87814505684455,-22.084993359893755,0,100,0,4998229537
1582813800,55.22,57.61,50.84,50.85,68.3745,77.57326923076923,75.83,42.1,55.74,42.1,52.3,27.54,55.38,38.42,56.56794999999991,62.699,68.58679999999997,69.71999999999994,67.3102618354643,67.71140509011494,69.64230769230765,85.5690904643384,53.715524920276906,56.56794999999991,62.699,68.58679999999997,69.71999999999994,53.1,16237243,5623771.8,20.792645549864872,25.724980500529977,1.5,2.75,NaN,NaN,3.2825527360672972,2.887251399496687,1007.1599848980767,-2.552605497651501,-2.3403655261056855,0.21223997154581542,98.64963475073237,-32.26322099373917,0,100,0,4981992294
1582900200,46.27,50.26,44.61,50.26,68.56975,77.78048076923076,75.83,42.1,55.74,42.1,52.3,27.54,55.38,38.42,56.58669999999991,62.693400000000004,68.30979999999997,68.76999999999994,66.64162411642648,66.049366510104,67.85692307692304,86.61847686630082,49.09536928754525,56.58669999999991,62.693400000000004,68.30979999999997,68.76999999999994,48.376666666666665,20123135,6395448.9,20.386619820429203,32.28853720026577,1.5,2.75,NaN,NaN,3.4937989692053475,3.14647733327992,1002.0121698275832,-2.8943782259001827,-3.405732810829413,-0.5113545849292304,97.6142355436254,-33.324489254444146,0,100,0,4961869159
1583159400,51.1,56.55,49.16,56.52,68.765,77.9876923076923,75.83,42.1,55.74,42.1,52.3,27.54,55.38,38.42,56.63264999999991,62.757200000000005,68.15759999999996,68.32099999999994,66.24469768048819,65.14180779485599,66.5184615384615,85.83336108204438,47.20356199487861,56.63264999999991,62.757200000000005,68.15759999999996,68.32099999999994,54.07666666666666,14869407,6698953.05,34.909928241561616,15.962203709535244,1.5,2.75,NaN,NaN,3.772099042833537,2.219661324540855,1009.8553916803844,-2.5527061637531054,-3.702237289620612,-1.1495311258675067,131.91225281962735,-24.337349397590362,4.677112412997625,76.51003340960627,18.812854177396115,4976738566
1583245800,56.78,59.11,50.17,51.71,68.96025,78.19490384615385,75.83,42.1,55.74,42.1,52.3,27.54,55.38,38.42,56.64809999999991,62.795500000000004,67.90919999999997,67.56199999999993,65.67470953615532,63.86258800486971,64.70384615384611,84.79464548467114,44.613046823021094,56.64809999999991,62.795500000000004,67.90919999999997,67.56199999999993,53.663333333333334,15354353,7239277.9,30.33138642065215,17.218956697488753,1.5,2.75,NaN,NaN,4.141234825488285,2.120978530192908,1006.1450457845592,-2.5012185663508584,-4.27605433380608,-1.7748357674552215,135.448611950708,-31.80799156006857,4.348890510048678,77.40462201624788,18.246487473703446,4961384213
1583332200,54.74,58.28,53.27,58.16,69.1555,78.40211538461539,75.83,42.1,55.74,42.1,52.3,27.54,55.38,38.42,56.700249999999905,62.885799999999996,67.77359999999996,66.96949999999994,65.38001504454138,63.31948438535831,63.40307692307689,82.81916443930605,43.98698940684773,56.700249999999905,62.885799999999996,67.77359999999996,66.96949999999994,56.57,10415804,7559296.75,41.42536111255442,7.302252951069549,1.5,2.75,NaN,NaN,4.3147180522391215,1.3778800256783146,1014.1898422394113,-1.91002435693431,-4.162366213623109,-2.252341856688799,160.2397212235953,-22.38088882957428,15.025565547947354,56.100531580321096,28.87390287173155,4971800017
1583418600,53.77,55.7182,51,52.31,69.35075,78.60932692307692,75.83,42.1,55.74,42.1,52.3,27.54,55.38,38.42,56.728099999999905,62.906800000000004,67.50199999999997,65.96749999999994,64.86746543495153,62.270962062943234,61.6284615384615,80.55234770001991,42.7045753769031,56.728099999999905,62.906800000000004,67.50199999999997,65.96749999999994,53.0094,13031004,8010136,35.84947785723391,14.2827433511709,1.5,2.75,NaN,NaN,4.5179524770791835,1.626814326248643,1007.1851854033268,-1.792147809411127,-4.4925266184527075,-2.7003788090415806,166.07781881311743,-27.85822645152393,16.253309260980167,54.22307414230168,29.52361659671816,4958769013
1583505000,47.5,50.4,45.95,49.7,69.546,78.81653846153846,75.83,42.1,55.74,42.1,52.3,27.54,55.38,38.42,56.73664999999991,62.886500000000005,67.18079999999995,64.79599999999994,64.272662868875,61.07372758075817,59.705384615384574,77.99548217223357,41.41528705853558,56.73664999999991,62.886500000000005,67.18079999999995,64.79599999999994,48.68333333333334,13626906,8535522.4,33.67184996071424,20.965641383530592,1.5,2.75,NaN,NaN,4.649527300144955,1.5964934964027508,1001.0473136722009,-1.7662629879376315,-4.90820754396362,-3.1419445560259884,166.28549219902635,-23.90139335476956,19.714739248300223,49.28531812440789,30.999942627291894,4945142107
1583760600,39.85,43.05,37.71,38.16,69.74125000000001,79.02374999999999,75.83,42.1,55.74,42.1,52.3,27.54,55.38,38.42,56.689599999999906,62.7522,66.62839999999994,63.108499999999935,63.24863687401716,58.89146781116215,56.807692307692264,75.88050203793173,37.734882577452794,56.689599999999906,62.7522,66.62839999999994,63.108499999999935,39.63999999999999,18924243,9319897.7,26.117697992594017,41.59990069967871,1.5,2.75,NaN,NaN,5.17384677870603,2.030520463760026,984.1772217933758,-2.365259790554428,-6.098519294219024,-3.7332595036645957,209.3032832609853,-35.768389160074065,3.2598389184057237,80.58519475291101,16.154966328683265,4926217864
1583847000,42.39,44,37.75,44,69.9365,79.23096153846154,75.83,42.1,55.74,42.1,52.3,27.54,55.38,38.42,56.68014999999991,62.661300000000004,66.17279999999994,61.634999999999934,62.49378836915374,57.47323278152766,54.4284615384615,71.47399846148281,37.38292461544019,56.68014999999991,62.661300000000004,66.17279999999994,61.634999999999934,41.916666666666664,21643628,10276875.05,34.16693204849375,26.798779659339512,1.5,2.75,NaN,NaN,5.250714865941313,2.1060514888716098,989.7673917371253,-2.209977984337237,-6.495731984086142,-4.285753999748905,234.9165445416979,-25.00426112152719,22.975057290117697,44.98223688191243,32.042705827969876,4947861492
1583933400,40.48,40.99,36,37.59,70.13175,79.43817307692308,75.83,42.1,55.74,42.1,52.3,27.54,55.38,38.42,56.63779999999991,62.5091,65.58979999999995,59.81849999999993,61.51716921742222,55.579591564239315,51.742307692307655,67.50086903594882,35.983746348666486,56.63779999999991,62.5091,65.58979999999995,59.81849999999993,38.193333333333335,21126026,11139203.5,30.26893787866821,36.82999877811003,1.5,2.75,NaN,NaN,5.447092375516933,1.8965472710863034,979.035480768268,-2.3667984826882797,-7.244252103109254,-4.877453620420974,245.42622918719243,-26.076696165191734,7.063838478801283,70.6667696883667,22.269391832832014,4926735466
1584019800,29.5,34.39,26.76,26.81,70.327,79.64538461538461,75.83,42.1,55.74,42.1,52.3,27.54,55.38,38.42,56.54784999999992,62.24530000000001,64.81459999999994,57.39399999999993,60.15610375791547,52.83963046288319,48.78076923076919,67.43221415155578,30.12932430998259,56.54784999999992,62.24530000000001,64.81459999999994,57.39399999999993,29.320000000000004,33980772,12694763.6,25.085643625529627,72.07406864347142,1.5,2.75,NaN,NaN,5.831585777265723,2.676755004717063,962.8182060280412,-2.984506647846165,-8.60808693022868,-5.623580282382515,294.5060947331987,-46.65738161559889,6.22356727436953,72.59082539090689,21.185607334723596,4892754694
1584106200,31.71,34.16,27.2,34.04,70.52225,79.85259615384615,75.83,42.1,55.74,42.1,52.3,27.54,55.38,38.42,56.49864999999993,62.060700000000004,64.17379999999994,55.34249999999993,59.13194282623251,51.04918946641813,46.829230769230726,65.9273377419343,27.73112379652716,56.49864999999993,62.060700000000004,64.17379999999994,55.34249999999993,31.8,31641096,14073550.75,33.33146316204639,45.06083922672676,1.5,2.75,NaN,NaN,5.940043936032457,2.2482667353865904,972.1887819072331,-2.702550571238593,-9.001768496430756,-6.299217925192163,341.9132022617248,-39.77353149327672,26.18453197311593,41.11236324689822,32.70310477998584,4924395790
1584365400,23.1,28.83,22,22.51,70.7175,80.05980769230769,75.83,42.1,55.74,42.1,52.3,27.54,55.38,38.42,56.38994999999993,61.74940000000001,63.265799999999956,52.698999999999934,57.69578820559594,48.331171421997354,44.047692307692266,65.78768191047253,22.307702704912,56.38994999999993,61.74940000000001,63.265799999999956,52.698999999999934,24.44666666666667,42234467,16061070.35,28.03234200006966,80.51128453303478,1.5,2.75,NaN,NaN,6.375755083458709,2.629617209789508,955.5544799982259,-3.0625426945289886,-10.1273962933534,-7.064853598824411,385.892433015642,-56.46876812995552,23.198462653120835,44.75301648987188,32.0485208570073,4882161323
1584451800,23.72,26.74,21.48,26.19,70.91275,80.26701923076922,75.83,42.1,55.74,42.1,52.3,27.54,55.38,38.42,56.308299999999925,61.481,62.46399999999995,50.273499999999935,56.46026709949414,46.22248842942618,42.15076923076919,65.43421262075502,18.867325840783366,56.308299999999925,61.481,62.46399999999995,50.273499999999935,24.80333333333333,41179923,17927724.75,31.761266772310435,58.902093250959176,1.5,2.75,NaN,NaN,6.296058291783088,2.296996611351923,959.2107651420066,-2.8283773099942744,-10.600325236317254,-7.771947926322979,410.4132823103445,-54.96905089408528,24.934451491746888,42.635217483147024,32.4303310251061,4923341246
1584538200,21.44,23.69,18.38,22.24,71.108,80.47423076923077,75.83,42.1,55.74,42.1,52.3,27.54,55.38,38.42,56.208999999999925,61.1681,61.56779999999994,47.59399999999993,55.11829584069045,43.93844191233797,39.99538461538457,65.00105242260794,14.989716808161202,56.208999999999925,61.1681,61.56779999999994,47.59399999999993,21.436666666666667,54281512,20536815.7,29.96646797523711,78.03156534842242,1.5,2.75,NaN,NaN,6.404196985227153,2.643131865861756,945.6382087978876,-2.7145631776131793,-11.165151898339452,-8.450588720726273,395.3637834493403,-57.484228636971906,20.893840102305806,47.70431325598089,31.4018466417133,4869059734
1584624600,21.61,23.8,19.9,22.02,71.30325,80.68144230769231,75.83,42.1,55.74,42.1,52.3,27.54,55.38,38.42,56.094949999999926,60.85100000000001,60.67739999999994,44.94849999999993,53.82032345478102,41.85097125402007,37.34153846153842,62.09052426348295,12.592552659593888,56.094949999999926,60.85100000000001,60.67739999999994,44.94849999999993,21.906666666666663,50720294,22806972.6,29.865241467716046,61.393707885287675,1.5,2.75,NaN,NaN,6.225325771996642,2.223894196286271,952.9135805741447,-2.437922278757771,-11.497991569173486,-9.060069290415715,398.31075497884984,-55.694164989939644,19.21805048125997,49.9614641243244,30.820485394415613,4818339440
1584711000,23,23.43,19.01,19.12,71.4985,80.88865384615384,75.83,42.1,55.74,42.1,52.3,27.54,55.38,38.42,55.96059999999993,60.49760000000001,59.70859999999994,42.27899999999993,52.459526456554315,39.6861168488753,34.83461538461535,59.85482950825744,9.814401260973252,55.96059999999993,60.49760000000001,59.70859999999994,42.27899999999993,20.52,39904406,24562727.6,28.498637151281315,67.36532752184137,1.5,2.75,NaN,NaN,6.096373931139739,1.6245918063269162,950.144705953172,-2.2392015112174217,-11.859071179437493,-9.61986966822007,398.7374109632557,-49.89517819706498,4.821628202090659,76.12282019084343,19.05555160706592,4778435034
1584970200,19,19.3,16.51,17.55,16.51,81.09586538461538,75.83,42.1,55.74,42.1,52.3,27.54,55.38,38.42,55.81389999999993,60.11980000000001,58.68099999999995,39.89099999999993,51.09052541904238,37.57791524422051,31.710769230769195,54.32704038032122,9.094498081217168,55.81389999999993,60.11980000000001,58.68099999999995,39.89099999999993,17.786666666666665,58496180,27044370.55,27.758090067400843,76.35237502175572,1.5,2.75,NaN,NaN,5.860204364629758,2.162970659341154,942.8859419280494,-2.0097557573610647,-12.132064364921401,-10.122308607560337,384.0272112933271,-60.11363636363637,4.7362386761477735,76.32575916849079,18.93800215536145,4719938854
1585056600,20.48,22.59,20.18,22.43,15.12857142857143,81.30307692307692,75.83,42.1,55.74,42.1,52.3,27.54,55.38,38.42,55.68474999999993,59.79170000000002,57.76399999999994,38.04199999999993,49.9665832457466,36.13525664953285,29.412307692307657,49.06692101468241,9.757694369932906,55.68474999999993,59.79170000000002,57.76399999999994,38.04199999999993,21.73333333333333,51313508,29057903.95,33.539050278287476,35.37897460783314,1.5,2.75,NaN,NaN,5.801618338584776,1.7659053484482319,954.7743115948008,-1.3568755313552607,-11.818403021754413,-10.461527490399153,409.26340431763856,-40.32987496674648,5.291889932817437,74.88045141525268,19.827658651929895,4771252362
1585143000,22.81,25.97,21.41,23.27,13.747142857142858,81.51028846153847,75.83,42.1,75.83,42.1,55.74,27.54,52.3,38.42,55.55654999999993,59.46700000000003,56.83419999999994,36.27199999999993,48.91965841258006,34.9099941114821,27.379230769230734,43.339669285547764,11.418792252913706,55.55654999999993,59.46700000000003,56.83419999999994,36.27199999999993,23.55,56012991,31255844.9,34.510513786620706,22.366642536203464,1.5,2.75,NaN,NaN,5.71293131440015,1.792080526992889,963.1938655550108,-0.7275506097954629,-11.370965752643482,-10.643415142848019,408.799833711586,-13.204028347631477,26.35241545307793,40.933678246534775,32.7139063003873,4827265353
1585229400,24.1275,27.8533,23.98,27.41,12.365714285714288,81.7175,75.83,42.1,75.83,42.1,55.74,27.54,52.3,38.42,55.449199999999934,59.188700000000026,55.994799999999934,35.09999999999992,48.07614239640045,34.195708958007614,26.55230769230766,41.257379876047324,11.847235508567994,55.449199999999934,59.188700000000026,55.994799999999934,35.09999999999992,26.414433333333335,48482524,32868108.95,39.22556704285185,7.837219458859616,1.5,2.75,NaN,NaN,5.632243363371567,1.4750627750976832,972.1091759041063,0.06627657658774311,-10.560569422113339,-10.626845998701082,378.9332424126362,-19.477085781433605,57.34847149184828,14.213704242112259,28.437824266039467,4875747877
1585315800,24.91,27.28,24.18,24.9,10.984285714285717,81.92471153846154,75.83,42.1,75.83,42.1,55.74,27.54,52.3,38.42,55.33054999999994,58.86970000000002,55.095399999999934,33.83199999999992,47.167274067129846,33.31040334295927,25.08307692307689,35.79644853807031,14.369705308083471,55.33054999999994,58.86970000000002,55.095399999999934,33.83199999999992,25.453333333333333,42154952,33969699.8,37.464433638994834,10.385747440451636,1.5,2.75,NaN,NaN,5.46065455170217,1.240957448790878,965.0940407513012,0.4970583406644806,-10.005523072870481,-10.502581413534962,350.14152396771954,10.617503331852497,52.38526587059734,17.476656144689123,30.138077984713558,4833592925
1585575000,25.57,27.56,24.97,27.29,9.602857142857145,82.13192307692307,75.83,17.55,75.83,42.1,55.74,27.54,52.3,38.42,55.22079999999995,58.56810000000002,54.21099999999993,32.37049999999992,46.387773123320834,32.737031596010766,24.290769230769204,32.39223523880071,16.1893032227377,55.22079999999995,58.56810000000002,54.21099999999993,32.37049999999992,26.606666666666666,32979616,34875210.25,40.21682910147406,4.857687279154107,1.5,2.75,NaN,NaN,5.260607798009157,0.9456463706910555,969.3366814384206,0.9892816316957269,-9.265979373915304,-10.25526100561103,255.82882318071572,4.2000763650248105,78.10936248667518,4.069906591870392,17.82073092145443,4866572541
1585661400,27,27.9,25.6573,26.05,8.221428571428575,82.33913461538461,75.83,17.55,75.83,42.1,55.74,27.54,52.3,38.42,55.10599999999994,58.25600000000002,53.286999999999935,31.08749999999992,45.59021339299453,32.10017144400974,24.232307692307664,32.270938091711834,16.193677292903494,55.10599999999994,58.25600000000002,53.286999999999935,31.08749999999992,26.535766666666664,43213397,36268162.45,39.25155841492565,5.0033759659031185,1.5,2.75,NaN,NaN,5.045042955294217,1.191496731039926,966.5293061638619,1.2602992306177452,-8.679886967338849,-9.940186197956594,243.3547764181173,17.13129496402879,49.497755846959265,19.47221522922978,31.030028923810956,4823359144
1585747800,23.15,24.2,21.91,22.59,6.840000000000003,82.54634615384614,75.83,17.55,75.83,42.1,55.74,27.54,52.3,38.42,54.97339999999994,57.90860000000002,52.30419999999994,29.308999999999923,44.688244240328075,31.194440830294525,23.351538461538432,29.074237373785753,17.62883954929111,54.97339999999994,57.90860000000002,52.30419999999994,29.308999999999923,22.900000000000002,38189638,37656854.15,36.61102154421612,19.09800753959323,1.5,2.75,NaN,NaN,4.980397029916058,1.014148389769303,957.8655537400789,1.2339145062671442,-8.397793065122663,-9.631707571389807,238.47653912934115,2.588555858310628,23.17733281913925,44.6643136053474,32.15835357551336,4785169506
1585834200,22.36,24.4,22.1702,24.12,5.458571428571432,82.7535576923077,75.83,17.55,75.83,42.1,55.74,27.54,52.3,38.42,54.84129999999994,57.570300000000024,51.34979999999993,27.89949999999992,43.881646426981874,30.520684560742666,23.475384615384584,29.18955386187307,17.7612153688961,54.84129999999994,57.570300000000024,51.34979999999993,27.89949999999992,23.5634,41577864,39084197.15,38.57870096922049,12.657513933268808,1.5,2.75,NaN,NaN,4.783925813493482,1.06380243248773,961.2948393799753,1.338144699873979,-7.959026696547333,-9.297171396421312,241.057253280432,26.15062761506276,18.977977875469477,50.17841390626336,30.843608218267175,4826747370
1585920600,23.8349,24.57,22.27,23.11,4.07714285714286,82.96076923076923,75.83,17.55,75.83,42.1,55.74,27.54,52.3,38.42,54.70189999999994,57.21850000000002,50.37139999999993,26.56999999999992,43.06707205729631,29.814905078767175,23.23846153846151,28.73399172862569,17.742931348297333,54.70189999999994,57.21850000000002,50.37139999999993,26.56999999999992,23.316666666666666,40390089,40422356.3,37.74574279580296,13.900092604408698,1.5,2.75,NaN,NaN,4.606502541101091,0.9992017461881608,955.8982842734705,1.353631106097259,-7.605132513799738,-8.958763619896997,224.6983348026164,31.680911680911674,19.96558739985145,48.827269607414735,31.2071429927338,4786357281
1586179800,25.81,28.81,25.49,27.79,2.6957142857142884,83.16798076923077,75.83,17.55,75.83,42.1,55.74,27.54,52.3,38.42,54.578799999999944,56.91680000000002,49.526199999999925,26.05149999999992,42.4679711923043,29.622056976027444,23.66538461538459,29.62687444148893,17.70389478928025,54.578799999999944,56.91680000000002,49.526199999999925,26.05149999999992,27.363333333333333,39068236,41429555.95,43.800757708111405,3.842069125737577,1.5,2.75,NaN,NaN,4.684609502451012,0.9430039763677457,965.617416871678,1.6727201106573766,-6.867863481575277,-8.540583592232654,231.9976321757639,23.896567097637092,22.32660767673584,45.74148364034608,31.93190868291808,4825425517
1586266200,30.7101,31.01,27.75,27.78,1.3142857142857185,83.3751923076923,75.83,17.55,75.83,42.1,55.74,27.54,52.3,38.42,54.45689999999995,56.61170000000002,48.747799999999934,25.24049999999992,41.89197232201786,29.446622978310543,24.10846153846151,30.363885504435583,17.853037572487434,54.45689999999995,56.61170000000002,48.747799999999934,25.24049999999992,28.846666666666664,47873261,42741037.6,43.790956729863495,8.419691827070599,1.5,2.75,NaN,NaN,4.5828516808473685,1.1200771831519598,972.8604506601907,1.8622568584131436,-6.2127625192162235,-8.075019377629367,194.65988264330048,19.38117748173615,20.51153060264188,48.102189590292824,31.386279807065293,4777552256
1586352600,28.7,31.05,27.98,30.61,-0.0671428571428514,83.58240384615384,75.83,17.55,75.83,42.1,55.74,27.54,52.3,38.42,54.35014999999996,56.334100000000014,47.98519999999994,24.891499999999915,41.449542034879904,29.557420789900014,24.992307692307666,31.423085388290318,18.561529996325014,54.35014999999996,56.334100000000014,47.98519999999994,24.891499999999915,29.88,38576087,43613540.65,47.37946676876553,10.55655451201444,1.5,2.75,NaN,NaN,4.489076560786842,0.8844979431863669,980.066929226962,2.1376546371022673,-5.402951081251533,-7.540605718353801,199.40126493361055,11.674571324334183,45.26024100288466,22.70689838520543,32.032860611909896,4816128343
1586439000,31.83,33.01,31.095,31.98,-1.448571428571423,83.78961538461539,75.83,17.55,75.83,42.1,55.74,27.54,52.3,38.42,54.25949999999995,56.06750000000001,47.252399999999945,25.149999999999917,41.07818744527677,29.788142619433348,26.102307692307665,31.968141773446987,20.236473611168343,54.25949999999995,56.06750000000001,47.252399999999945,25.149999999999917,32.02833333333333,44859442,44157474.15,49.07443908171569,13.247564635901318,1.5,2.75,NaN,NaN,4.339856806444924,1.015896920363141,986.9935967810067,2.3543857034488678,-4.5976235890427155,-6.952009292491583,180.41587928174167,28.43373493975905,49.58688607522944,19.412014083250426,31.001099841520126,4860987785
1586784600,31.68,31.77,29.67,31.09,-2.8299999999999947,83.99682692307692,75.83,17.55,75.83,42.1,55.74,27.54,52.3,38.42,54.164949999999955,55.77940000000002,46.48899999999994,25.002499999999916,40.686493819971794,29.912129036630173,26.76846153846151,32.77994719205111,20.756975884871906,54.164949999999955,55.77940000000002,46.48899999999994,25.002499999999916,30.843333333333334,35165242,44333681.45,47.99290910256922,8.299756631301209,1.5,2.75,NaN,NaN,4.194867034556002,0.7931947190007158,981.7515392969011,2.3733901689439296,-3.9852715813116717,-6.358661750255601,168.94601464483688,13.924514474166363,48.04256677369253,20.542394031540724,31.415039194766763,4825822543
1586871000,32.9466,34.19,32.57,33.88,-4.211428571428566,84.20403846153846,75.83,17.55,75.83,42.1,55.74,27.54,52.3,38.42,54.08199999999995,55.51870000000002,45.85659999999994,25.57099999999992,40.41957249369839,30.29002150933206,27.584615384615354,34.31282747029031,20.8564032989404,54.08199999999995,55.51870000000002,45.85659999999994,25.57099999999992,33.54666666666666,30687904,43756353.3,51.59436437270722,14.020963703309802,1.5,2.75,NaN,NaN,4.11666224637343,0.7013359589086232,987.253767009739,2.496906752707927,-3.237528309370692,-5.734435062078619,168.118388619703,30.05758157389636,47.606646667327425,20.871588500433006,31.521764832239572,4856510447
1586957400,31.67,32.37,30.89,31.7,-5.592857142857138,84.41125,75.83,17.55,75.83,42.1,55.74,27.54,52.3,38.42,53.98374999999996,55.23670000000002,45.15279999999994,25.846499999999917,40.077628474337665,30.42430517510996,27.914615384615352,34.988161401602724,20.841069367627984,53.98374999999996,55.23670000000002,45.15279999999994,25.846499999999917,31.653333333333332,27931722,43093943.25,48.75345218113573,7.608099405391642,1.5,2.75,NaN,NaN,4.03618637163247,0.6481588801925199,980.3825017904154,2.356589819308799,-2.7886977879426205,-5.1452876072514195,171.4359595120783,40.327578574590525,54.55510750254905,15.948228196494105,29.49666430095685,4828578725
1587043800,32.1779,32.47,31.03,32.18,-6.97428571428571,84.61846153846153,75.83,17.55,75.83,42.1,55.74,27.54,52.3,38.42,53.88184999999996,54.965800000000016,44.396199999999936,26.343499999999914,39.767917553775405,30.59151420605187,28.474615384615355,35.65670256950534,21.292528199725368,53.88184999999996,54.965800000000016,44.396199999999936,26.343499999999914,31.893333333333338,34532462,42106490.75,49.413926509401286,6.558912624354956,1.5,2.75,NaN,NaN,3.8507444879444366,0.8201220615850063,982.3126546848977,2.222646635035617,-2.3669793134568984,-4.5896259484925155,137.46446271722093,33.41625207296848,53.90979710416576,16.3769809276529,29.71322196818133,4863111187
1587130200,34.36,34.98,33.31,34.76,-8.355714285714281,84.82567307692307,75.83,17.55,75.83,42.1,55.74,27.54,52.3,38.42,53.79044999999996,54.72350000000002,43.64439999999994,26.980499999999914,39.57152863009794,30.988512853094548,29.04923076923074,36.922322084838946,21.176139453622536,53.79044999999996,54.72350000000002,43.64439999999994,26.980499999999914,34.349999999999994,31562086,41148580.35,52.92578919679372,10.970089970575069,1.5,2.75,NaN,NaN,3.7756913102341194,0.7670273368252424,989.1015344812182,2.2286711490254225,-1.8037870122107371,-4.03245816123616,138.54833752186124,50.4110774556469,50.53989154236905,18.709752357803023,30.75035609982794,4894673273
1587389400,33.29,34.63,32.83,32.94,-9.737142857142853,85.03288461538462,75.83,17.55,75.83,42.1,55.74,27.54,52.3,38.42,53.68399999999996,54.459600000000016,42.84059999999994,27.671499999999916,39.311468683819584,31.174368771847448,29.579230769230737,37.500848558695644,21.65761297976583,53.68399999999996,54.459600000000016,42.84059999999994,27.671499999999916,33.46666666666667,28604859,40583603,50.274305266070655,7.8523229721997,1.5,2.75,NaN,NaN,3.6438562166459683,0.704837838079581,983.6205841688608,2.0362315765229875,-1.4871686905824255,-3.523400267105413,140.97004826861823,18.53184598776538,53.97100895212578,16.347521715931133,29.681469331943088,4866068414
1587475800,31.2001,31.68,29.58,29.94,-11.118571428571425,85.24009615384615,75.83,17.55,75.83,42.1,55.74,27.54,52.3,38.42,53.56374999999996,54.15210000000002,42.00119999999995,28.290999999999922,38.94396010798352,31.05680984119531,30.144615384615353,36.96244998506242,23.326780784168285,53.56374999999996,54.15210000000002,42.00119999999995,28.290999999999922,30.400000000000002,33679372,39342762.6,46.16846853546898,1.7463939640228143,1.5,2.75,NaN,NaN,3.6235807725998277,0.856050001938603,978.6298234745685,1.6495407329223561,-1.461474350952468,-3.111015083874824,123.16856207788794,7.775377969762419,26.090245507485648,41.162811474861684,32.74694301765267,4832389042
1587562200,31.65,32.51,31.18,31.91,-12.499999999999993,85.44730769230769,75.83,17.55,75.83,42.1,55.74,27.54,52.3,38.42,53.45714999999996,53.86030000000002,41.169999999999945,28.764999999999922,38.66811853512142,31.138066046795757,30.743846153846125,36.646177054360905,24.841515253331345,53.45714999999996,53.86030000000002,41.169999999999945,28.764999999999922,31.866666666666667,18484377,37701306.05,49.10772266933992,3.6798945860745134,1.5,2.75,NaN,NaN,3.5483250031284115,0.49028479213653137,983.4394051062386,1.4747820810434082,-1.2675374825705639,-2.742319563613972,127.09884582685314,4.246978111728195,46.59473956600742,21.660086799116918,31.745173634875673,4850873419
1587648600,32.3727,33.56,31.78,31.85,-13.881428571428565,85.65451923076922,75.83,17.55,75.83,42.1,55.74,27.54,52.3,38.42,53.34949999999997,53.56000000000002,40.328599999999945,29.193999999999924,38.40074133766568,31.205869280434257,31.41615384615382,35.34998766581499,27.48232002649264,53.34949999999997,53.56000000000002,40.328599999999945,29.193999999999924,32.39666666666667,30495328,36425422.9,49.01993311904821,4.240381407635683,1.5,2.75,NaN,NaN,3.422016074333525,0.8371990102550052,987.0900588459506,1.3091083742029443,-1.1059340958602917,-2.415042470063236,115.60287091900089,-0.4065040650406473,17.97677452760594,51.59163247210133,30.43159300029274,4820378091
1587735000,32.45,33.469,31.68,33.24,-15.262857142857136,85.86173076923077,75.83,17.55,75.83,42.1,55.74,27.54,52.3,38.42,53.244949999999974,53.280200000000015,39.48739999999994,29.485499999999927,38.19835932442389,31.399596015630994,31.835384615384587,35.263168069496594,28.407601161272584,53.244949999999974,53.280200000000015,39.48739999999994,29.485499999999927,32.79633333333334,24007344,35201663.9,51.196596991114234,4.958539478407349,1.5,2.75,NaN,NaN,3.3053720690239876,0.6819945803755032,990.2672580204744,1.2473657141287773,-0.8558353274022643,-2.1032010415310416,115.4702416417833,6.915406883242207,13.702693265953034,58.101955502299916,28.195351231747047,4844385435
1587994200,33.98,35.07,33.8,34.66,-16.644285714285704,86.06894230769231,75.83,17.55,75.83,42.1,55.74,27.54,52.3,38.42,53.145899999999976,53.03070000000002,38.679199999999945,29.973499999999927,38.059600135230795,31.710110680808995,32.36461538461536,35.197266932705844,29.53196383652488,53.145899999999976,53.03070000000002,38.679199999999945,29.973499999999927,34.51,21158057,34151819.15,53.386191923616714,8.417115422726315,1.5,2.75,NaN,NaN,3.199988349807988,0.6195294284931232,996.2184483775934,1.2530732040906325,-0.5368595364177509,-1.7899327405083834,115.34544309406768,2.3022432113341025,35.50864862269867,31.204999254909477,33.28635212239185,4865543492
1588080600,36.11,36.2299,34.05,34.2,-18.025714285714276,86.27615384615385,75.83,17.55,75.83,17.55,55.74,42.1,52.3,27.54,53.04109999999998,52.78890000000001,37.85559999999994,30.31899999999993,37.90824326718253,31.947242996922423,32.6407692307692,35.435065195914696,29.846473265623708,53.04109999999998,52.78890000000001,37.85559999999994,30.31899999999993,34.826633333333334,31461255,34075901.1,52.563472235885165,7.769564324527624,1.5,2.75,NaN,NaN,3.127124896250275,0.9232699351859546,1000.9257544180724,1.177924730033561,-0.3175268279664323,-1.4954515579999932,105.36642790885689,7.886435331230295,34.37266196759536,32.30535266259639,33.32198536980827,4834082237
1588167000,36.25,37.45,35.85,36.84,-19.407142857142848,86.48336538461538,75.83,17.55,75.83,17.55,55.74,42.1,52.3,27.54,52.94914999999998,52.562700000000014,37.09839999999994,30.858499999999935,37.866351374351844,32.41321985435838,33.014615384615354,36.55585910689595,29.47337166233476,52.94914999999998,52.562700000000014,37.09839999999994,30.858499999999935,36.71333333333334,26079315,33219197,56.68876081845816,11.612686649694117,1.5,2.75,NaN,NaN,3.1359016893752556,0.7850675920914043,1010.2531334711613,1.2511867404621293,0.06853186757766849,-1.1826548728844608,103.36714013807203,14.481044126786834,39.903555918027024,27.17033849987022,32.926105582102764,4860161552
1588253400,36.23,36.49,35.11,35.75,-20.78857142857142,86.69057692307692,75.83,17.55,75.83,17.55,55.74,42.1,52.3,27.54,52.85469999999999,52.32160000000002,36.29679999999994,31.516499999999933,37.78335720280863,32.731008439657586,33.373076923076894,37.00473587534129,29.7414179708125,52.85469999999999,52.32160000000002,36.29679999999994,31.516499999999933,35.78333333333333,25563232,32587876.7,54.57834020064624,7.078259414694858,1.5,2.75,NaN,NaN,3.0354801401341662,0.78443993867204,1005.1338027366012,1.1727374580205647,0.283266949641245,-0.8894705083793196,106.54467705454701,2.8481012658227907,40.895266346139984,26.306284010476457,32.79844964338355,4834598320
1588339800,33.86,34.16,32.5,32.99,-22.16999999999999,86.89778846153845,75.83,17.55,75.83,17.55,55.74,42.1,52.3,27.54,52.75159999999998,52.03740000000002,35.45799999999994,31.959999999999933,37.595382410541625,32.75567430254734,33.30461538461536,36.92901657980176,29.680214189428956,52.75159999999998,52.03740000000002,35.45799999999994,31.959999999999933,33.21666666666667,26388898,31828428.4,49.54833546229639,0.944222625233999,1.5,2.75,NaN,NaN,3.05080298726744,0.8290983666664484,999.038874669089,0.8940625128983195,0.2281076327435798,-0.6659548801547397,108.8179158345907,0.15179113539770572,17.945521537074917,51.61955505176723,30.43492341115786,4808209422
1588599000,32.2,33.3463,31.69,33.22,-23.551428571428563,87.10499999999999,75.83,17.55,75.83,17.55,55.74,42.1,52.3,27.54,52.64684999999998,51.76080000000002,34.67219999999994,32.465499999999935,37.423798786598816,32.79989579754283,33.42153846153843,36.92747054349804,29.915606379578826,52.64684999999998,51.76080000000002,34.67219999999994,32.465499999999935,32.7521,18849022,30751375.05,49.962191965624804,1.3963742847852374,1.5,2.75,NaN,NaN,2.9511956310340506,0.6129489159217288,997.7683292294113,0.6932756680329961,0.2006397048865054,-0.49263596314649066,104.40483529666655,10.955243820975276,15.6396391331061,55.08166324404051,29.278697622853397,4827058444
1588685400,34.31,35.22,33.98,34.13,-24.932857142857134,87.31221153846154,75.83,17.55,75.83,17.55,55.74,42.1,52.3,27.54,52.55159999999997,51.49550000000002,34.048599999999944,32.782499999999935,37.294630206732194,32.926572388253035,33.57153846153843,37.01852462476384,30.124552298313017,52.55159999999997,51.49550000000002,34.048599999999944,32.782499999999935,34.44333333333333,18649377,29730432.1,51.65205138275699,3.815997842092727,1.5,2.75,NaN,NaN,2.8832530859601895,0.6272824067027266,1000.6811242788441,0.5936490495711497,0.2494253488174465,-0.34422370075370323,84.94115495213885,6.957066750235043,39.49793926698887,27.57847111948691,32.9235896135242,4845707821
1588771800,34.81,34.96,33.4,33.46,-26.314285714285706,87.51942307692308,75.83,17.55,75.83,17.55,55.74,42.1,52.3,27.54,52.450999999999965,51.21840000000002,33.52959999999994,33.06649999999994,37.144252551566225,32.977375017943224,33.47153846153843,36.84954739857489,30.093529524501964,52.450999999999965,51.21840000000002,33.52959999999994,33.06649999999994,33.94,18055065,28239522.3,50.30500790039762,1.836969983191386,1.5,2.75,NaN,NaN,2.7887350083916047,0.6393544766159164,997.3140664160081,0.46046533808595436,0.23135797185373974,-0.22910736623221462,80.1272678711001,5.054945054945053,14.61170570289036,56.68037676089665,28.70791753621298,4827652756
1588858200,34.69,35.39,34.47,34.67,-27.695714285714278,87.72663461538461,75.83,17.55,75.83,17.55,55.74,42.1,52.3,27.54,52.35069999999997,50.93770000000002,33.04959999999994,33.26949999999994,37.047223039740096,33.13857739718673,33.60461538461536,37.02442748367861,30.184803285552103,52.35069999999997,50.93770000000002,33.04959999999994,33.26949999999994,34.843333333333334,15240771,27072756.5,52.703920544365076,3.731834071127208,1.5,2.75,NaN,NaN,2.72739679350649,0.562956010777846,1001.5838169041244,0.43215811536350185,0.3110902779721627,-0.12106783739133914,81.84810192690237,4.3020457280385065,38.609778431473465,28.373210161525233,33.01701140700129,4842893527
1588944600,35.9,36.5,35.44,36.39,-29.07714285714285,87.93384615384615,75.83,17.55,75.83,17.55,55.74,42.1,52.3,27.54,52.255149999999965,50.67360000000002,32.76039999999995,33.48999999999994,37.02144958720127,33.44823669269275,34.1007692307692,37.095014599045456,31.10652386249295,52.255149999999965,50.67360000000002,32.76039999999995,33.48999999999994,36.11,12880029,25473785.85,55.95847760682521,6.077200362342499,1.5,2.75,NaN,NaN,2.6632970225417405,0.5056189557313091,1007.6741857429217,0.5026313881783797,0.5072213978316356,0.0045900096532558166,82.77864576430318,4.991344489324882,73.79353983522229,5.7170402274433005,20.48941993733441,4855773556
1589203800,35.57,36.96,35.4,36.38,-30.45857142857142,88.1410576923077,75.83,17.55,75.83,17.55,55.74,42.1,52.3,27.54,52.163749999999965,50.396300000000025,32.48279999999995,33.754499999999936,36.99629470142867,33.72745224576963,34.44461538461535,37.37962019797391,31.5096105712568,52.163749999999965,50.396300000000025,32.48279999999995,33.754499999999936,36.24666666666667,14214090,24426228.25,55.93437845257351,6.472435734042987,1.5,2.75,NaN,NaN,2.5844900923601877,0.5819191507800636,1004.6996561856713,0.5197738794772424,0.6543073589998087,0.1345334795225664,80.16976850406022,6.374269005847951,47.65295408372704,20.872256025370202,31.474789890902777,4841559466
1589290200,36.881,37.04,34.15,34.24,-31.839999999999993,88.34826923076923,75.83,17.55,75.83,17.55,55.74,42.1,52.3,27.54,52.05624999999996,50.09740000000002,32.03719999999995,33.77249999999994,36.88820471313735,33.7762663176011,34.62846153846151,37.16234085261564,32.09458222430737,52.05624999999996,50.09740000000002,32.03719999999995,33.77249999999994,35.14333333333334,17276145,23755640.3,50.88408793061101,3.0010939562727144,1.5,2.75,NaN,NaN,2.606312228620174,0.7272439210994451,1000.1712465855475,0.3654747386478906,0.5913769028324296,0.22590216418453904,88.25592040055481,-7.0575461454940305,18.53048263864653,50.8378746763366,30.63164268501688,4824283321
1589376600,33.9699,34.39,31.44,32.45,-33.22142857142856,88.55548076923077,75.83,17.55,75.83,17.55,55.74,42.1,52.3,27.54,51.941199999999974,49.78060000000002,31.651999999999948,33.80999999999993,36.7141574694849,33.649955239734325,34.56769230769227,37.26450699681268,31.870877618571857,51.941199999999974,49.78060000000002,31.651999999999948,33.80999999999993,32.76,24326895,23575398.95,47.05685915784651,5.929273894784863,1.5,2.75,NaN,NaN,2.630861355147304,1.0318762813555695,993.0969653820997,0.1333111115853003,0.39254105366616443,0.25922994208086414,78.96635428650966,-9.230769230769223,16.12639017774854,54.3322407400254,29.541369082226055,4799956426
1589463000,31.46,33.5898,30.58,33.55,30.58,88.7626923076923,75.83,17.55,75.83,17.55,55.74,42.1,52.3,27.54,51.833449999999964,49.46670000000003,31.159799999999947,33.87849999999993,36.59007286283843,33.64043569309296,34.48230769230766,37.231798877081296,31.73281650753402,51.833449999999964,49.46670000000003,31.159799999999947,33.87849999999993,32.57326666666666,32202514,23458901.55,49.5672393958723,4.136570264321227,1.5,2.75,NaN,NaN,2.6579284012082107,1.3727204545943457,995.3966309096193,0.04864313944398779,0.32003386638584885,0.27139072694186106,82.17337867378912,1.6974840860866782,27.97228561647054,39.045345700911106,32.98236868261835,4832158940
1589549400,32.65,33.99,32.26,33.96,30.960270270270268,88.96990384615384,75.83,17.55,75.83,17.55,55.74,42.1,52.3,27.54,51.73729999999996,49.147400000000026,30.792799999999946,33.83849999999994,36.48693275057026,33.67087038898887,34.46384615384612,37.223874453160775,31.703817854531465,51.73729999999996,49.147400000000026,30.792799999999946,33.83849999999994,33.403333333333336,22057536,22983674.05,50.50919445485719,1.6419243684777276,1.5,2.75,NaN,NaN,2.5916478011219106,0.9597045255695313,997.5732107955871,0.016715965760026985,0.2922856841418948,0.27556971838186783,67.57710687762385,2.2275737507525646,33.342074200568845,33.36893093514639,33.28899486428477,4854216476
1589808600,36.43,37.72,36.28,37.09,31.340540540540538,89.17711538461538,75.83,17.55,75.83,17.55,55.74,42.1,52.3,27.54,51.66364999999996,48.86070000000002,30.540599999999944,34.045999999999935,36.51058244662633,33.99650178051374,34.48307692307689,37.31169316118435,31.654460684969425,51.66364999999996,48.86070000000002,30.540599999999944,34.045999999999935,37.03,18482925,22477577.35,57.097124867741286,7.9150745558267595,1.5,2.75,NaN,NaN,2.6751015296132024,0.8222827892971303,1005.4170820202742,0.1930653245085231,0.5169013740175217,0.3238360495089986,83.50800200761805,8.672721945502493,55.86991201744986,15.154779981734228,28.975308000815904,4872699401
1589895000,36.9,37.55,35.94,35.98,31.72081081081081,89.38432692307693,75.83,17.55,75.83,17.55,55.74,42.1,52.3,27.54,51.59019999999996,48.56270000000002,30.496999999999943,34.347999999999935,36.48977529185667,34.18540637284576,34.500769230769194,37.36353240954446,31.638006051993926,51.59019999999996,48.56270000000002,30.496999999999943,34.347999999999935,36.49,18037427,21695480.1,54.33485371979623,6.1548115801747185,1.5,2.75,NaN,NaN,2.599022848926545,0.8313910048019633,1002.6632967466311,0.21968692449508403,0.5984447051278536,0.3787577806327696,85.93891865478292,7.531380753138063,54.51113446860215,16.042104555794218,29.446760975603627,4854661974
1589981400,37.39,38.135,37.28,37.83,32.10108108108108,89.59153846153846,75.83,17.55,75.83,17.55,55.74,42.1,52.3,27.54,51.54869999999996,48.273200000000024,30.373599999999943,34.643999999999934,36.54233312354856,34.53251052781283,34.87307692307689,38.09007394242353,31.65607990373024,51.54869999999996,48.273200000000024,30.373599999999943,34.643999999999934,37.74833333333333,17601071,21651314.8,57.98329601239189,7.028892259122735,1.5,2.75,NaN,NaN,2.5673069311460774,0.8129331249666186,1008.6766152979802,0.33946609169824293,0.8030903952555732,0.4636243035573303,87.81421699176167,9.114508220363417,81.2900441894,3.0445213764858807,15.665434434114117,4872263045
1590067800,37.73,38.07,36.54,36.94,32.48135135135135,89.79875,75.83,17.55,75.83,17.55,55.74,42.1,52.3,27.54,51.493399999999966,47.97520000000002,30.360599999999945,34.89849999999994,36.557927903017244,34.761795239449704,35.15923076923073,38.39886476126854,31.91959677719292,51.493399999999966,47.97520000000002,30.360599999999945,34.89849999999994,37.18333333333333,17467935,20999945.15,55.6785987456364,4.953017628235022,1.5,2.75,NaN,NaN,2.4932135789213574,0.8318086011762751,1010.636744187405,0.3357214846499924,0.8832761593698208,0.5475546747198284,88.66101768221147,1.5114042319318415,51.986259807688015,17.75808352782472,30.25565666448726,4854795110
1590154200,36.88,37.27,36.38,37.19,32.86162162162162,90.00596153846153,75.83,17.55,75.83,17.55,55.74,42.1,52.3,27.54,51.43889999999997,47.69140000000002,30.568199999999948,35.09599999999993,36.58271504407539,34.99305283569259,35.39461538461534,38.7437334350842,32.04549733414648,51.43889999999997,47.69140000000002,30.568199999999948,35.09599999999993,36.946666666666665,12755553,20437355.6,56.205183623444974,3.7904446317157983,1.5,2.75,NaN,NaN,2.3786983232841172,0.6241293271816437,1013.0015074447224,0.32673782702241705,0.9559769584978497,0.6292391314754326,84.56485035288215,2.226498075865847,47.13267970040197,21.30929347939036,31.558026820207665,4867550663
1590499800,39.71,39.76,38.4414,38.64,33.24189189189189,90.21317307692307,75.83,17.55,75.83,17.55,55.74,42.1,52.3,27.54,51.37789999999996,47.41700000000002,30.66019999999995,35.29499999999994,36.6633928854842,35.340381137055196,35.79307692307688,39.3526653575009,32.23348848865287,51.37789999999996,47.41700000000002,30.66019999999995,35.29499999999994,38.94713333333333,13527748,20055840.15,59.23070858841597,7.791359696849427,1.5,2.75,NaN,NaN,2.3923627287638234,0.6745041792726894,1018.9276059983913,0.39077786714777063,1.1177114654101459,0.7269335982623752,87.00477728450723,12.850467289719623,43.51532654688489,24.15609383184995,32.32857962126516,4881078411
1590586200,39.76,40.3,37.7211,40.26,33.62216216216216,90.42038461538462,75.83,17.55,75.83,17.55,55.74,42.1,52.3,27.54,51.33054999999997,47.14050000000003,31.01519999999995,35.597999999999935,36.80443630173972,35.80891626685946,36.22307692307688,40.42813164413588,32.01802220201788,51.33054999999997,47.14050000000003,31.01519999999995,35.597999999999935,39.42703333333333,17960955,19380825.15,62.35942350752928,7.457810537692261,1.5,2.75,NaN,NaN,2.4056868195664074,0.9267384056658703,1024.748842332095,0.5071890026395651,1.3609198515618317,0.8537308489222666,77.58289769657303,24.067796610169477,75.46225996355588,5.05764269580997,19.48009734063413,4899039366
1590672600,40.76,41.63,39.79,40.1,34.00243243243243,90.62759615384616,75.83,17.55,75.83,17.55,55.74,42.1,52.3,27.54,51.29124999999997,46.87870000000004,31.29339999999995,35.76099999999993,36.93367409382836,36.21759090811094,36.5084615384615,41.19598899005765,31.820934086865357,51.29124999999997,46.87870000000004,31.29339999999995,35.76099999999993,40.50666666666667,16672439,18910481.35,61.8545366807584,9.105675417661885,1.5,2.75,NaN,NaN,2.365280618168807,0.8816506936773452,1022.2426001251245,0.5355714341013209,1.5231951415489178,0.9876237074475969,65.53329507678767,19.52309985096872,44.176467514140626,23.616292962227018,32.20723952363236,4882366927
1590759000,39.88,40.85,38.72,40.53,34.3827027027027,90.83480769230769,75.83,17.55,75.83,17.55,55.74,42.1,52.3,27.54,51.24284999999998,46.61350000000003,31.659199999999945,35.99999999999993,37.07470648230568,36.628296535909904,36.827692307692274,41.979045550936846,31.676339064447703,51.24284999999998,46.61350000000003,31.659199999999945,35.99999999999993,40.03333333333333,21894288,18727034.15,62.727927546933685,6.1876857910513134,1.5,2.75,NaN,NaN,2.348474859728178,1.1691273601912027,1022.8149515965968,0.5437230713386154,1.6672775466208662,1.1235544752822508,65.28443222370719,19.346289752650176,76.6291720494828,4.616441205638449,18.75438674487873,4904261215
1591018200,40.32,41.36,40.1,41.1,34.76297297297297,91.04201923076923,75.83,17.55,75.83,17.55,55.74,42.1,52.3,27.54,51.21969999999998,46.35910000000003,32.04079999999995,36.40549999999993,37.2325611300584,37.05417305629944,37.35538461538458,42.738547056721686,31.972222174047474,51.21969999999998,46.35910000000003,32.04079999999995,36.40549999999993,40.85333333333333,11751231,17995150.8,63.907629351359695,7.373192426601377,1.5,2.75,NaN,NaN,2.2707266554618792,0.6530220908179329,1027.5525083977807,0.5464623344687287,1.8066323933681616,1.260170058899433,65.22403561999013,10.811539498517114,76.06577301438936,4.811228991090644,19.12299799451999,4916012446
1591104600,41.5,42.1301,40.93,42.1,35.14324324324324,91.24923076923076,75.83,17.55,75.83,17.55,55.74,42.1,52.3,27.54,51.199699999999986,46.10450000000004,32.50039999999994,36.849499999999935,37.42344108574238,37.53472800331854,38.09769230769228,43.22575179280361,32.96963282258095,51.199699999999986,46.10450000000004,32.50039999999994,36.849499999999935,41.72003333333333,12075535,17656476.45,65.94415635476152,7.195034927906288,1.5,2.75,NaN,NaN,2.194253322928888,0.6839153346476443,1031.736546260839,0.5718617269072528,1.9749972175334989,1.403135490626246,48.69479384656387,17.00944969427461,75.94540748773612,4.856682689780186,19.19790982248367,4928087981
1591191000,43.02,44.23,42.895,43.8,35.52351351351351,91.4564423076923,75.83,17.55,75.83,17.55,55.74,42.1,52.3,27.54,51.17829999999998,45.85320000000004,33.02539999999995,37.33299999999993,37.67350221963484,38.13142057443106,38.88615384615382,44.12559913952682,33.646708552780815,51.17829999999998,45.85320000000004,33.02539999999995,37.33299999999993,43.641666666666666,13047831,17376399.15,69.13279746241295,10.071864068433104,1.5,2.75,NaN,NaN,2.1896637998625383,0.7508938352167169,1036.9398747019113,0.6535015473955084,2.2200124248706317,1.5665108774751233,42.19396168655755,15.781126090404438,74.59703402330493,5.379084152380069,20.023881824314998,4941135812
1591277400,43.34,44.15,42.5,43.43,35.90378378378378,91.66365384615385,75.83,17.55,75.83,17.55,55.74,42.1,52.3,27.54,51.146399999999986,45.60470000000004,33.44539999999994,37.83149999999993,37.899247230629555,38.63604718639001,39.61461538461535,44.53550720738091,34.69372356184979,51.146399999999986,45.60470000000004,33.44539999999994,37.83149999999993,43.36000000000001,14517849,17199538.35,67.64820329531716,7.751471961324019,1.5,2.75,NaN,NaN,2.1511163855866426,0.8440836436752385,1038.831293425709,0.6325200580149339,2.3571609499937907,1.7246408919788567,40.065144579126496,17.56903086085545,75.91389934344984,4.8686131440088785,19.21748751254127,4926617963
1591363800,45.94,47.61,45.9,46.77,36.28405405405405,91.87086538461539,75.83,17.55,75.83,17.55,55.74,42.1,52.3,27.54,51.13684999999999,45.37480000000004,33.91539999999995,38.436499999999924,38.24711988825192,39.41070935911477,40.359230769230734,46.34169983264214,34.37676170581933,51.13684999999999,45.37480000000004,33.91539999999995,38.436499999999924,46.76,19893807,17432190.15,73.23561117125155,12.742188004903507,1.5,2.75,NaN,NaN,2.296036643759025,1.1412109912075508,1044.8749939303232,0.7836392956629887,2.7041900115575928,1.920550715894604,45.44910901533063,25.75961279913957,76.29428932823792,4.7254681082775605,18.98024256348451,4946511770
1591623000,47.2,48.5687,46.93,48.48,36.66432432432432,48.5687,75.83,17.55,75.83,17.55,55.74,42.1,52.3,27.54,51.12984999999999,45.16580000000003,34.33679999999995,39.040999999999926,38.6484093043989,40.274451324913365,41.320769230769194,48.138558006243414,34.502980455294974,51.12984999999999,45.16580000000003,34.33679999999995,39.040999999999926,47.9929,11919440,17384160.7,75.56263423095048,12.35497124795775,1.5,2.75,NaN,NaN,2.2605125977762373,0.6856494371914084,1051.2590017275893,0.9288971502256933,3.0816721536767204,2.152775003451027,44.567922581209984,25.46583850931676,79.06884780567486,3.8237515706584624,17.107400623666667,4958431210
1591709400,47.16,48.13,46.77,47.42,37.04459459459459,48.20341973684211,75.83,17.55,75.83,17.55,55.74,42.1,52.3,27.54,51.118099999999984,44.94130000000004,34.78719999999994,39.592999999999925,38.99239325324601,40.95497977015971,42.05846153846149,49.2697341079187,34.847188969004286,51.118099999999984,44.94130000000004,34.78719999999994,39.592999999999925,47.44,16122239,17479568.15,71.4174653659789,10.415565011871907,1.5,2.75,NaN,NaN,2.2211902693636483,0.9223476725310288,1046.2513153279708,0.8839744733840966,3.257743095181148,2.3737686217970513,51.63163853364898,17.784401390958777,50.959634994340234,18.68265770494172,30.357707300718047,4942308971
1591795800,47.7,48.12,46.2752,46.65,37.42486486486486,47.83813947368421,75.83,17.55,75.83,17.55,55.74,42.1,52.3,27.54,51.12144999999999,44.69270000000003,35.17439999999995,40.213499999999925,39.29269155704028,41.49736264919212,42.80538461538457,49.747761133262024,35.86300809750711,51.12144999999999,44.69270000000003,35.17439999999995,40.213499999999925,47.01506666666666,19500593,17590790.55,68.47873065595459,8.300982916535665,1.5,2.75,NaN,NaN,2.1943052501233877,1.1085683127527204,1041.8080218262023,0.7386976106913066,3.2971406351611847,2.558443024469878,53.722755283273976,16.334164588528672,23.475623693311444,44.66546201748846,31.8589142892001,4922808378
1591882200,43.27,43.57,38.27,38.56,37.80513513513513,47.472859210526316,75.83,17.55,75.83,17.55,55.74,42.1,52.3,27.54,51.07689999999999,44.35580000000004,35.42459999999995,40.51899999999993,39.2639585548034,41.21761382545954,42.91076923076917,49.54367768454817,36.27786077699017,51.07689999999999,44.35580000000004,35.42459999999995,40.51899999999993,40.13333333333333,33437297,18046310.65,46.724521763807964,8.908733094845845,1.5,2.75,NaN,NaN,2.6361405894002883,1.8528605457647933,1029.4814471014686,0.06930740126840851,2.645077276055389,2.5757698747869804,129.832600036049,-4.86059708857636,16.975238413696268,53.40212571058712,29.622635875716597,4889371081
1591968600,41.4399,41.765,37.72,39.88,38.185405405405405,47.107578947368424,75.83,17.55,75.83,17.55,55.74,42.1,52.3,27.54,51.04179999999999,44.037300000000045,35.77039999999995,40.835499999999925,39.28811704285033,41.09022203255863,43.006153846153786,49.42279345776713,36.589514234540445,51.04179999999999,44.037300000000045,35.77039999999995,40.835499999999925,39.788333333333334,29234099,17897889.9,49.541183819008246,7.635056846914859,1.5,2.75,NaN,NaN,2.7367734044431247,1.633382435769705,1035.5498972295097,-0.29313010829197506,2.209357239422012,2.502487347713987,131.4341841987351,-2.9683698296836956,20.562559744083952,48.399358226284406,31.038082029631646,4918605180
1592227800,37.43,41.48,36.93,41,36.93,46.742298684210525,48.48,17.55,75.83,17.55,55.74,42.1,52.3,27.54,51.00734999999999,43.72890000000004,36.107999999999954,41.18749999999993,39.35524970783659,41.081629458029234,43.06307692307686,49.393814562029725,36.732339284124,51.00734999999999,43.72890000000004,36.107999999999954,41.18749999999993,39.803333333333335,26172285,18103627.35,51.86650811943427,5.575444071012504,1.5,2.75,NaN,NaN,2.866289589840044,1.445692871047746,1039.1405597230973,-0.4562714690423939,1.9321480114109946,2.3884194804533885,132.26141459753595,-2.612826603325419,24.727824843290765,42.75796445112124,32.514210705588006,4944777465
1592314200,44.39,44.45,41.26,43.36,37.23238095238095,46.37701842105263,48.48,17.55,75.83,17.55,55.74,42.1,52.3,27.54,50.97574999999999,43.44220000000004,36.51299999999995,41.50099999999993,39.512298738901826,41.29861712869312,43.31384615384609,49.40911815995069,37.2185741477415,50.97574999999999,43.44220000000004,36.51299999999995,41.50099999999993,43.02333333333333,24880051,18423483.65,56.42349265876174,2.1330437107731366,1.5,2.75,NaN,NaN,2.9079831905657554,1.3504531212803503,1044.4999511925719,-0.40577188691180677,1.8812046218136302,2.286976508725437,135.6239043788542,-1.004566210045657,47.80102849548993,20.72557299903767,31.4733985054724,4969657516
1592400600,43.84,43.965,42.52,42.77,37.53476190476191,46.01173815789474,48.48,17.55,75.83,17.55,55.74,42.1,52.3,27.54,50.941399999999994,43.16940000000004,36.812599999999954,41.84049999999992,39.64005172953313,41.438748830722346,43.48615384615379,49.38022146844102,37.59208622386656,50.941399999999994,43.16940000000004,36.812599999999954,41.84049999999992,43.085,14325364,18237880.5,55.02105428654915,1.984171002689696,1.5,2.75,NaN,NaN,2.8034843912396297,0.7854730707331918,1040.8171017140173,-0.4113508442907623,1.7727879533619841,2.1841387976527464,133.79630325436895,-1.519686852406163,52.80204039757344,17.127351715256605,30.070607887169945,4955332152
1592487000,42.1535,43.09,41.94,42.86,37.83714285714286,45.64645789473684,48.48,17.55,75.83,17.55,55.74,42.1,52.3,27.54,50.91179999999999,42.93100000000004,37.114199999999954,42.09199999999992,39.76632421072791,41.57410608493927,43.62153846153841,49.36918464814302,37.873892274933795,50.91179999999999,42.93100000000004,37.114199999999954,42.09199999999992,42.63,11666455,17941149.7,55.20396476213708,0.49907334797499486,1.5,2.75,NaN,NaN,2.685378363293942,0.6502623965062841,1039.4682338759974,-0.4074527224699951,1.6748228945652528,2.082275617035248,133.75759522649102,-8.360059867436398,84.39946900391534,2.1453414807604374,13.455189515324221,4966998607
1592573400,44.42,44.501,41.55,42.13,38.13952380952381,45.28117763157895,48.48,17.55,75.83,17.55,55.74,42.1,52.3,27.54,50.87064999999998,42.664900000000046,37.34459999999996,42.351499999999916,39.85901737893466,41.627048362564096,43.623846153846095,49.369070463380396,37.878621844311795,50.87064999999998,42.664900000000046,37.34459999999996,42.351499999999916,42.727,18463317,17990918.8,53.31029001971885,0.8707937473163648,1.5,2.75,NaN,NaN,2.7043513373443746,1.0262575916912036,1036.1239536056976,-0.4492207141523159,1.520749724344853,1.9699704384971688,124.91214438620034,-13.098184818481837,55.79580203587634,15.140781833831959,29.063416130291696,4948535290
1592832600,41.85,43.12,41.36,42.94,38.44190476190476,44.91589736842106,48.48,17.55,75.83,17.55,55.74,42.1,52.3,27.54,50.82374999999999,42.40810000000004,37.56379999999996,42.63899999999992,39.979840226819576,41.75209137565323,43.55769230769226,49.31307589496829,37.80230872041622,50.82374999999999,42.40810000000004,37.56379999999996,42.63899999999992,42.47333333333333,10016381,17853960.2,55.14875947312403,0.8002460589723297,1.5,2.75,NaN,NaN,2.6368976703912046,0.5610173254446933,1037.95425412747,-0.41811872678165796,1.4473220300200964,1.8654407568017544,122.98672625339195,-9.447490510333202,46.6965084284437,21.57693854087306,31.72655303068323,4958551671
1592919000,44.1,44.51,43.3177,43.47,38.744285714285716,44.55061710526316,48.48,17.55,75.83,17.55,55.74,42.1,52.3,27.54,50.778899999999986,42.15020000000004,37.811399999999956,42.88049999999992,40.11670923753253,41.91570172082911,43.56076923076918,49.315919227015144,37.80561923452322,50.778899999999986,42.15020000000004,37.811399999999956,42.88049999999992,43.765899999999995,10428500,17698997.8,56.35963404716737,3.049995874905992,1.5,2.75,NaN,NaN,2.56069069393469,0.5892141531313145,1040.0513591468634,-0.3598896345521334,1.4155787136115876,1.775468348163721,123.54614020555496,-6.816720257234727,33.77332031078868,32.90618601963772,33.3204936695736,4968980171
1593005400,42.56,42.84,39.34,40.17,39.04666666666667,44.185336842105265,48.48,17.55,75.83,17.55,55.74,42.1,52.3,27.54,50.71744999999999,41.896900000000045,37.937199999999955,42.87599999999992,40.118799071354786,41.749444414083484,43.05307692307687,48.750392807247565,37.35576103890618,50.71744999999999,41.896900000000045,37.937199999999955,42.87599999999992,40.78333333333334,21619763,17881938.2,47.72079935228915,4.7847219830819885,1.5,2.75,NaN,NaN,2.672784215796497,1.20902794530405,1034.0904650809941,-0.531311654916437,1.1113287795181748,1.6426404344346117,130.00261738993413,4.175311203319501,28.298388766580928,38.647401558317625,33.05420967510145,4947360408
1593091800,39.91,41.57,39.051,41.45,39.34904761904762,43.820056578947366,48.48,17.55,75.83,17.55,55.74,42.1,52.3,27.54,50.66209999999999,41.642500000000034,38.132199999999955,42.94349999999992,40.17100302934087,41.720925898456485,42.512307692307644,47.31005815137235,37.714557233242935,50.66209999999999,41.642500000000034,38.132199999999955,42.94349999999992,40.690333333333335,15448366,17820734.55,50.866690767185624,3.494334883385149,1.5,2.75,NaN,NaN,2.66179962895389,0.8668759391851218,1037.1116667582194,-0.5441924509844573,0.96239987070404,1.5065923216884973,68.15783537846279,3.9368104312938823,31.38456028255992,35.3320153222127,33.28342439522738,4962808774
1593178200,40.97,41.06,38.25,38.54,39.651428571428575,43.45477631578947,48.48,17.55,75.83,17.55,55.74,42.1,52.3,27.54,50.58669999999999,41.32780000000003,38.25939999999996,42.84399999999992,40.107042126229466,41.417980574793965,41.829230769230726,46.141570569874105,37.51689096858735,50.58669999999999,41.32780000000003,38.25939999999996,42.84399999999992,39.28333333333333,21054085,17778724.4,44.33495294515756,7.519604950885851,1.5,2.75,NaN,NaN,2.700242512600041,1.184229224004395,1031.2839515840758,-0.7231831332244978,0.6026134051578751,1.3257965383823729,79.46035375584283,-6.000000000000002,30.72882495217939,36.01876333305266,33.25241171476796,4941754689
1593437400,39,40.22,38.06,40.11,39.953809523809525,43.08949605263158,48.48,17.55,75.83,17.55,55.74,42.1,52.3,27.54,50.516749999999995,41.00540000000003,38.366399999999956,42.79449999999992,40.10715812127929,41.29341099624216,41.3261538461538,44.6940432876202,37.958264404687405,50.516749999999995,41.00540000000003,38.366399999999956,42.79449999999992,39.46333333333333,14988452,17940585.45,48.19968183485686,4.848967980733607,1.5,2.75,NaN,NaN,2.6616537617000375,0.8354494362389941,1036.20642750893,-0.7093538721541299,0.43910419818971036,1.1484580703438403,81.4919134235673,-7.495387453874539,33.07057679470883,33.60633561438114,33.32308759091003,4956743141
1593523800,40,42.445,39.93,41.81,40.256190476190476,42.72421578947368,48.48,17.55,75.83,17.55,55.74,42.1,52.3,27.54,50.455999999999996,40.69220000000003,38.54379999999995,42.77999999999992,40.1739362341703,41.342609948981,41.576153846153815,44.54438085863671,38.60792683367092,50.455999999999996,40.69220000000003,38.54379999999995,42.77999999999992,41.395,15209497,18097283.55,52.079337805796065,0.19002832455798258,1.5,2.75,NaN,NaN,2.6511784930071776,0.8404298334597293,1039.8300216891064,-0.5654807016184673,0.44160719332075615,1.0070878949392235,78.0758909810429,-2.244563946691608,36.52567594019172,30.24904019485348,33.225283864954804,4971952638
1593610200,42.2,43.14,42,42.59,40.558571428571426,42.35893552631579,48.48,17.55,75.83,17.55,55.74,42.1,52.3,27.54,50.40145,40.39900000000003,38.79679999999995,42.719499999999925,40.268683832830284,41.461409001459,41.78461538461535,44.624968725414995,38.944262043815705,50.40145,40.39900000000003,38.79679999999995,42.719499999999925,42.57666666666667,14461139,18167948.95,53.789479190309564,2.768018001615231,1.5,2.75,NaN,NaN,2.556808600649522,0.7959698169451319,1041.2389484533016,-0.4050640031460475,0.5007578910066641,0.9058218941527116,78.73852058686661,-0.6299580027998041,69.42546775987121,7.605618734093451,22.968913506035335,4986413777
1593696600,44.12,44.71,42.97,43.25,40.860952380952384,41.9936552631579,48.48,17.55,75.83,17.55,55.74,42.1,52.3,27.54,50.34844999999999,40.09680000000004,39.023599999999945,42.710499999999925,40.38559819232714,41.63175100132005,41.95769230769228,44.859258503823696,39.05612611156086,50.34844999999999,40.09680000000004,39.023599999999945,42.710499999999925,43.64333333333333,14654413,18174777.15,55.24489082752863,4.309199531572063,1.5,2.75,NaN,NaN,2.525607986317413,0.8063049620391082,1044.2763497194521,-0.24942234713314182,0.5940439602362844,0.8434663073694262,79.25976009702619,2.6584381675765427,69.35588298270687,7.637959310276839,23.006157707016268,5001068190
1594042200,45.03,45.44,44.66,45.24,41.163333333333334,41.628375,48.48,17.55,75.83,17.55,55.74,42.1,52.3,27.54,50.30479999999999,39.81000000000003,39.291399999999946,42.63399999999993,40.57596689066725,41.97539376309909,42.10230769230766,45.42575496511762,38.778860419497704,50.30479999999999,39.81000000000003,39.291399999999946,42.63399999999993,45.11333333333334,10834819,17721827.75,59.39724428384708,6.127305896496587,1.5,2.75,NaN,NaN,2.5016359872947405,0.6113827057144261,1048.4942929120662,-0.019486611160187572,0.8191080434191917,0.8385946545793793,82.0417817473495,5.35631113181184,100,0,0,5011903009
1594128600,44.5599,45.47,43.72,43.86,41.465714285714284,41.263094736842106,48.48,17.55,75.83,17.55,55.74,42.1,52.3,27.54,50.254349999999995,39.49560000000003,39.50379999999995,42.40299999999993,40.70475250279795,42.154880071375366,42.186153846153815,45.62572035248558,38.74658733982205,50.254349999999995,39.49560000000003,39.50379999999995,42.40299999999993,44.35,11186624,17685186.95,55.54837016080757,4.221928218499201,1.5,2.75,NaN,NaN,2.447947702487973,0.6325420269306229,1043.8400728156503,0.02994049044877045,0.8760202676403424,0.8460797771915719,84.36535748949471,0.897170462387855,80.68852645229585,3.2198483157613262,16.09162523194283,5000716385
1594215000,44.24,44.92,43.42,44.83,NaN,NaN,48.48,17.55,75.83,17.55,55.74,42.1,52.3,27.54,50.2132,39.193200000000026,39.70719999999994,42.273499999999935,40.86652691445293,42.40965339791104,42.33769230769228,46.045763785271994,38.629620830112565,50.2132,39.193200000000026,39.70719999999994,42.273499999999935,44.39000000000001,9959588,17377054.4,57.62680290446281,3.4211065145198014,1.5,2.75,NaN,NaN,2.380237152310261,0.5731459297267321,1046.2940447026078,0.11354049626843132,0.988005397527111,0.8744649012586797,84.96472517554545,11.600697037590232,79.1248403243842,3.7282573322718897,17.1469023433439,5010675973
1594301400,45.16,45.2614,42.54,44.1,NaN,NaN,48.48,17.55,75.83,17.55,55.74,42.1,52.3,27.54,50.168,38.88040000000003,39.905199999999944,42.14599999999994,40.99332978055282,42.57063878858618,42.489230769230744,46.3102613312929,38.66820020716859,50.168,38.88040000000003,39.905199999999944,42.14599999999994,43.96713333333333,15521528,17178101.15,55.52275742940257,2.348144687349472,1.5,2.75,NaN,NaN,2.404605927145243,0.9035648273616087,1041.9968649967243,0.10542815571275532,1.0062500958996239,0.9008219401868686,68.98488686407433,6.393244873341372,44.5143419058981,23.320082356847067,32.16557573725484,4995154445
1594387800,44.08,45.58,43.42,45.45,NaN,NaN,48.48,17.55,75.83,17.55,55.74,42.1,52.3,27.54,50.136100000000006,38.587900000000026,40.07739999999994,42.49049999999994,41.16810116170761,42.844863665863684,42.68230769230767,46.815819172848556,38.54879621176678,50.136100000000006,38.587900000000026,40.07739999999994,42.49049999999994,44.81666666666666,11063747,16059423.65,58.53770345294981,3.9841111646060163,1.5,2.75,NaN,NaN,2.387134075206297,0.6889255331401635,1046.725746348649,0.17275800415730835,1.116769445383504,0.9440114412261956,68.8466861263544,17.929423975090824,41.461837123707575,25.852750949496826,32.68541192679559,5006218192
1594647000,46.52,47.65,43.97,44.29,NaN,NaN,48.48,17.55,75.83,17.55,55.74,42.1,52.3,27.54,50.093650000000004,38.27250000000003,40.24819999999994,42.71099999999994,41.29052856713084,42.98249569768619,42.74538461538459,46.94947504392688,38.54129418684229,50.093650000000004,38.27250000000003,40.24819999999994,42.71099999999994,45.303333333333335,15115317,15353484.55,55.082570304254475,4.74387876375808,1.5,2.75,NaN,NaN,2.4794816412629896,0.9844877200856661,1043.7851581721902,0.12326792657720431,1.098096349447701,0.9748284228704966,51.514982510846714,10.421341311393668,15.876081009799563,54.7366408975523,29.38727809264814,4991102875
1594733400,43.62,46.14,43.07,46.01,NaN,NaN,48.48,17.55,48.48,17.55,75.83,42.1,55.74,27.54,50.06170000000001,37.98330000000003,40.508599999999944,42.96149999999994,41.47560587822375,43.2708294407637,43.19461538461535,47.449687401611364,38.93954336761934,50.06170000000001,37.98330000000003,40.508599999999944,42.96149999999994,45.07333333333333,16153892,14852564.9,58.951424309666855,3.0798206173037994,1.5,2.75,NaN,NaN,2.521661524029919,1.0876163214072203,1047.731489305251,0.18666565344378627,1.2081604896752296,1.0214948362314433,51.1873465744748,10.045443673762247,42.61805834421471,24.904383635360112,32.47755802042518,5007256767
1594819800,47.53,47.78,46.15,47.24,NaN,NaN,48.48,17.55,48.48,17.55,75.83,42.1,55.74,27.54,50.04030000000001,37.730600000000024,40.788999999999945,43.15549999999994,41.70166054966596,43.648845684500486,43.63999999999997,48.26721049046579,39.01278950953415,50.04030000000001,37.730600000000024,40.788999999999945,43.15549999999994,47.05666666666667,17448985,14481011.6,61.50491387974887,5.931727212798621,1.5,2.75,NaN,NaN,2.467971415170639,1.2049562200475001,1053.1100180472558,0.2857997514817985,1.3787445255836914,1.092944774101893,48.871958579344366,10.918055881662358,49.663460376023835,19.396185054575337,30.940354569400828,5024705752
1594906200,46.3401,46.995,46.035,46.77,NaN,NaN,48.48,17.55,48.48,17.55,75.83,42.1,55.74,27.54,50.01260000000001,37.54520000000003,41.041799999999945,43.355499999999935,41.900418959482984,43.94609847645282,44.27307692307689,48.12265939486531,40.42349445128848,50.01260000000001,37.54520000000003,41.041799999999945,43.355499999999935,46.6,10726908,14301088.8,59.96978129318901,4.061750222915647,1.5,2.75,NaN,NaN,2.3777591712298793,0.7500763158676421,1051.46250910516,0.2929945174760191,1.459187920946917,1.1661934034708978,50.244736427761225,8.13872832369943,54.61199950320808,15.958294794950799,29.42970570184112,5013978844
1594992600,47.24,47.552,46.33,47.13,NaN,NaN,48.48,17.55,48.48,17.55,75.83,42.1,55.74,27.54,49.99630000000001,37.42240000000003,41.31519999999995,43.56899999999994,42.105500568915026,44.24932719298112,44.81307692307689,48.10421546458624,41.521938381567544,49.99630000000001,37.42240000000003,41.31519999999995,43.56899999999994,47.004,8613031,14148417.6,60.77731875895483,4.700937188072386,1.5,2.75,NaN,NaN,2.295204944713459,0.608762848503991,1053.2684053539133,0.29448719698047054,1.534302399696486,1.2398152027160154,50.10193479146895,4.177718832891248,52.99503953645306,17.0441365803389,29.960823883208036,5022591875
1595251800,47.08,48.68,46.72,48.31,NaN,NaN,48.48,17.55,48.48,17.55,75.83,42.1,55.74,27.54,49.99895000000001,37.31880000000003,41.587999999999944,43.877999999999936,42.34881427209483,44.63605793650673,45.3130769230769,48.60234511024264,42.02380873591116,49.99895000000001,37.31880000000003,41.587999999999944,43.877999999999936,47.903333333333336,7721316,13611317.55,63.38468300550228,5.636029818416055,1.5,2.75,NaN,NaN,2.2712617343767834,0.5672717554076901,1051.64746396682,0.34398695885468067,1.6697989012843664,1.3258119424296857,45.90047286330342,10.145918832649345,80.84468713072405,3.1994540345449374,15.95585883473102,5030313191
1595338200,49.28,49.5,48.175,48.62,NaN,NaN,48.48,17.55,48.48,17.55,75.83,42.1,55.74,27.54,49.99775,37.29650000000003,41.83259999999995,44.161999999999935,42.59474312416954,45.015480990172755,45.776923076923055,49.09986324504928,42.45398290879683,49.99775,37.29650000000003,41.83259999999995,44.161999999999935,48.76499999999999,10496454,13635321.2,64.0606095535137,6.063245239524542,1.5,2.75,NaN,NaN,2.2036716104927274,0.769798807526441,1056.540436117833,0.36467638721258777,1.7816574264454204,1.4169810392328326,39.260331386154924,8.454160160606735,78.87116801536237,3.8471598995119143,17.281672085125706,5040809645
1595424600,48.48,49.61,48.42,49.43,NaN,NaN,48.48,17.55,48.48,17.55,75.83,42.1,55.74,27.54,49.99080000000001,37.288200000000025,42.093599999999945,44.45999999999993,42.86279241341779,45.435911372061064,46.25230769230767,49.756504331031046,42.74811105358429,49.99080000000001,37.288200000000025,42.093599999999945,44.45999999999993,49.153333333333336,8223224,13525057.4,65.83529889099111,5.4571782179367,1.5,2.75,NaN,NaN,2.1312664954575324,0.6079991941475975,1058.7862050865538,0.3973011433051321,1.9136074683642477,1.5163063250591156,38.80170263843976,12.08616780045351,74.13585090810244,5.617682540075942,20.246466551821616,5049032869
1595511000,49.27,49.64,47.02,47.73,NaN,NaN,48.48,17.55,48.48,17.55,75.83,42.1,55.74,27.54,49.97875000000001,37.20030000000003,42.36339999999995,44.83799999999993,43.05366329916612,45.65439600329334,46.443846153846124,49.977852713950945,42.9098395937413,49.97875000000001,37.20030000000003,42.36339999999995,44.83799999999993,48.129999999999995,14700357,13179087.1,59.22521645656468,3.1261857348647575,1.5,2.75,NaN,NaN,2.16617603149628,1.1154305976170382,1057.9743609456677,0.2746086221181119,1.8595671027067553,1.5849584805886434,44.43120456762288,5.0165016501650035,65.35285915327475,9.686085310138344,24.961055536586898,5034332512
1595597400,46.79,47.2594,46.05,46.74,NaN,NaN,48.48,17.55,48.48,17.55,75.83,42.1,55.74,27.54,49.973050000000015,37.150600000000026,42.649199999999944,45.10249999999993,43.19822552272823,45.75778686012255,46.66538461538459,49.86938802827642,43.46138120249276,49.973050000000015,37.150600000000026,42.649199999999944,45.10249999999993,46.68313333333333,12917946,13052566.1,55.71684524429417,0.06562260555016754,1.5,2.75,NaN,NaN,2.1314491721036886,0.9896863115675009,1055.286757127075,0.10568263794147259,1.7170617780154842,1.6113791400740116,44.748254854882646,5.531722736509376,35.447874631728986,31.434715000715343,33.117410367555664,5021414566
1595856600,47.09,47.8699,46.72,47.75,NaN,NaN,48.48,17.55,48.48,17.55,75.83,42.1,55.74,27.54,49.96615000000001,37.04650000000002,42.93319999999994,45.56299999999993,43.37672648262124,45.947521444872784,46.88999999999997,49.95419521370492,43.82580478629502,49.96615000000001,37.04650000000002,42.93319999999994,45.56299999999993,47.44663333333333,7674838,12383603.75,58.422826046836235,1.7490469893587528,1.5,2.75,NaN,NaN,2.0613385169534255,0.6197580409499133,1058.1885306976817,0.044028249607506176,1.6664144520833943,1.6223862024758882,41.80102563704557,3.781786568137366,33.5758297945843,33.11074727794693,33.31342292746878,5029089404
1595943000,47.44,47.98,46.74,46.92,NaN,NaN,48.48,17.55,48.48,17.55,75.83,42.1,55.74,27.54,49.94970000000002,36.992600000000024,43.19239999999994,45.90349999999993,43.51567838526354,46.040138450122996,47.10692307692304,49.71580004858238,44.4980461052637,49.94970000000002,36.992600000000024,43.19239999999994,45.90349999999993,47.21333333333333,9458683,12107115.3,55.42547909787374,1.1965290630602239,1.5,2.75,NaN,NaN,2.0026714800281806,0.7812499316001392,1057.1272985872397,-0.06468320644426706,1.5415321944205544,1.6062154008648215,39.01590153684986,-0.677392040643523,12.364128639991057,60.34467246637309,27.291198893635837,5019630721
1596029400,47.31,48.88,47.27,48.57,NaN,NaN,49.43,17.55,48.48,17.55,75.83,42.1,55.74,27.54,49.93390000000002,36.981300000000026,43.42199999999994,46.24149999999993,43.71388707603752,46.28107764534938,47.34692307692304,49.87471791542598,44.8191282384201,49.93390000000002,36.981300000000026,43.42199999999994,46.24149999999993,48.24,8089106,11751095.75,59.83684252789663,2.8963152572226134,1.5,2.75,NaN,NaN,1.999623517169025,0.6883703589939687,1062.3204893953298,-0.03877505435190942,1.5577465829249348,1.5965216372768443,41.110345052358,3.848620910840276,12.042954536883059,60.899174765389404,27.05787069772754,5027719827
1596115800,47.16,48.275,46.15,48.05,NaN,NaN,49.43,17.55,48.48,17.55,75.83,42.1,55.74,27.54,49.91620000000002,37.08020000000003,43.663399999999946,46.51449999999993,43.883930720114485,46.449546441030385,47.63615384615381,49.46150588320628,45.81080180910134,49.91620000000002,37.08020000000003,43.663399999999946,46.51449999999993,47.49166666666667,12924162,11674246.9,57.892327743435885,1.635224416481755,1.5,2.75,NaN,NaN,2.0296504087998093,1.1070660155388696,1059.1518934917788,-0.06824404232596093,1.511216584369393,1.579460626695354,41.19934756378669,1.9520475281137164,12.912348268731694,59.413900234685315,27.673751496582998,5014795665
1596202200,48.95,49.25,46.91,49.21,NaN,NaN,49.43,17.55,48.48,17.55,75.83,42.1,55.74,27.54,49.89680000000001,37.13230000000003,43.89099999999995,46.81249999999993,44.09279618207078,46.71244677997987,47.88230769230766,49.625305178446524,46.1393102061688,49.89680000000001,37.13230000000003,43.89099999999995,46.81249999999993,48.45666666666667,12545609,11568806.7,60.94160101738388,1.9462656499778033,1.5,2.75,NaN,NaN,2.0518182367426805,1.084434144793862,1057.2010410517623,-0.02350831862487679,1.5500752284142578,1.5735835470391346,42.92039448429528,1.8629683295383948,43.02126959965062,24.524870249726188,32.45386015062319,5027341274
1596461400,50.04,50.599,49.75,50.21,NaN,NaN,49.43,17.55,48.48,17.55,75.83,42.1,55.74,27.54,49.88380000000001,37.25850000000003,44.15639999999995,47.06099999999993,44.33268652787192,47.045547086648455,48.1107692307692,50.20109068618754,46.02044777535086,49.88380000000001,37.25850000000003,44.15639999999995,47.06099999999993,50.18633333333334,6818563,11367993.9,63.402072309590686,4.923706073802643,1.5,2.75,NaN,NaN,2.0044740769753457,0.5998035414146378,1060.7046623667507,0.055235114213900705,1.6426274398065104,1.5873923255926097,42.19523412294677,3.270259152612101,43.290026088283376,24.354450994064837,32.35552291765178,5034159837
1596547800,49.8,50.81,49.79,50.78,NaN,NaN,49.43,17.55,48.48,17.55,75.83,42.1,55.74,27.54,49.87175000000001,37.49820000000003,44.428199999999954,47.406999999999925,44.58552235030832,47.401209268872414,48.41923076923074,50.79156440173383,46.046897136727644,49.87175000000001,37.49820000000003,44.428199999999954,47.406999999999925,50.46,7112130,11164269.2,64.76459176234583,4.254417364571723,1.5,2.75,NaN,NaN,1.9341545000485356,0.6370439365614724,1063.9378238742127,0.12359857199480784,1.7418905405861196,1.6182919685913117,42.39535080974871,2.731134938296584,68.34144523859915,8.146447856364526,23.512106905036323,5041271967
1596634200,51.46,51.89,51.34,51.71,NaN,NaN,49.43,17.55,48.48,17.55,75.83,42.1,55.74,27.54,49.86780000000001,37.67490000000004,44.689599999999956,47.75099999999993,44.864913630688385,47.81157029088457,48.771538461538434,51.59148768261804,45.95158924045883,49.86780000000001,37.67490000000004,44.689599999999956,47.75099999999993,51.64666666666666,7093743,11020976.95,66.9280045502268,5.53057587453208,1.5,2.75,NaN,NaN,1.8752863214736402,0.6436582738701763,1067.3707448224081,0.20456498990820604,1.8739982059765694,1.6694332160683634,42.57566472360745,8.338571129268812,67.92248315644835,8.348577046824198,23.72893979672745,5048365710
1596720600,51.48,52.8498,51.3199,52.77,NaN,NaN,49.43,17.55,48.48,17.55,75.83,42.1,55.74,27.54,49.863450000000014,37.977500000000035,44.93979999999995,48.18449999999992,45.17491701772021,48.28380169175271,49.11461538461535,52.62674483189343,45.60248593733726,49.863450000000014,37.977500000000035,44.93979999999995,48.18449999999992,52.313233333333336,7614422,10625621.65,69.24578517767637,6.012731341055489,1.5,2.75,NaN,NaN,1.850615869939809,0.7166095547924953,1067.6913750429392,0.2970163569601081,2.0407036622684984,1.7436873053083903,34.961970237926224,12.90115532734275,100,0,0,5055980132
1596807000,52.32,52.98,51.8314,52.87,NaN,NaN,49.43,17.55,48.48,17.55,75.83,42.1,55.74,27.54,49.86265000000001,38.24430000000003,45.19519999999995,48.555499999999924,45.47668497780961,48.720582483014354,49.44153846153843,53.462933903642465,45.42014301943439,49.86265000000001,38.24430000000003,45.19519999999995,48.555499999999924,52.56046666666666,10639191,10604393.85,69.46321248840127,5.111801180276846,1.5,2.75,NaN,NaN,1.8004718792298224,1.003281389817486,1070.790512207182,0.3298778965793825,2.1560346760326183,1.8261567794532358,29.6103057150804,10.722513089005231,100,0,0,5066619323
1597066200,53.14,53.47,52.15,53.38,NaN,NaN,49.43,17.55,48.48,17.55,75.83,42.1,55.74,27.54,49.861900000000006,38.55570000000003,45.45219999999995,49.00999999999992,45.78661890024845,49.164336532251085,49.74538461538459,54.281357857637886,45.20941137313129,49.861900000000006,38.55570000000003,45.45219999999995,49.00999999999992,53,8010421,10249149.05,70.6046267361506,5.357896649421865,1.5,2.75,NaN,NaN,1.7661524592848352,0.781569373312997,1075.4320763451703,0.34908041431422676,2.262507297346019,1.9134268830317924,29.06002651899053,13.768115942028988,100,0,0,5074629744
1597152600,54,54.185,53.35,53.73,NaN,NaN,49.43,17.55,48.48,17.55,75.83,42.1,55.74,27.54,49.861900000000006,38.87280000000003,45.70479999999995,49.39599999999992,46.098124041415176,49.59916162441765,50.20692307692305,55.03998475737992,45.373861396466175,49.861900000000006,38.87280000000003,45.70479999999995,49.39599999999992,53.754999999999995,2795226,9581215.75,71.39484453292484,5.42098756155856,1.5,2.75,NaN,NaN,1.6996415693359186,1.961701485786268,1079.6778585659945,0.347708642954061,2.3480626867243686,2.0003540437703076,23.040227876428773,10.623841877702278,100,0,0,5077424970